country,countryName,year,vaccine,coverage,target,vaccinated,unvaccinated,whoRegion,gvapMics
afg,Afghanistan,2000,dtp1,48,900856,432411,468445,emr,gavi
afg,Afghanistan,2000,dtp3,24,900856,216205,684651,emr,gavi
afg,Afghanistan,2000,mcv1,27,900856,243231,657625,emr,gavi
afg,Afghanistan,2001,dtp3,33,928583,306432,622151,emr,gavi
afg,Afghanistan,2001,mcv1,37,928583,343576,585007,emr,gavi
afg,Afghanistan,2001,dtp1,59,928583,547864,380719,emr,gavi
afg,Afghanistan,2002,dtp3,36,954310,343552,610758,emr,gavi
afg,Afghanistan,2002,mcv1,35,954310,334008,620302,emr,gavi
afg,Afghanistan,2002,dtp1,62,954310,591672,362638,emr,gavi
afg,Afghanistan,2003,mcv1,39,978276,381528,596748,emr,gavi
afg,Afghanistan,2003,dtp3,41,978276,401093,577183,emr,gavi
afg,Afghanistan,2003,dtp1,66,978276,645662,332614,emr,gavi
afg,Afghanistan,2004,mcv1,48,1000216,480104,520112,emr,gavi
afg,Afghanistan,2004,dtp3,50,1000216,500108,500108,emr,gavi
afg,Afghanistan,2004,dtp1,72,1000216,720156,280060,emr,gavi
afg,Afghanistan,2004,mcv2,2,933802,18676,915126,emr,gavi
afg,Afghanistan,2005,mcv1,50,1019314,509657,509657,emr,gavi
afg,Afghanistan,2005,dtp1,76,1019314,774679,244635,emr,gavi
afg,Afghanistan,2005,dtp3,58,1019314,591202,428112,emr,gavi
afg,Afghanistan,2005,mcv2,9,958773,86290,872483,emr,gavi
afg,Afghanistan,2006,mcv1,53,1034578,548326,486252,emr,gavi
afg,Afghanistan,2006,dtp3,58,1034578,600055,434523,emr,gavi
afg,Afghanistan,2006,dtp1,75,1034578,775934,258644,emr,gavi
afg,Afghanistan,2006,mcv2,18,985243,177344,807899,emr,gavi
afg,Afghanistan,2007,dtp3,63,1045629,658746,386883,emr,gavi
afg,Afghanistan,2007,mcv1,55,1045629,575096,470533,emr,gavi
afg,Afghanistan,2007,dtp1,76,1045629,794678,250951,emr,gavi
afg,Afghanistan,2007,mcv2,4,1004017,40161,963856,emr,gavi
afg,Afghanistan,2008,dtp1,75,1052611,789458,263153,emr,gavi
afg,Afghanistan,2008,mcv1,59,1052611,621040,431571,emr,gavi
afg,Afghanistan,2008,dtp3,64,1052611,673671,378940,emr,gavi
afg,Afghanistan,2008,mcv2,23,1019333,234447,784886,emr,gavi
afg,Afghanistan,2009,dtp1,72,1056113,760401,295712,emr,gavi
afg,Afghanistan,2009,mcv1,60,1056113,633668,422445,emr,gavi
afg,Afghanistan,2009,dtp3,63,1056113,665351,390762,emr,gavi
afg,Afghanistan,2009,mcv2,24,1030860,247406,783454,emr,gavi
afg,Afghanistan,2010,dtp1,72,1057357,761297,296060,emr,gavi
afg,Afghanistan,2010,mcv1,62,1057357,655561,401796,emr,gavi
afg,Afghanistan,2010,dtp3,66,1057357,697856,359501,emr,gavi
afg,Afghanistan,2010,mcv2,29,1042417,302301,740116,emr,gavi
afg,Afghanistan,2011,dtp3,68,1057902,719373,338529,emr,gavi
afg,Afghanistan,2011,dtp1,78,1057902,825164,232738,emr,gavi
afg,Afghanistan,2011,mcv1,64,1057902,677057,380845,emr,gavi
afg,Afghanistan,2011,mcv2,31,1050961,325798,725163,emr,gavi
afg,Afghanistan,2012,dtp3,67,1059168,709643,349525,emr,gavi
afg,Afghanistan,2012,dtp1,78,1059168,826151,233017,emr,gavi
afg,Afghanistan,2012,mcv1,59,1059168,624909,434259,emr,gavi
afg,Afghanistan,2012,mcv2,33,1059236,349548,709688,emr,gavi
afg,Afghanistan,2013,dtp3,64,1062169,679788,382381,emr,gavi
afg,Afghanistan,2013,dtp1,76,1062169,807248,254921,emr,gavi
afg,Afghanistan,2013,mcv1,57,1062169,605436,456733,emr,gavi
afg,Afghanistan,2013,mcv2,35,1050079,367528,682551,emr,gavi
afg,Afghanistan,2014,dtp1,73,1067300,779129,288171,emr,gavi
afg,Afghanistan,2014,dtp3,62,1067300,661726,405574,emr,gavi
afg,Afghanistan,2014,mcv1,60,1067300,640380,426920,emr,gavi
afg,Afghanistan,2014,mcv2,39,1051830,410214,641616,emr,gavi
afg,Afghanistan,2015,dtp1,73,1074377,784295,290082,emr,gavi
afg,Afghanistan,2015,dtp3,65,1074377,698345,376032,emr,gavi
afg,Afghanistan,2015,mcv1,62,1074377,666114,408263,emr,gavi
afg,Afghanistan,2015,mcv2,39,1052730,410565,642165,emr,gavi
afg,Afghanistan,2016,dtp3,65,1082647,703721,378926,emr,gavi
afg,Afghanistan,2016,dtp1,73,1082647,790332,292315,emr,gavi
afg,Afghanistan,2016,mcv1,62,1082647,671241,411406,emr,gavi
afg,Afghanistan,2016,mcv2,39,1044328,407288,637040,emr,gavi
ago,Angola,2000,dtp1,44,713913,314122,399791,afr,gavi
ago,Angola,2000,dtp3,28,713913,199896,514017,afr,gavi
ago,Angola,2000,mcv1,36,713913,257009,456904,afr,gavi
ago,Angola,2001,dtp1,55,737985,405892,332093,afr,gavi
ago,Angola,2001,mcv1,65,737985,479690,258295,afr,gavi
ago,Angola,2001,dtp3,38,737985,280434,457551,afr,gavi
ago,Angola,2002,dtp1,62,763743,473521,290222,afr,gavi
ago,Angola,2002,dtp3,41,763743,313135,450608,afr,gavi
ago,Angola,2002,mcv1,66,763743,504070,259673,afr,gavi
ago,Angola,2003,dtp1,64,790840,506138,284702,afr,gavi
ago,Angola,2003,dtp3,40,790840,316336,474504,afr,gavi
ago,Angola,2003,mcv1,52,790840,411237,379603,afr,gavi
ago,Angola,2004,dtp1,69,818924,565058,253866,afr,gavi
ago,Angola,2004,dtp3,40,818924,327570,491354,afr,gavi
ago,Angola,2004,mcv1,52,818924,425840,393084,afr,gavi
ago,Angola,2005,dtp3,38,847500,322050,525450,afr,gavi
ago,Angola,2005,mcv1,32,847500,271200,576300,afr,gavi
ago,Angola,2005,dtp1,54,847500,457650,389850,afr,gavi
ago,Angola,2006,mcv1,33,876049,289096,586953,afr,gavi
ago,Angola,2006,dtp1,57,876049,499348,376701,afr,gavi
ago,Angola,2006,dtp3,34,876049,297857,578192,afr,gavi
ago,Angola,2007,dtp3,73,904188,660057,244131,afr,gavi
ago,Angola,2007,dtp1,73,904188,660057,244131,afr,gavi
ago,Angola,2007,mcv1,71,904188,641973,262215,afr,gavi
ago,Angola,2008,dtp3,69,931639,642831,288808,afr,gavi
ago,Angola,2008,mcv1,61,931639,568300,363339,afr,gavi
ago,Angola,2008,dtp1,88,931639,819842,111797,afr,gavi
ago,Angola,2009,dtp1,79,958243,757012,201231,afr,gavi
ago,Angola,2009,mcv1,57,958243,546199,412044,afr,gavi
ago,Angola,2009,dtp3,60,958243,574946,383297,afr,gavi
ago,Angola,2010,dtp1,93,983959,915082,68877,afr,gavi
ago,Angola,2010,mcv1,72,983959,708450,275509,afr,gavi
ago,Angola,2010,dtp3,77,983959,757648,226311,afr,gavi
ago,Angola,2011,dtp3,71,1008914,716329,292585,afr,gavi
ago,Angola,2011,mcv1,64,1008914,645705,363209,afr,gavi
ago,Angola,2011,dtp1,88,1008914,887844,121070,afr,gavi
ago,Angola,2012,dtp3,75,1033508,775131,258377,afr,gavi
ago,Angola,2012,dtp1,83,1033508,857812,175696,afr,gavi
ago,Angola,2012,mcv1,72,1033508,744126,289382,afr,gavi
ago,Angola,2013,dtp3,77,1058122,814754,243368,afr,gavi
ago,Angola,2013,dtp1,79,1058122,835916,222206,afr,gavi
ago,Angola,2013,mcv1,66,1058122,698361,359761,afr,gavi
ago,Angola,2014,dtp1,81,1082973,877208,205765,afr,gavi
ago,Angola,2014,mcv1,60,1082973,649784,433189,afr,gavi
ago,Angola,2014,dtp3,64,1082973,693103,389870,afr,gavi
ago,Angola,2015,mcv1,55,1108261,609544,498717,afr,gavi
ago,Angola,2015,dtp1,77,1108261,853361,254900,afr,gavi
ago,Angola,2015,dtp3,64,1108261,709287,398974,afr,gavi
ago,Angola,2015,mcv2,26,1032858,268543,764315,afr,gavi
ago,Angola,2016,dtp1,79,1134119,895954,238165,afr,gavi
ago,Angola,2016,dtp3,64,1134119,725836,408283,afr,gavi
ago,Angola,2016,mcv1,49,1134119,555718,578401,afr,gavi
ago,Angola,2016,mcv2,26,1055343,274389,780954,afr,gavi
alb,Albania,2000,mcv1,95,49801,47311,2490,eur,mic_nongavi
alb,Albania,2000,dtp1,98,49801,48805,996,eur,mic_nongavi
alb,Albania,2000,dtp3,97,49801,48307,1494,eur,mic_nongavi
alb,Albania,2001,dtp3,97,47253,45835,1418,eur,mic_nongavi
alb,Albania,2001,mcv1,95,47253,44890,2363,eur,mic_nongavi
alb,Albania,2001,dtp1,97,47253,45835,1418,eur,mic_nongavi
alb,Albania,2001,mcv2,90,60372,54335,6037,eur,mic_nongavi
alb,Albania,2002,dtp1,98,44852,43955,897,eur,mic_nongavi
alb,Albania,2002,mcv1,96,44852,43058,1794,eur,mic_nongavi
alb,Albania,2002,dtp3,98,44852,43955,897,eur,mic_nongavi
alb,Albania,2002,mcv2,93,58163,54092,4071,eur,mic_nongavi
alb,Albania,2003,mcv1,93,42593,39611,2982,eur,mic_nongavi
alb,Albania,2003,dtp3,97,42593,41315,1278,eur,mic_nongavi
alb,Albania,2003,dtp1,97,42593,41315,1278,eur,mic_nongavi
alb,Albania,2003,mcv2,93,55842,51933,3909,eur,mic_nongavi
alb,Albania,2004,mcv1,96,40516,38895,1621,eur,mic_nongavi
alb,Albania,2004,dtp1,98,40516,39706,810,eur,mic_nongavi
alb,Albania,2004,dtp3,97,40516,39301,1215,eur,mic_nongavi
alb,Albania,2004,mcv2,96,53422,51285,2137,eur,mic_nongavi
alb,Albania,2005,mcv1,97,38686,37525,1161,eur,mic_nongavi
alb,Albania,2005,dtp1,99,38686,38299,387,eur,mic_nongavi
alb,Albania,2005,dtp3,98,38686,37912,774,eur,mic_nongavi
alb,Albania,2005,mcv2,97,50938,49410,1528,eur,mic_nongavi
alb,Albania,2006,dtp3,97,37180,36065,1115,eur,mic_nongavi
alb,Albania,2006,dtp1,98,37180,36436,744,eur,mic_nongavi
alb,Albania,2006,mcv1,95,37180,35321,1859,eur,mic_nongavi
alb,Albania,2006,mcv2,94,48391,45488,2903,eur,mic_nongavi
alb,Albania,2007,mcv1,97,36022,34941,1081,eur,mic_nongavi
alb,Albania,2007,dtp1,98,36022,35302,720,eur,mic_nongavi
alb,Albania,2007,dtp3,98,36022,35302,720,eur,mic_nongavi
alb,Albania,2007,mcv2,95,45695,43410,2285,eur,mic_nongavi
alb,Albania,2008,dtp1,99,35207,34855,352,eur,mic_nongavi
alb,Albania,2008,mcv1,98,35207,34503,704,eur,mic_nongavi
alb,Albania,2008,dtp3,99,35207,34855,352,eur,mic_nongavi
alb,Albania,2008,mcv2,98,42959,42100,859,eur,mic_nongavi
alb,Albania,2009,mcv1,97,34708,33667,1041,eur,mic_nongavi
alb,Albania,2009,dtp1,99,34708,34361,347,eur,mic_nongavi
alb,Albania,2009,dtp3,98,34708,34014,694,eur,mic_nongavi
alb,Albania,2009,mcv2,98,40345,39538,807,eur,mic_nongavi
alb,Albania,2010,dtp1,99,34465,34120,345,eur,mic_nongavi
alb,Albania,2010,mcv1,99,34465,34120,345,eur,mic_nongavi
alb,Albania,2010,dtp3,99,34465,34120,345,eur,mic_nongavi
alb,Albania,2010,mcv2,98,38027,37266,761,eur,mic_nongavi
alb,Albania,2011,dtp3,99,34396,34052,344,eur,mic_nongavi
alb,Albania,2011,dtp1,99,34396,34052,344,eur,mic_nongavi
alb,Albania,2011,mcv1,99,34396,34052,344,eur,mic_nongavi
alb,Albania,2011,mcv2,99,35565,35209,356,eur,mic_nongavi
alb,Albania,2012,dtp3,99,34407,34063,344,eur,mic_nongavi
alb,Albania,2012,dtp1,99,34407,34063,344,eur,mic_nongavi
alb,Albania,2012,mcv1,98,34407,33719,688,eur,mic_nongavi
alb,Albania,2012,mcv2,99,33696,33359,337,eur,mic_nongavi
alb,Albania,2013,dtp3,99,34417,34073,344,eur,mic_nongavi
alb,Albania,2013,mcv1,99,34417,34073,344,eur,mic_nongavi
alb,Albania,2013,dtp1,99,34417,34073,344,eur,mic_nongavi
alb,Albania,2013,mcv2,99,32358,32034,324,eur,mic_nongavi
alb,Albania,2014,dtp3,98,34380,33692,688,eur,mic_nongavi
alb,Albania,2014,dtp1,99,34380,34036,344,eur,mic_nongavi
alb,Albania,2014,mcv1,98,34380,33692,688,eur,mic_nongavi
alb,Albania,2014,mcv2,98,31448,30819,629,eur,mic_nongavi
alb,Albania,2015,dtp3,99,34276,33933,343,eur,mic_nongavi
alb,Albania,2015,mcv1,97,34276,33248,1028,eur,mic_nongavi
alb,Albania,2015,dtp1,99,34276,33933,343,eur,mic_nongavi
alb,Albania,2015,mcv2,98,30821,30205,616,eur,mic_nongavi
alb,Albania,2016,dtp3,98,34119,33437,682,eur,mic_nongavi
alb,Albania,2016,dtp1,99,34119,33778,341,eur,mic_nongavi
alb,Albania,2016,mcv1,96,34119,32754,1365,eur,mic_nongavi
alb,Albania,2016,mcv2,98,31440,30811,629,eur,mic_nongavi
and,Andorra,2000,mcv1,97,643.7665606454,624,19.7665606454,eur,hic
and,Andorra,2000,dtp1,99,643.7665606454,637,6.7665606454,eur,hic
and,Andorra,2000,dtp3,98,643.7665606454,631,12.7665606454,eur,hic
and,Andorra,2001,dtp1,98,675.1334458595,662,13.1334458595,eur,hic
and,Andorra,2001,mcv1,97,675.1334458595,655,20.1334458595,eur,hic
and,Andorra,2001,dtp3,96,675.1334458595,648,27.1334458595,eur,hic
and,Andorra,2002,mcv1,98,715.2988564886,701,14.2988564886,eur,hic
and,Andorra,2002,dtp1,99,715.2988564886,708,7.2988564886,eur,hic
and,Andorra,2002,dtp3,97,715.2988564886,694,21.2988564886,eur,hic
and,Andorra,2003,dtp3,99,759.8160598533,752,7.8160598533,eur,hic
and,Andorra,2003,dtp1,99,759.8160598533,752,7.8160598533,eur,hic
and,Andorra,2003,mcv1,96,759.8160598533,729,30.8160598533,eur,hic
and,Andorra,2004,dtp3,99,802.4906687063,794,8.4906687063,eur,hic
and,Andorra,2004,mcv1,98,802.4906687063,786,16.4906687063,eur,hic
and,Andorra,2004,dtp1,99,802.4906687063,794,8.4906687063,eur,hic
and,Andorra,2005,mcv1,94,837.3783032871,787,50.3783032871,eur,hic
and,Andorra,2005,dtp3,98,837.3783032871,821,16.3783032871,eur,hic
and,Andorra,2005,dtp1,99,837.3783032871,829,8.3783032871,eur,hic
and,Andorra,2006,mcv1,91,861.0948810608,784,77.0948810608,eur,hic
and,Andorra,2006,dtp3,93,861.0948810608,801,60.0948810608,eur,hic
and,Andorra,2006,dtp1,97,861.0948810608,835,26.0948810608,eur,hic
and,Andorra,2007,mcv1,94,873.2832544258,821,52.2832544258,eur,hic
and,Andorra,2007,dtp1,98,873.2832544258,856,17.2832544258,eur,hic
and,Andorra,2007,dtp3,96,873.2832544258,838,35.2832544258,eur,hic
and,Andorra,2007,mcv2,80,873.2832544258,699,174.2832544258,eur,hic
and,Andorra,2008,mcv1,98,873.7438109656,856,17.7438109656,eur,hic
and,Andorra,2008,dtp3,99,873.7438109656,865,8.7438109656,eur,hic
and,Andorra,2008,dtp1,99,873.7438109656,865,8.7438109656,eur,hic
and,Andorra,2008,mcv2,86,873.7438109656,751,122.7438109656,eur,hic
and,Andorra,2009,mcv1,98,863.2854635678,846,17.2854635678,eur,hic
and,Andorra,2009,dtp3,99,863.2854635678,855,8.2854635678,eur,hic
and,Andorra,2009,dtp1,99,863.2854635678,855,8.2854635678,eur,hic
and,Andorra,2009,mcv2,82,863.2854635678,708,155.2854635678,eur,hic
and,Andorra,2010,dtp3,99,843.5013469997,835,8.5013469997,eur,hic
and,Andorra,2010,dtp1,99,843.5013469997,835,8.5013469997,eur,hic
and,Andorra,2010,mcv1,99,843.5013469997,835,8.5013469997,eur,hic
and,Andorra,2010,mcv2,86,843.5013469997,725,118.5013469997,eur,hic
and,Andorra,2011,dtp1,99,816.186579919,808,8.186579919,eur,hic
and,Andorra,2011,dtp3,99,816.186579919,808,8.186579919,eur,hic
and,Andorra,2011,mcv1,99,816.186579919,808,8.186579919,eur,hic
and,Andorra,2011,mcv2,82,816.186579919,669,147.186579919,eur,hic
and,Andorra,2012,dtp1,99,784.3354614347,776,8.3354614347,eur,hic
and,Andorra,2012,mcv1,98,784.3354614347,769,15.3354614347,eur,hic
and,Andorra,2012,dtp3,99,784.3354614347,776,8.3354614347,eur,hic
and,Andorra,2012,mcv2,89,784.3354614347,698,86.3354614347,eur,hic
and,Andorra,2013,mcv1,95,751.9622409644,714,37.9622409644,eur,hic
and,Andorra,2013,dtp3,96,751.9622409644,722,29.9622409644,eur,hic
and,Andorra,2013,dtp1,98,751.9622409644,737,14.9622409644,eur,hic
and,Andorra,2013,mcv2,91,751.9622409644,684,67.9622409644,eur,hic
and,Andorra,2014,mcv1,96,722.4367538503,694,28.4367538503,eur,hic
and,Andorra,2014,dtp3,97,722.4367538503,701,21.4367538503,eur,hic
and,Andorra,2014,dtp1,99,722.4367538503,715,7.4367538503,eur,hic
and,Andorra,2014,mcv2,90,722.4367538503,650,72.4367538503,eur,hic
and,Andorra,2015,dtp3,97,697.6830922045,677,20.6830922045,eur,hic
and,Andorra,2015,mcv1,96,697.6830922045,670,27.6830922045,eur,hic
and,Andorra,2015,dtp1,99,697.6830922045,691,6.6830922045,eur,hic
and,Andorra,2015,mcv2,88,697.6830922045,614,83.6830922045,eur,hic
and,Andorra,2016,dtp3,98,678.1963742368,665,13.1963742368,eur,hic
and,Andorra,2016,mcv1,97,678.1963742368,658,20.1963742368,eur,hic
and,Andorra,2016,dtp1,99,678.1963742368,671,7.1963742368,eur,hic
and,Andorra,2016,mcv2,90,NA,NA,#VALUE!,eur,hic
are,United Arab Emirates,2000,dtp3,94,52686,49525,3161,emr,hic
are,United Arab Emirates,2000,mcv1,94,52686,49525,3161,emr,hic
are,United Arab Emirates,2000,dtp1,96,52686,50579,2107,emr,hic
are,United Arab Emirates,2000,mcv2,92,53840,49533,4307,emr,hic
are,United Arab Emirates,2001,mcv1,94,55030,51728,3302,emr,hic
are,United Arab Emirates,2001,dtp1,96,55030,52829,2201,emr,hic
are,United Arab Emirates,2001,dtp3,94,55030,51728,3302,emr,hic
are,United Arab Emirates,2001,mcv2,92,50948,46872,4076,emr,hic
are,United Arab Emirates,2002,dtp1,96,58037,55716,2321,emr,hic
are,United Arab Emirates,2002,dtp3,94,58037,54555,3482,emr,hic
are,United Arab Emirates,2002,mcv1,94,58037,54555,3482,emr,hic
are,United Arab Emirates,2002,mcv2,92,49185,45250,3935,emr,hic
are,United Arab Emirates,2003,dtp1,96,61618,59153,2465,emr,hic
are,United Arab Emirates,2003,mcv1,94,61618,57921,3697,emr,hic
are,United Arab Emirates,2003,dtp3,94,61618,57921,3697,emr,hic
are,United Arab Emirates,2003,mcv2,92,51847,47699,4148,emr,hic
are,United Arab Emirates,2004,dtp1,96,65653,63027,2626,emr,hic
are,United Arab Emirates,2004,dtp3,94,65653,61714,3939,emr,hic
are,United Arab Emirates,2004,mcv1,94,65653,61714,3939,emr,hic
are,United Arab Emirates,2004,mcv2,92,54124,49794,4330,emr,hic
are,United Arab Emirates,2005,dtp1,97,69995,67895,2100,emr,hic
are,United Arab Emirates,2005,mcv1,92,69995,64395,5600,emr,hic
are,United Arab Emirates,2005,dtp3,94,69995,65795,4200,emr,hic
are,United Arab Emirates,2005,mcv2,94,54616,51339,3277,emr,hic
are,United Arab Emirates,2006,mcv1,92,74473,68515,5958,emr,hic
are,United Arab Emirates,2006,dtp3,92,74473,68515,5958,emr,hic
are,United Arab Emirates,2006,dtp1,97,74473,72239,2234,emr,hic
are,United Arab Emirates,2006,mcv2,93,56906,52923,3983,emr,hic
are,United Arab Emirates,2007,mcv1,92,78864,72555,6309,emr,hic
are,United Arab Emirates,2007,dtp1,97,78864,76498,2366,emr,hic
are,United Arab Emirates,2007,dtp3,92,78864,72555,6309,emr,hic
are,United Arab Emirates,2007,mcv2,93,60507,56272,4235,emr,hic
are,United Arab Emirates,2008,mcv1,92,82937,76302,6635,emr,hic
are,United Arab Emirates,2008,dtp3,92,82937,76302,6635,emr,hic
are,United Arab Emirates,2008,dtp1,96,82937,79620,3317,emr,hic
are,United Arab Emirates,2008,mcv2,92,64795,59611,5184,emr,hic
are,United Arab Emirates,2009,dtp3,93,86498,80443,6055,emr,hic
are,United Arab Emirates,2009,dtp1,95,86498,82173,4325,emr,hic
are,United Arab Emirates,2009,mcv1,93,86498,80443,6055,emr,hic
are,United Arab Emirates,2009,mcv2,93,68576,63776,4800,emr,hic
are,United Arab Emirates,2010,dtp1,94,89323,83964,5359,emr,hic
are,United Arab Emirates,2010,mcv1,94,89323,83964,5359,emr,hic
are,United Arab Emirates,2010,dtp3,94,89323,83964,5359,emr,hic
are,United Arab Emirates,2010,mcv2,94,73883,69450,4433,emr,hic
are,United Arab Emirates,2011,dtp1,95,91231,86669,4562,emr,hic
are,United Arab Emirates,2011,mcv1,95,91231,86669,4562,emr,hic
are,United Arab Emirates,2011,dtp3,95,91231,86669,4562,emr,hic
are,United Arab Emirates,2011,mcv2,95,79853,75860,3993,emr,hic
are,United Arab Emirates,2012,dtp3,96,92256,88566,3690,emr,hic
are,United Arab Emirates,2012,dtp1,96,92256,88566,3690,emr,hic
are,United Arab Emirates,2012,mcv1,96,92256,88566,3690,emr,hic
are,United Arab Emirates,2012,mcv2,96,84945,81547,3398,emr,hic
are,United Arab Emirates,2013,dtp3,98,92493,90643,1850,emr,hic
are,United Arab Emirates,2013,dtp1,98,92493,90643,1850,emr,hic
are,United Arab Emirates,2013,mcv1,98,92493,90643,1850,emr,hic
are,United Arab Emirates,2013,mcv2,98,88974,87195,1779,emr,hic
are,United Arab Emirates,2014,mcv1,99,92038,91118,920,emr,hic
are,United Arab Emirates,2014,dtp3,99,92038,91118,920,emr,hic
are,United Arab Emirates,2014,dtp1,99,92038,91118,920,emr,hic
are,United Arab Emirates,2014,mcv2,99,91913,90994,919,emr,hic
are,United Arab Emirates,2015,mcv1,99,91052,90141,911,emr,hic
are,United Arab Emirates,2015,dtp3,99,91052,90141,911,emr,hic
are,United Arab Emirates,2015,dtp1,99,91052,90141,911,emr,hic
are,United Arab Emirates,2015,mcv2,99,93478,92543,935,emr,hic
are,United Arab Emirates,2016,mcv1,99,89739,88842,897,emr,hic
are,United Arab Emirates,2016,dtp3,99,89739,88842,897,emr,hic
are,United Arab Emirates,2016,dtp1,99,89739,88842,897,emr,hic
are,United Arab Emirates,2016,mcv2,99,94825,93877,948,emr,hic
arg,Argentina,2000,dtp3,83,706891,586720,120171,amr,mic_nongavi
arg,Argentina,2000,dtp1,96,706891,678615,28276,amr,mic_nongavi
arg,Argentina,2000,mcv1,91,706891,643271,63620,amr,mic_nongavi
arg,Argentina,2000,mcv2,56,696477,390027,306450,amr,mic_nongavi
arg,Argentina,2001,mcv1,89,711582,633308,78274,amr,mic_nongavi
arg,Argentina,2001,dtp3,83,711582,590613,120969,amr,mic_nongavi
arg,Argentina,2001,dtp1,96,711582,683119,28463,amr,mic_nongavi
arg,Argentina,2001,mcv2,56,703297,393846,309451,amr,mic_nongavi
arg,Argentina,2002,mcv1,95,716283,680469,35814,amr,mic_nongavi
arg,Argentina,2002,dtp1,96,716283,687632,28651,amr,mic_nongavi
arg,Argentina,2002,dtp3,93,716283,666143,50140,amr,mic_nongavi
arg,Argentina,2002,mcv2,83,699850,580876,118974,amr,mic_nongavi
arg,Argentina,2003,dtp3,96,720453,691635,28818,amr,mic_nongavi
arg,Argentina,2003,dtp1,96,720453,691635,28818,amr,mic_nongavi
arg,Argentina,2003,mcv1,97,720453,698839,21614,amr,mic_nongavi
arg,Argentina,2003,mcv2,80,695381,556305,139076,amr,mic_nongavi
arg,Argentina,2004,mcv1,99,723900,716661,7239,amr,mic_nongavi
arg,Argentina,2004,dtp1,99,723900,716661,7239,amr,mic_nongavi
arg,Argentina,2004,dtp3,98,723900,709422,14478,amr,mic_nongavi
arg,Argentina,2004,mcv2,93,691621,643208,48413,amr,mic_nongavi
arg,Argentina,2005,dtp3,98,726652,712119,14533,amr,mic_nongavi
arg,Argentina,2005,dtp1,99,726652,719385,7267,amr,mic_nongavi
arg,Argentina,2005,mcv1,98,726652,712119,14533,amr,mic_nongavi
arg,Argentina,2005,mcv2,88,690794,607899,82895,amr,mic_nongavi
arg,Argentina,2006,dtp1,93,728939,677913,51026,amr,mic_nongavi
arg,Argentina,2006,mcv1,97,728939,707071,21868,amr,mic_nongavi
arg,Argentina,2006,dtp3,91,728939,663334,65605,amr,mic_nongavi
arg,Argentina,2006,mcv2,91,693371,630968,62403,amr,mic_nongavi
arg,Argentina,2007,mcv1,94,731127,687259,43868,amr,mic_nongavi
arg,Argentina,2007,dtp3,91,731127,665326,65801,amr,mic_nongavi
arg,Argentina,2007,dtp1,94,731127,687259,43868,amr,mic_nongavi
arg,Argentina,2007,mcv2,84,699713,587759,111954,amr,mic_nongavi
arg,Argentina,2008,mcv1,96,733453,704115,29338,amr,mic_nongavi
arg,Argentina,2008,dtp1,97,733453,711449,22004,amr,mic_nongavi
arg,Argentina,2008,dtp3,93,733453,682111,51342,amr,mic_nongavi
arg,Argentina,2008,mcv2,88,708061,623094,84967,amr,mic_nongavi
arg,Argentina,2009,mcv1,96,735909,706473,29436,amr,mic_nongavi
arg,Argentina,2009,dtp3,94,735909,691754,44155,amr,mic_nongavi
arg,Argentina,2009,dtp1,94,735909,691754,44155,amr,mic_nongavi
arg,Argentina,2009,mcv2,96,716568,687905,28663,amr,mic_nongavi
arg,Argentina,2010,mcv1,95,738373,701454,36919,amr,mic_nongavi
arg,Argentina,2010,dtp1,95,738373,701454,36919,amr,mic_nongavi
arg,Argentina,2010,dtp3,94,738373,694071,44302,amr,mic_nongavi
arg,Argentina,2010,mcv2,94,722669,679309,43360,amr,mic_nongavi
arg,Argentina,2011,dtp3,91,740627,673971,66656,amr,mic_nongavi
arg,Argentina,2011,dtp1,94,740627,696189,44438,amr,mic_nongavi
arg,Argentina,2011,mcv1,95,740627,703596,37031,amr,mic_nongavi
arg,Argentina,2011,mcv2,91,726749,661342,65407,amr,mic_nongavi
arg,Argentina,2012,dtp1,94,742430,697884,44546,amr,mic_nongavi
arg,Argentina,2012,mcv1,94,742430,697884,44546,amr,mic_nongavi
arg,Argentina,2012,dtp3,91,742430,675611,66819,amr,mic_nongavi
arg,Argentina,2012,mcv2,89,728425,648298,80127,amr,mic_nongavi
arg,Argentina,2013,dtp1,94,743609,698992,44617,amr,mic_nongavi
arg,Argentina,2013,mcv1,94,743609,698992,44617,amr,mic_nongavi
arg,Argentina,2013,dtp3,94,743609,698992,44617,amr,mic_nongavi
arg,Argentina,2013,mcv2,83,728683,604807,123876,amr,mic_nongavi
arg,Argentina,2014,dtp3,94,744120,699473,44647,amr,mic_nongavi
arg,Argentina,2014,dtp1,98,744120,729238,14882,amr,mic_nongavi
arg,Argentina,2014,mcv1,95,744120,706914,37206,amr,mic_nongavi
arg,Argentina,2014,mcv2,96,728583,699440,29143,amr,mic_nongavi
arg,Argentina,2015,mcv1,89,743972,662135,81837,amr,mic_nongavi
arg,Argentina,2015,dtp3,94,743972,699334,44638,amr,mic_nongavi
arg,Argentina,2015,dtp1,94,743972,699334,44638,amr,mic_nongavi
arg,Argentina,2015,mcv2,87,729642,634789,94853,amr,mic_nongavi
arg,Argentina,2016,mcv1,90,743245,668920,74325,amr,mic_nongavi
arg,Argentina,2016,dtp3,92,743245,683785,59460,amr,mic_nongavi
arg,Argentina,2016,dtp1,97,743245,720948,22297,amr,mic_nongavi
arg,Argentina,2016,mcv2,88,732410,644521,87889,amr,mic_nongavi
arm,Armenia,2000,mcv1,92,38377,35307,3070,eur,gavi
arm,Armenia,2000,dtp3,93,38377,35691,2686,eur,gavi
arm,Armenia,2000,dtp1,97,38377,37226,1151,eur,gavi
arm,Armenia,2000,mcv2,94,42098,39572,2526,eur,gavi
arm,Armenia,2001,mcv1,93,38358,35673,2685,eur,gavi
arm,Armenia,2001,dtp3,94,38358,36057,2301,eur,gavi
arm,Armenia,2001,dtp1,98,38358,37591,767,eur,gavi
arm,Armenia,2001,mcv2,96,38843,37289,1554,eur,gavi
arm,Armenia,2002,dtp3,94,38858,36527,2331,eur,gavi
arm,Armenia,2002,dtp1,98,38858,38081,777,eur,gavi
arm,Armenia,2002,mcv1,91,38858,35361,3497,eur,gavi
arm,Armenia,2002,mcv2,95,36130,34324,1806,eur,gavi
arm,Armenia,2003,mcv1,94,39634,37256,2378,eur,gavi
arm,Armenia,2003,dtp1,98,39634,38841,793,eur,gavi
arm,Armenia,2003,dtp3,94,39634,37256,2378,eur,gavi
arm,Armenia,2003,mcv2,93,41059,38185,2874,eur,gavi
arm,Armenia,2004,mcv1,92,40529,37287,3242,eur,gavi
arm,Armenia,2004,dtp3,91,40529,36881,3648,eur,gavi
arm,Armenia,2004,dtp1,97,40529,39313,1216,eur,gavi
arm,Armenia,2004,mcv2,94,38080,35795,2285,eur,gavi
arm,Armenia,2005,dtp3,90,41394,37255,4139,eur,gavi
arm,Armenia,2005,dtp1,96,41394,39738,1656,eur,gavi
arm,Armenia,2005,mcv1,94,41394,38910,2484,eur,gavi
arm,Armenia,2005,mcv2,92,35821,32955,2866,eur,gavi
arm,Armenia,2006,dtp1,95,42121,40015,2106,eur,gavi
arm,Armenia,2006,dtp3,87,42121,36645,5476,eur,gavi
arm,Armenia,2006,mcv1,92,42121,38751,3370,eur,gavi
arm,Armenia,2006,mcv2,85,34427,29263,5164,eur,gavi
arm,Armenia,2007,dtp3,88,42680,37558,5122,eur,gavi
arm,Armenia,2007,dtp1,96,42680,40973,1707,eur,gavi
arm,Armenia,2007,mcv1,92,42680,39266,3414,eur,gavi
arm,Armenia,2007,mcv2,93,34009,31628,2381,eur,gavi
arm,Armenia,2008,dtp1,96,43045,41323,1722,eur,gavi
arm,Armenia,2008,mcv1,94,43045,40462,2583,eur,gavi
arm,Armenia,2008,dtp3,89,43045,38310,4735,eur,gavi
arm,Armenia,2008,mcv2,94,34261,32205,2056,eur,gavi
arm,Armenia,2009,mcv1,96,43167,41440,1727,eur,gavi
arm,Armenia,2009,dtp1,97,43167,41872,1295,eur,gavi
arm,Armenia,2009,dtp3,93,43167,40145,3022,eur,gavi
arm,Armenia,2009,mcv2,96,34875,33480,1395,eur,gavi
arm,Armenia,2010,dtp1,98,43024,42164,860,eur,gavi
arm,Armenia,2010,mcv1,97,43024,41733,1291,eur,gavi
arm,Armenia,2010,dtp3,94,43024,40443,2581,eur,gavi
arm,Armenia,2010,mcv2,97,35368,34307,1061,eur,gavi
arm,Armenia,2011,dtp1,98,42627,41774,853,eur,gavi
arm,Armenia,2011,mcv1,97,42627,41348,1279,eur,gavi
arm,Armenia,2011,dtp3,95,42627,40496,2131,eur,gavi
arm,Armenia,2011,mcv2,98,36132,35409,723,eur,gavi
arm,Armenia,2012,dtp1,98,42045,41204,841,eur,gavi
arm,Armenia,2012,dtp3,95,42045,39943,2102,eur,gavi
arm,Armenia,2012,mcv1,97,42045,40784,1261,eur,gavi
arm,Armenia,2012,mcv2,97,37294,36175,1119,eur,gavi
arm,Armenia,2013,mcv1,97,41341,40101,1240,eur,gavi
arm,Armenia,2013,dtp3,95,41341,39274,2067,eur,gavi
arm,Armenia,2013,dtp1,97,41341,40101,1240,eur,gavi
arm,Armenia,2013,mcv2,97,38639,37480,1159,eur,gavi
arm,Armenia,2014,mcv1,97,40548,39332,1216,eur,gavi
arm,Armenia,2014,dtp3,93,40548,37710,2838,eur,gavi
arm,Armenia,2014,dtp1,97,40548,39332,1216,eur,gavi
arm,Armenia,2014,mcv2,97,39950,38752,1198,eur,gavi
arm,Armenia,2015,dtp3,94,39688,37307,2381,eur,gavi
arm,Armenia,2015,dtp1,97,39688,38497,1191,eur,gavi
arm,Armenia,2015,mcv1,97,39688,38497,1191,eur,gavi
arm,Armenia,2015,mcv2,97,40968,39739,1229,eur,gavi
arm,Armenia,2016,dtp1,97,38776,37613,1163,eur,gavi
arm,Armenia,2016,mcv1,97,38776,37613,1163,eur,gavi
arm,Armenia,2016,dtp3,94,38776,36449,2327,eur,gavi
arm,Armenia,2016,mcv2,97,41640,40391,1249,eur,gavi
atg,Antigua and Barbuda,2000,dtp1,98,1684,1650,34,amr,hic
atg,Antigua and Barbuda,2000,dtp3,95,1684,1600,84,amr,hic
atg,Antigua and Barbuda,2000,mcv1,95,1684,1600,84,amr,hic
atg,Antigua and Barbuda,2001,dtp1,99,1699,1682,17,amr,hic
atg,Antigua and Barbuda,2001,dtp3,97,1699,1648,51,amr,hic
atg,Antigua and Barbuda,2001,mcv1,97,1699,1648,51,amr,hic
atg,Antigua and Barbuda,2002,dtp3,98,1704,1670,34,amr,hic
atg,Antigua and Barbuda,2002,mcv1,99,1704,1687,17,amr,hic
atg,Antigua and Barbuda,2002,dtp1,98,1704,1670,34,amr,hic
atg,Antigua and Barbuda,2003,dtp1,99,1701,1684,17,amr,hic
atg,Antigua and Barbuda,2003,dtp3,99,1701,1684,17,amr,hic
atg,Antigua and Barbuda,2003,mcv1,99,1701,1684,17,amr,hic
atg,Antigua and Barbuda,2004,dtp3,97,1693,1642,51,amr,hic
atg,Antigua and Barbuda,2004,mcv1,97,1693,1642,51,amr,hic
atg,Antigua and Barbuda,2004,dtp1,99,1693,1676,17,amr,hic
atg,Antigua and Barbuda,2005,dtp3,99,1682,1665,17,amr,hic
atg,Antigua and Barbuda,2005,dtp1,99,1682,1665,17,amr,hic
atg,Antigua and Barbuda,2005,mcv1,99,1682,1665,17,amr,hic
atg,Antigua and Barbuda,2005,mcv2,46,1728,795,933,amr,hic
atg,Antigua and Barbuda,2006,dtp3,99,1668,1651,17,amr,hic
atg,Antigua and Barbuda,2006,dtp1,99,1668,1651,17,amr,hic
atg,Antigua and Barbuda,2006,mcv1,99,1668,1651,17,amr,hic
atg,Antigua and Barbuda,2006,mcv2,68,1724,1172,552,amr,hic
atg,Antigua and Barbuda,2007,dtp3,99,1654,1637,17,amr,hic
atg,Antigua and Barbuda,2007,dtp1,99,1654,1637,17,amr,hic
atg,Antigua and Barbuda,2007,mcv1,99,1654,1637,17,amr,hic
atg,Antigua and Barbuda,2007,mcv2,78,1708,1332,376,amr,hic
atg,Antigua and Barbuda,2008,dtp3,99,1642,1626,16,amr,hic
atg,Antigua and Barbuda,2008,mcv1,99,1642,1626,16,amr,hic
atg,Antigua and Barbuda,2008,dtp1,99,1642,1626,16,amr,hic
atg,Antigua and Barbuda,2008,mcv2,83,1688,1401,287,amr,hic
atg,Antigua and Barbuda,2009,dtp1,99,1631,1615,16,amr,hic
atg,Antigua and Barbuda,2009,dtp3,99,1631,1615,16,amr,hic
atg,Antigua and Barbuda,2009,mcv1,99,1631,1615,16,amr,hic
atg,Antigua and Barbuda,2009,mcv2,94,1669,1569,100,amr,hic
atg,Antigua and Barbuda,2010,dtp3,98,1623,1591,32,amr,hic
atg,Antigua and Barbuda,2010,mcv1,98,1623,1591,32,amr,hic
atg,Antigua and Barbuda,2010,dtp1,99,1623,1607,16,amr,hic
atg,Antigua and Barbuda,2010,mcv2,92,1655,1523,132,amr,hic
atg,Antigua and Barbuda,2011,mcv1,99,1620,1604,16,amr,hic
atg,Antigua and Barbuda,2011,dtp1,99,1620,1604,16,amr,hic
atg,Antigua and Barbuda,2011,dtp3,99,1620,1604,16,amr,hic
atg,Antigua and Barbuda,2011,mcv2,89,1641,1460,181,amr,hic
atg,Antigua and Barbuda,2012,mcv1,98,1618,1586,32,amr,hic
atg,Antigua and Barbuda,2012,dtp3,98,1618,1586,32,amr,hic
atg,Antigua and Barbuda,2012,dtp1,99,1618,1602,16,amr,hic
atg,Antigua and Barbuda,2012,mcv2,90,1619,1457,162,amr,hic
atg,Antigua and Barbuda,2013,mcv1,98,1618,1586,32,amr,hic
atg,Antigua and Barbuda,2013,dtp3,99,1618,1602,16,amr,hic
atg,Antigua and Barbuda,2013,dtp1,99,1618,1602,16,amr,hic
atg,Antigua and Barbuda,2013,mcv2,87,1611,1402,209,amr,hic
atg,Antigua and Barbuda,2014,dtp3,99,1620,1604,16,amr,hic
atg,Antigua and Barbuda,2014,mcv1,98,1620,1588,32,amr,hic
atg,Antigua and Barbuda,2014,dtp1,99,1620,1604,16,amr,hic
atg,Antigua and Barbuda,2014,mcv2,87,1604,1395,209,amr,hic
atg,Antigua and Barbuda,2015,dtp1,99,1622,1606,16,amr,hic
atg,Antigua and Barbuda,2015,mcv1,98,1622,1590,32,amr,hic
atg,Antigua and Barbuda,2015,dtp3,99,1622,1606,16,amr,hic
atg,Antigua and Barbuda,2015,mcv2,87,1598,1390,208,amr,hic
atg,Antigua and Barbuda,2016,dtp1,99,1626,1610,16,amr,hic
atg,Antigua and Barbuda,2016,mcv1,98,1626,1593,33,amr,hic
atg,Antigua and Barbuda,2016,dtp3,99,1626,1610,16,amr,hic
atg,Antigua and Barbuda,2016,mcv2,87,1599,1391,208,amr,hic
aus,Australia,2000,dtp1,96,246409,236553,9856,wpr,hic
aus,Australia,2000,dtp3,90,246409,221768,24641,wpr,hic
aus,Australia,2000,mcv1,91,246409,224232,22177,wpr,hic
aus,Australia,2001,dtp1,97,247666,240236,7430,wpr,hic
aus,Australia,2001,mcv1,92,247666,227853,19813,wpr,hic
aus,Australia,2001,dtp3,92,247666,227853,19813,wpr,hic
aus,Australia,2002,mcv1,94,250729,235685,15044,wpr,hic
aus,Australia,2002,dtp3,92,250729,230671,20058,wpr,hic
aus,Australia,2002,dtp1,97,250729,243207,7522,wpr,hic
aus,Australia,2003,dtp3,93,255516,237630,17886,wpr,hic
aus,Australia,2003,dtp1,97,255516,247851,7665,wpr,hic
aus,Australia,2003,mcv1,94,255516,240185,15331,wpr,hic
aus,Australia,2004,dtp1,97,261811,253957,7854,wpr,hic
aus,Australia,2004,dtp3,92,261811,240866,20945,wpr,hic
aus,Australia,2004,mcv1,94,261811,246102,15709,wpr,hic
aus,Australia,2004,mcv2,85,255297,217002,38295,wpr,hic
aus,Australia,2005,dtp1,97,269116,261043,8073,wpr,hic
aus,Australia,2005,dtp3,92,269116,247587,21529,wpr,hic
aus,Australia,2005,mcv1,94,269116,252969,16147,wpr,hic
aus,Australia,2005,mcv2,85,256492,218018,38474,wpr,hic
aus,Australia,2006,dtp3,92,276749,254609,22140,wpr,hic
aus,Australia,2006,mcv1,94,276749,260144,16605,wpr,hic
aus,Australia,2006,dtp1,97,276749,268447,8302,wpr,hic
aus,Australia,2006,mcv2,87,257377,223918,33459,wpr,hic
aus,Australia,2007,dtp3,92,283993,261274,22719,wpr,hic
aus,Australia,2007,mcv1,94,283993,266953,17040,wpr,hic
aus,Australia,2007,dtp1,97,283993,275473,8520,wpr,hic
aus,Australia,2007,mcv2,89,259798,231220,28578,wpr,hic
aus,Australia,2008,dtp3,92,290288,267065,23223,wpr,hic
aus,Australia,2008,dtp1,97,290288,281579,8709,wpr,hic
aus,Australia,2008,mcv1,94,290288,272871,17417,wpr,hic
aus,Australia,2008,mcv2,80,263861,211089,52772,wpr,hic
aus,Australia,2009,mcv1,94,295365,277643,17722,wpr,hic
aus,Australia,2009,dtp1,97,295365,286504,8861,wpr,hic
aus,Australia,2009,dtp3,92,295365,271736,23629,wpr,hic
aus,Australia,2009,mcv2,82,269626,221093,48533,wpr,hic
aus,Australia,2010,dtp1,97,299168,290193,8975,wpr,hic
aus,Australia,2010,mcv1,94,299168,281218,17950,wpr,hic
aus,Australia,2010,dtp3,92,299168,275235,23933,wpr,hic
aus,Australia,2010,mcv2,88,277170,243910,33260,wpr,hic
aus,Australia,2011,dtp1,92,301895,277743,24152,wpr,hic
aus,Australia,2011,mcv1,94,301895,283781,18114,wpr,hic
aus,Australia,2011,dtp3,92,301895,277743,24152,wpr,hic
aus,Australia,2011,mcv2,90,286364,257728,28636,wpr,hic
aus,Australia,2012,dtp1,92,304028,279706,24322,wpr,hic
aus,Australia,2012,dtp3,92,304028,279706,24322,wpr,hic
aus,Australia,2012,mcv1,94,304028,285786,18242,wpr,hic
aus,Australia,2012,mcv2,91,296282,269617,26665,wpr,hic
aus,Australia,2013,dtp3,91,305954,278418,27536,wpr,hic
aus,Australia,2013,mcv1,94,305954,287597,18357,wpr,hic
aus,Australia,2013,dtp1,92,305954,281478,24476,wpr,hic
aus,Australia,2013,mcv2,92,305507,281066,24441,wpr,hic
aus,Australia,2014,dtp3,92,307799,283175,24624,wpr,hic
aus,Australia,2014,dtp1,92,307799,283175,24624,wpr,hic
aus,Australia,2014,mcv1,94,307799,289331,18468,wpr,hic
aus,Australia,2014,mcv2,93,312178,290326,21852,wpr,hic
aus,Australia,2015,dtp1,97,309617,300328,9289,wpr,hic
aus,Australia,2015,mcv1,95,309617,294136,15481,wpr,hic
aus,Australia,2015,dtp3,93,309617,287944,21673,wpr,hic
aus,Australia,2015,mcv2,93,314067,292082,21985,wpr,hic
aus,Australia,2016,dtp3,94,311379,292696,18683,wpr,hic
aus,Australia,2016,mcv1,95,311379,295810,15569,wpr,hic
aus,Australia,2016,dtp1,98,311379,305151,6228,wpr,hic
aus,Australia,2016,mcv2,94,316605,297609,18996,wpr,hic
aut,Austria,2000,dtp1,99,79946,79147,799,eur,hic
aut,Austria,2000,dtp3,81,79946,64756,15190,eur,hic
aut,Austria,2000,mcv1,75,79946,59960,19986,eur,hic
aut,Austria,2000,mcv2,35,94943,33230,61713,eur,hic
aut,Austria,2001,dtp3,84,78975,66339,12636,eur,hic
aut,Austria,2001,dtp1,99,78975,78185,790,eur,hic
aut,Austria,2001,mcv1,79,78975,62390,16585,eur,hic
aut,Austria,2001,mcv2,34,93778,31885,61893,eur,hic
aut,Austria,2002,dtp1,99,78205,77423,782,eur,hic
aut,Austria,2002,dtp3,83,78205,64910,13295,eur,hic
aut,Austria,2002,mcv1,78,78205,61000,17205,eur,hic
aut,Austria,2002,mcv2,39,76151,29699,46452,eur,hic
aut,Austria,2003,dtp3,84,77595,65180,12415,eur,hic
aut,Austria,2003,dtp1,99,77595,76819,776,eur,hic
aut,Austria,2003,mcv1,79,77595,61300,16295,eur,hic
aut,Austria,2003,mcv2,46,80380,36975,43405,eur,hic
aut,Austria,2004,dtp3,83,77152,64036,13116,eur,hic
aut,Austria,2004,dtp1,99,77152,76380,772,eur,hic
aut,Austria,2004,mcv1,74,77152,57092,20060,eur,hic
aut,Austria,2004,mcv2,47,79525,37377,42148,eur,hic
aut,Austria,2005,dtp1,99,76892,76123,769,eur,hic
aut,Austria,2005,dtp3,86,76892,66127,10765,eur,hic
aut,Austria,2005,mcv1,75,76892,57669,19223,eur,hic
aut,Austria,2005,mcv2,54,78813,42559,36254,eur,hic
aut,Austria,2006,dtp3,83,76830,63769,13061,eur,hic
aut,Austria,2006,dtp1,99,76830,76062,768,eur,hic
aut,Austria,2006,mcv1,80,76830,61464,15366,eur,hic
aut,Austria,2006,mcv2,61,79501,48496,31005,eur,hic
aut,Austria,2007,dtp3,85,76961,65417,11544,eur,hic
aut,Austria,2007,dtp1,99,76961,76191,770,eur,hic
aut,Austria,2007,mcv1,79,76961,60799,16162,eur,hic
aut,Austria,2007,mcv2,56,80277,44955,35322,eur,hic
aut,Austria,2008,dtp3,83,77270,64134,13136,eur,hic
aut,Austria,2008,dtp1,97,77270,74952,2318,eur,hic
aut,Austria,2008,mcv1,83,77270,64134,13136,eur,hic
aut,Austria,2008,mcv2,62,77785,48227,29558,eur,hic
aut,Austria,2009,dtp3,83,77739,64523,13216,eur,hic
aut,Austria,2009,dtp1,93,77739,72297,5442,eur,hic
aut,Austria,2009,mcv1,76,77739,59082,18657,eur,hic
aut,Austria,2009,mcv2,64,77872,49838,28034,eur,hic
aut,Austria,2010,dtp3,86,78360,67390,10970,eur,hic
aut,Austria,2010,mcv1,80,78360,62688,15672,eur,hic
aut,Austria,2010,dtp1,98,78360,76793,1567,eur,hic
aut,Austria,2010,mcv2,69,78172,53939,24233,eur,hic
aut,Austria,2011,dtp3,89,79126,70422,8704,eur,hic
aut,Austria,2011,mcv1,84,79126,66466,12660,eur,hic
aut,Austria,2011,dtp1,99,79126,78335,791,eur,hic
aut,Austria,2011,mcv2,73,78205,57090,21115,eur,hic
aut,Austria,2012,mcv1,88,80007,70406,9601,eur,hic
aut,Austria,2012,dtp1,99,80007,79207,800,eur,hic
aut,Austria,2012,dtp3,92,80007,73606,6401,eur,hic
aut,Austria,2012,mcv2,78,78507,61235,17272,eur,hic
aut,Austria,2013,mcv1,92,80959,74482,6477,eur,hic
aut,Austria,2013,dtp3,95,80959,76911,4048,eur,hic
aut,Austria,2013,dtp1,99,80959,80149,810,eur,hic
aut,Austria,2013,mcv2,82,79860,65485,14375,eur,hic
aut,Austria,2014,dtp1,99,81933,81114,819,eur,hic
aut,Austria,2014,mcv1,96,81933,78656,3277,eur,hic
aut,Austria,2014,dtp3,98,81933,80294,1639,eur,hic
aut,Austria,2014,mcv2,87,80595,70118,10477,eur,hic
aut,Austria,2015,mcv1,96,82872,79557,3315,eur,hic
aut,Austria,2015,dtp1,99,82872,82043,829,eur,hic
aut,Austria,2015,dtp3,93,82872,77071,5801,eur,hic
aut,Austria,2015,mcv2,88,81302,71546,9756,eur,hic
aut,Austria,2016,mcv1,95,83728,79542,4186,eur,hic
aut,Austria,2016,dtp3,87,83728,72843,10885,eur,hic
aut,Austria,2016,dtp1,99,83728,82891,837,eur,hic
aut,Austria,2016,mcv2,89,82188,73147,9041,eur,hic
aze,Azerbaijan,2000,mcv1,67,132532,88796,43736,eur,gavi
aze,Azerbaijan,2000,dtp1,83,132532,110002,22530,eur,gavi
aze,Azerbaijan,2000,dtp3,76,132532,100724,31808,eur,gavi
aze,Azerbaijan,2001,mcv1,68,130081,88455,41626,eur,gavi
aze,Azerbaijan,2001,dtp1,83,130081,107967,22114,eur,gavi
aze,Azerbaijan,2001,dtp3,77,130081,100162,29919,eur,gavi
aze,Azerbaijan,2001,mcv2,65,166825,108436,58389,eur,gavi
aze,Azerbaijan,2002,dtp1,82,128815,105628,23187,eur,gavi
aze,Azerbaijan,2002,dtp3,76,128815,97899,30916,eur,gavi
aze,Azerbaijan,2002,mcv1,66,128815,85018,43797,eur,gavi
aze,Azerbaijan,2002,mcv2,67,158361,106102,52259,eur,gavi
aze,Azerbaijan,2003,mcv1,67,128589,86155,42434,eur,gavi
aze,Azerbaijan,2003,dtp3,77,128589,99014,29575,eur,gavi
aze,Azerbaijan,2003,dtp1,83,128589,106729,21860,eur,gavi
aze,Azerbaijan,2003,mcv2,66,149309,98544,50765,eur,gavi
aze,Azerbaijan,2004,mcv1,67,129395,86695,42700,eur,gavi
aze,Azerbaijan,2004,dtp3,77,129395,99634,29761,eur,gavi
aze,Azerbaijan,2004,dtp1,84,129395,108692,20703,eur,gavi
aze,Azerbaijan,2004,mcv2,67,140634,94225,46409,eur,gavi
aze,Azerbaijan,2005,dtp1,81,131428,106457,24971,eur,gavi
aze,Azerbaijan,2005,dtp3,75,131428,98571,32857,eur,gavi
aze,Azerbaijan,2005,mcv1,67,131428,88057,43371,eur,gavi
aze,Azerbaijan,2005,mcv2,67,133588,89504,44084,eur,gavi
aze,Azerbaijan,2006,mcv1,69,134930,93102,41828,eur,gavi
aze,Azerbaijan,2006,dtp3,78,134930,105245,29685,eur,gavi
aze,Azerbaijan,2006,dtp1,86,134930,116040,18890,eur,gavi
aze,Azerbaijan,2006,mcv2,68,129381,87979,41402,eur,gavi
aze,Azerbaijan,2007,mcv1,75,139825,104869,34956,eur,gavi
aze,Azerbaijan,2007,dtp1,87,139825,121648,18177,eur,gavi
aze,Azerbaijan,2007,dtp3,79,139825,110462,29363,eur,gavi
aze,Azerbaijan,2007,mcv2,75,127167,95375,31792,eur,gavi
aze,Azerbaijan,2008,mcv1,79,145810,115190,30620,eur,gavi
aze,Azerbaijan,2008,dtp1,90,145810,131229,14581,eur,gavi
aze,Azerbaijan,2008,dtp3,81,145810,118106,27704,eur,gavi
aze,Azerbaijan,2008,mcv2,79,126411,99865,26546,eur,gavi
aze,Azerbaijan,2009,mcv1,85,152438,129572,22866,eur,gavi
aze,Azerbaijan,2009,dtp3,81,152438,123475,28963,eur,gavi
aze,Azerbaijan,2009,dtp1,90,152438,137194,15244,eur,gavi
aze,Azerbaijan,2009,mcv2,83,126475,104974,21501,eur,gavi
aze,Azerbaijan,2010,dtp1,94,159008,149468,9540,eur,gavi
aze,Azerbaijan,2010,dtp3,81,159008,128796,30212,eur,gavi
aze,Azerbaijan,2010,mcv1,89,159008,141517,17491,eur,gavi
aze,Azerbaijan,2010,mcv2,89,126445,112536,13909,eur,gavi
aze,Azerbaijan,2011,dtp1,94,164749,154864,9885,eur,gavi
aze,Azerbaijan,2011,mcv1,92,164749,151569,13180,eur,gavi
aze,Azerbaijan,2011,dtp3,87,164749,143332,21417,eur,gavi
aze,Azerbaijan,2011,mcv2,92,127728,117510,10218,eur,gavi
aze,Azerbaijan,2012,dtp1,94,169086,158941,10145,eur,gavi
aze,Azerbaijan,2012,dtp3,89,169086,150487,18599,eur,gavi
aze,Azerbaijan,2012,mcv1,94,169086,158941,10145,eur,gavi
aze,Azerbaijan,2012,mcv2,95,130412,123891,6521,eur,gavi
aze,Azerbaijan,2013,mcv1,98,171629,168196,3433,eur,gavi
aze,Azerbaijan,2013,dtp1,95,171629,163048,8581,eur,gavi
aze,Azerbaijan,2013,dtp3,93,171629,159615,12014,eur,gavi
aze,Azerbaijan,2013,mcv2,98,134223,131539,2684,eur,gavi
aze,Azerbaijan,2014,dtp3,94,172204,161872,10332,eur,gavi
aze,Azerbaijan,2014,dtp1,96,172204,165316,6888,eur,gavi
aze,Azerbaijan,2014,mcv1,98,172204,168760,3444,eur,gavi
aze,Azerbaijan,2014,mcv2,98,138962,136183,2779,eur,gavi
aze,Azerbaijan,2015,dtp1,97,170833,165708,5125,eur,gavi
aze,Azerbaijan,2015,mcv1,98,170833,167416,3417,eur,gavi
aze,Azerbaijan,2015,dtp3,96,170833,164000,6833,eur,gavi
aze,Azerbaijan,2015,mcv2,98,144262,141377,2885,eur,gavi
aze,Azerbaijan,2016,dtp1,98,167789,164433,3356,eur,gavi
aze,Azerbaijan,2016,dtp3,97,167789,162755,5034,eur,gavi
aze,Azerbaijan,2016,mcv1,98,167789,164433,3356,eur,gavi
aze,Azerbaijan,2016,mcv2,98,150829,147812,3017,eur,gavi
bdi,Burundi,2000,dtp3,80,247439,197951,49488,afr,gavi
bdi,Burundi,2000,dtp1,88,247439,217746,29693,afr,gavi
bdi,Burundi,2000,mcv1,72,247439,178156,69283,afr,gavi
bdi,Burundi,2001,dtp1,90,252586,227327,25259,afr,gavi
bdi,Burundi,2001,dtp3,81,252586,204595,47991,afr,gavi
bdi,Burundi,2001,mcv1,73,252586,184388,68198,afr,gavi
bdi,Burundi,2002,dtp3,81,259511,210204,49307,afr,gavi
bdi,Burundi,2002,mcv1,75,259511,194633,64878,afr,gavi
bdi,Burundi,2002,dtp1,91,259511,236155,23356,afr,gavi
bdi,Burundi,2003,dtp1,93,268122,249353,18769,afr,gavi
bdi,Burundi,2003,dtp3,82,268122,219860,48262,afr,gavi
bdi,Burundi,2003,mcv1,76,268122,203773,64349,afr,gavi
bdi,Burundi,2004,dtp3,83,278268,230962,47306,afr,gavi
bdi,Burundi,2004,dtp1,95,278268,264355,13913,afr,gavi
bdi,Burundi,2004,mcv1,78,278268,217049,61219,afr,gavi
bdi,Burundi,2005,dtp3,87,289673,252016,37657,afr,gavi
bdi,Burundi,2005,dtp1,96,289673,278086,11587,afr,gavi
bdi,Burundi,2005,mcv1,87,289673,252016,37657,afr,gavi
bdi,Burundi,2006,dtp1,99,301965,298945,3020,afr,gavi
bdi,Burundi,2006,dtp3,92,301965,277808,24157,afr,gavi
bdi,Burundi,2006,mcv1,92,301965,277808,24157,afr,gavi
bdi,Burundi,2007,dtp3,99,314666,311519,3147,afr,gavi
bdi,Burundi,2007,mcv1,88,314666,276906,37760,afr,gavi
bdi,Burundi,2007,dtp1,99,314666,311519,3147,afr,gavi
bdi,Burundi,2008,dtp3,92,327340,301153,26187,afr,gavi
bdi,Burundi,2008,dtp1,98,327340,320793,6547,afr,gavi
bdi,Burundi,2008,mcv1,84,327340,274966,52374,afr,gavi
bdi,Burundi,2009,mcv1,91,339693,309121,30572,afr,gavi
bdi,Burundi,2009,dtp3,94,339693,319311,20382,afr,gavi
bdi,Burundi,2009,dtp1,99,339693,336296,3397,afr,gavi
bdi,Burundi,2010,dtp1,99,351559,348043,3516,afr,gavi
bdi,Burundi,2010,mcv1,92,351559,323434,28125,afr,gavi
bdi,Burundi,2010,dtp3,96,351559,337497,14062,afr,gavi
bdi,Burundi,2011,dtp1,99,362928,359299,3629,afr,gavi
bdi,Burundi,2011,dtp3,96,362928,348411,14517,afr,gavi
bdi,Burundi,2011,mcv1,93,362928,337523,25405,afr,gavi
bdi,Burundi,2012,dtp3,96,373954,358996,14958,afr,gavi
bdi,Burundi,2012,mcv1,93,373954,347777,26177,afr,gavi
bdi,Burundi,2012,dtp1,98,373954,366475,7479,afr,gavi
bdi,Burundi,2013,dtp3,96,384721,369332,15389,afr,gavi
bdi,Burundi,2013,mcv1,98,384721,377027,7694,afr,gavi
bdi,Burundi,2013,dtp1,98,384721,377027,7694,afr,gavi
bdi,Burundi,2013,mcv2,51,348832,177904,170928,afr,gavi
bdi,Burundi,2014,dtp3,95,395161,375403,19758,afr,gavi
bdi,Burundi,2014,mcv1,94,395161,371451,23710,afr,gavi
bdi,Burundi,2014,dtp1,98,395161,387258,7903,afr,gavi
bdi,Burundi,2014,mcv2,60,360193,216116,144077,afr,gavi
bdi,Burundi,2015,dtp1,97,405162,393007,12155,afr,gavi
bdi,Burundi,2015,dtp3,94,405162,380852,24310,afr,gavi
bdi,Burundi,2015,mcv1,93,405162,376801,28361,afr,gavi
bdi,Burundi,2015,mcv2,65,371436,241433,130003,afr,gavi
bdi,Burundi,2016,dtp1,97,414610,402172,12438,afr,gavi
bdi,Burundi,2016,mcv1,93,414610,385587,29023,afr,gavi
bdi,Burundi,2016,dtp3,94,414610,389733,24877,afr,gavi
bdi,Burundi,2016,mcv2,72,380732,274127,106605,afr,gavi
bel,Belgium,2000,mcv1,82,113465,93041,20424,eur,hic
bel,Belgium,2000,dtp3,95,113465,107792,5673,eur,hic
bel,Belgium,2000,dtp1,97,113465,110061,3404,eur,hic
bel,Belgium,2001,mcv1,82,113856,93362,20494,eur,hic
bel,Belgium,2001,dtp3,95,113856,108163,5693,eur,hic
bel,Belgium,2001,dtp1,97,113856,110440,3416,eur,hic
bel,Belgium,2002,dtp3,95,114753,109015,5738,eur,hic
bel,Belgium,2002,mcv1,82,114753,94097,20656,eur,hic
bel,Belgium,2002,dtp1,97,114753,111310,3443,eur,hic
bel,Belgium,2003,dtp3,95,116077,110273,5804,eur,hic
bel,Belgium,2003,dtp1,97,116077,112595,3482,eur,hic
bel,Belgium,2003,mcv1,82,116077,95183,20894,eur,hic
bel,Belgium,2004,dtp3,95,117743,111856,5887,eur,hic
bel,Belgium,2004,mcv1,82,117743,96549,21194,eur,hic
bel,Belgium,2004,dtp1,97,117743,114211,3532,eur,hic
bel,Belgium,2005,dtp3,97,119589,116001,3588,eur,hic
bel,Belgium,2005,mcv1,88,119589,105238,14351,eur,hic
bel,Belgium,2005,dtp1,98,119589,117197,2392,eur,hic
bel,Belgium,2006,dtp1,99,121418,120204,1214,eur,hic
bel,Belgium,2006,dtp3,98,121418,118990,2428,eur,hic
bel,Belgium,2006,mcv1,92,121418,111705,9713,eur,hic
bel,Belgium,2006,mcv2,78,118043,92074,25969,eur,hic
bel,Belgium,2007,dtp1,99,123061,121830,1231,eur,hic
bel,Belgium,2007,mcv1,92,123061,113216,9845,eur,hic
bel,Belgium,2007,dtp3,98,123061,120600,2461,eur,hic
bel,Belgium,2007,mcv2,78,121361,94662,26699,eur,hic
bel,Belgium,2008,dtp3,99,124398,123154,1244,eur,hic
bel,Belgium,2008,mcv1,93,124398,115690,8708,eur,hic
bel,Belgium,2008,dtp1,99,124398,123154,1244,eur,hic
bel,Belgium,2008,mcv2,81,120328,97466,22862,eur,hic
bel,Belgium,2009,dtp1,99,125381,124127,1254,eur,hic
bel,Belgium,2009,dtp3,98,125381,122873,2508,eur,hic
bel,Belgium,2009,mcv1,95,125381,119112,6269,eur,hic
bel,Belgium,2009,mcv2,83,119934,99545,20389,eur,hic
bel,Belgium,2010,dtp1,99,126046,124786,1260,eur,hic
bel,Belgium,2010,dtp3,98,126046,123525,2521,eur,hic
bel,Belgium,2010,mcv1,95,126046,119744,6302,eur,hic
bel,Belgium,2010,mcv2,83,120293,99843,20450,eur,hic
bel,Belgium,2011,dtp1,99,126502,125237,1265,eur,hic
bel,Belgium,2011,dtp3,98,126502,123972,2530,eur,hic
bel,Belgium,2011,mcv1,95,126502,120177,6325,eur,hic
bel,Belgium,2011,mcv2,83,120786,100252,20534,eur,hic
bel,Belgium,2012,dtp1,99,126907,125638,1269,eur,hic
bel,Belgium,2012,mcv1,96,126907,121831,5076,eur,hic
bel,Belgium,2012,dtp3,99,126907,125638,1269,eur,hic
bel,Belgium,2012,mcv2,85,121397,103187,18210,eur,hic
bel,Belgium,2013,dtp3,99,127378,126104,1274,eur,hic
bel,Belgium,2013,mcv1,96,127378,122283,5095,eur,hic
bel,Belgium,2013,dtp1,99,127378,126104,1274,eur,hic
bel,Belgium,2013,mcv2,85,122413,104051,18362,eur,hic
bel,Belgium,2014,mcv1,96,127933,122816,5117,eur,hic
bel,Belgium,2014,dtp3,99,127933,126654,1279,eur,hic
bel,Belgium,2014,dtp1,99,127933,126654,1279,eur,hic
bel,Belgium,2014,mcv2,85,124154,105531,18623,eur,hic
bel,Belgium,2015,dtp1,99,128551,127265,1286,eur,hic
bel,Belgium,2015,mcv1,96,128551,123409,5142,eur,hic
bel,Belgium,2015,dtp3,99,128551,127265,1286,eur,hic
bel,Belgium,2015,mcv2,85,126596,107607,18989,eur,hic
bel,Belgium,2016,dtp3,98,129163,126580,2583,eur,hic
bel,Belgium,2016,dtp1,99,129163,127871,1292,eur,hic
bel,Belgium,2016,mcv1,96,129163,123996,5167,eur,hic
bel,Belgium,2016,mcv2,85,129056,109698,19358,eur,hic
ben,Benin,2000,dtp3,78,265959,207448,58511,afr,gavi
ben,Benin,2000,dtp1,89,265959,236704,29255,afr,gavi
ben,Benin,2000,mcv1,70,265959,186171,79788,afr,gavi
ben,Benin,2001,dtp1,88,272270,239598,32672,afr,gavi
ben,Benin,2001,mcv1,68,272270,185144,87126,afr,gavi
ben,Benin,2001,dtp3,76,272270,206925,65345,afr,gavi
ben,Benin,2002,dtp1,87,278801,242557,36244,afr,gavi
ben,Benin,2002,dtp3,75,278801,209101,69700,afr,gavi
ben,Benin,2002,mcv1,66,278801,184009,94792,afr,gavi
ben,Benin,2003,dtp1,86,285565,245586,39979,afr,gavi
ben,Benin,2003,mcv1,65,285565,185617,99948,afr,gavi
ben,Benin,2003,dtp3,73,285565,208462,77103,afr,gavi
ben,Benin,2004,dtp1,85,292550,248668,43882,afr,gavi
ben,Benin,2004,dtp3,72,292550,210636,81914,afr,gavi
ben,Benin,2004,mcv1,63,292550,184306,108244,afr,gavi
ben,Benin,2005,dtp1,84,299732,251775,47957,afr,gavi
ben,Benin,2005,dtp3,70,299732,209812,89920,afr,gavi
ben,Benin,2005,mcv1,61,299732,182837,116895,afr,gavi
ben,Benin,2006,dtp1,89,307061,273284,33777,afr,gavi
ben,Benin,2006,mcv1,66,307061,202660,104401,afr,gavi
ben,Benin,2006,dtp3,74,307061,227225,79836,afr,gavi
ben,Benin,2007,dtp1,94,314464,295596,18868,afr,gavi
ben,Benin,2007,mcv1,70,314464,220125,94339,afr,gavi
ben,Benin,2007,dtp3,82,314464,257860,56604,afr,gavi
ben,Benin,2008,dtp1,91,321870,292902,28968,afr,gavi
ben,Benin,2008,dtp3,75,321870,241402,80468,afr,gavi
ben,Benin,2008,mcv1,66,321870,212434,109436,afr,gavi
ben,Benin,2009,mcv1,71,329227,233751,95476,afr,gavi
ben,Benin,2009,dtp1,89,329227,293012,36215,afr,gavi
ben,Benin,2009,dtp3,79,329227,260089,69138,afr,gavi
ben,Benin,2010,dtp1,87,336486,292743,43743,afr,gavi
ben,Benin,2010,mcv1,68,336486,228810,107676,afr,gavi
ben,Benin,2010,dtp3,76,336486,255729,80757,afr,gavi
ben,Benin,2011,dtp1,85,343611,292069,51542,afr,gavi
ben,Benin,2011,dtp3,75,343611,257708,85903,afr,gavi
ben,Benin,2011,mcv1,70,343611,240528,103083,afr,gavi
ben,Benin,2012,dtp3,80,350611,280489,70122,afr,gavi
ben,Benin,2012,dtp1,89,350611,312044,38567,afr,gavi
ben,Benin,2012,mcv1,74,350611,259452,91159,afr,gavi
ben,Benin,2013,dtp3,77,357509,275282,82227,afr,gavi
ben,Benin,2013,mcv1,68,357509,243106,114403,afr,gavi
ben,Benin,2013,dtp1,86,357509,307458,50051,afr,gavi
ben,Benin,2014,dtp3,78,364317,284167,80150,afr,gavi
ben,Benin,2014,dtp1,86,364317,313313,51004,afr,gavi
ben,Benin,2014,mcv1,68,364317,247736,116581,afr,gavi
ben,Benin,2015,dtp3,82,371068,304276,66792,afr,gavi
ben,Benin,2015,dtp1,86,371068,319118,51950,afr,gavi
ben,Benin,2015,mcv1,74,371068,274590,96478,afr,gavi
ben,Benin,2016,dtp3,82,377805,309800,68005,afr,gavi
ben,Benin,2016,mcv1,74,377805,279576,98229,afr,gavi
ben,Benin,2016,dtp1,86,377805,324912,52893,afr,gavi
bfa,Burkina Faso,2000,dtp3,45,486995,219148,267847,afr,gavi
bfa,Burkina Faso,2000,mcv1,48,486995,233758,253237,afr,gavi
bfa,Burkina Faso,2000,dtp1,97,486995,472385,14610,afr,gavi
bfa,Burkina Faso,2001,dtp1,93,499903,464910,34993,afr,gavi
bfa,Burkina Faso,2001,mcv1,63,499903,314939,184964,afr,gavi
bfa,Burkina Faso,2001,dtp3,62,499903,309940,189963,afr,gavi
bfa,Burkina Faso,2002,mcv1,64,513029,328339,184690,afr,gavi
bfa,Burkina Faso,2002,dtp1,89,513029,456596,56433,afr,gavi
bfa,Burkina Faso,2002,dtp3,69,513029,353990,159039,afr,gavi
bfa,Burkina Faso,2003,dtp1,90,526307,473676,52631,afr,gavi
bfa,Burkina Faso,2003,mcv1,76,526307,399993,126314,afr,gavi
bfa,Burkina Faso,2003,dtp3,79,526307,415783,110524,afr,gavi
bfa,Burkina Faso,2004,dtp1,90,539641,485677,53964,afr,gavi
bfa,Burkina Faso,2004,mcv1,78,539641,420920,118721,afr,gavi
bfa,Burkina Faso,2004,dtp3,79,539641,426316,113325,afr,gavi
bfa,Burkina Faso,2005,dtp3,82,552884,453365,99519,afr,gavi
bfa,Burkina Faso,2005,dtp1,91,552884,503124,49760,afr,gavi
bfa,Burkina Faso,2005,mcv1,84,552884,464423,88461,afr,gavi
bfa,Burkina Faso,2006,dtp3,86,565882,486659,79223,afr,gavi
bfa,Burkina Faso,2006,dtp1,91,565882,514953,50929,afr,gavi
bfa,Burkina Faso,2006,mcv1,88,565882,497976,67906,afr,gavi
bfa,Burkina Faso,2007,dtp1,92,578558,532273,46285,afr,gavi
bfa,Burkina Faso,2007,mcv1,94,578558,543845,34713,afr,gavi
bfa,Burkina Faso,2007,dtp3,89,578558,514917,63641,afr,gavi
bfa,Burkina Faso,2008,dtp3,93,590878,549517,41361,afr,gavi
bfa,Burkina Faso,2008,dtp1,97,590878,573152,17726,afr,gavi
bfa,Burkina Faso,2008,mcv1,94,590878,555425,35453,afr,gavi
bfa,Burkina Faso,2009,mcv1,94,602854,566683,36171,afr,gavi
bfa,Burkina Faso,2009,dtp1,93,602854,560654,42200,afr,gavi
bfa,Burkina Faso,2009,dtp3,92,602854,554626,48228,afr,gavi
bfa,Burkina Faso,2010,dtp1,93,614550,571532,43018,afr,gavi
bfa,Burkina Faso,2010,mcv1,92,614550,565386,49164,afr,gavi
bfa,Burkina Faso,2010,dtp3,91,614550,559240,55310,afr,gavi
bfa,Burkina Faso,2011,mcv1,89,626080,557211,68869,afr,gavi
bfa,Burkina Faso,2011,dtp1,93,626080,582254,43826,afr,gavi
bfa,Burkina Faso,2011,dtp3,91,626080,569733,56347,afr,gavi
bfa,Burkina Faso,2012,dtp3,90,637604,573844,63760,afr,gavi
bfa,Burkina Faso,2012,dtp1,94,637604,599348,38256,afr,gavi
bfa,Burkina Faso,2012,mcv1,87,637604,554715,82889,afr,gavi
bfa,Burkina Faso,2013,dtp3,88,649259,571348,77911,afr,gavi
bfa,Burkina Faso,2013,dtp1,94,649259,610303,38956,afr,gavi
bfa,Burkina Faso,2013,mcv1,82,649259,532392,116867,afr,gavi
bfa,Burkina Faso,2014,dtp3,91,661116,601616,59500,afr,gavi
bfa,Burkina Faso,2014,dtp1,95,661116,628060,33056,afr,gavi
bfa,Burkina Faso,2014,mcv1,88,661116,581782,79334,afr,gavi
bfa,Burkina Faso,2014,mcv2,17,620068,105412,514656,afr,gavi
bfa,Burkina Faso,2015,dtp1,95,673215,639554,33661,afr,gavi
bfa,Burkina Faso,2015,dtp3,91,673215,612626,60589,afr,gavi
bfa,Burkina Faso,2015,mcv1,88,673215,592429,80786,afr,gavi
bfa,Burkina Faso,2015,mcv2,50,632795,316398,316397,afr,gavi
bfa,Burkina Faso,2016,mcv1,88,685547,603281,82266,afr,gavi
bfa,Burkina Faso,2016,dtp3,91,685547,623848,61699,afr,gavi
bfa,Burkina Faso,2016,dtp1,95,685547,651270,34277,afr,gavi
bfa,Burkina Faso,2016,mcv2,50,644215,322108,322107,afr,gavi
bgd,Bangladesh,2000,dtp1,92,3405297,3132873,272424,sear,gavi
bgd,Bangladesh,2000,dtp3,82,3405297,2792344,612953,sear,gavi
bgd,Bangladesh,2000,mcv1,74,3405297,2519920,885377,sear,gavi
bgd,Bangladesh,2001,dtp1,94,3395003,3191303,203700,sear,gavi
bgd,Bangladesh,2001,mcv1,77,3395003,2614152,780851,sear,gavi
bgd,Bangladesh,2001,dtp3,85,3395003,2885753,509250,sear,gavi
bgd,Bangladesh,2002,dtp1,95,3377432,3208560,168872,sear,gavi
bgd,Bangladesh,2002,mcv1,75,3377432,2533074,844358,sear,gavi
bgd,Bangladesh,2002,dtp3,83,3377432,2803269,574163,sear,gavi
bgd,Bangladesh,2003,dtp3,87,3352776,2916915,435861,sear,gavi
bgd,Bangladesh,2003,mcv1,76,3352776,2548110,804666,sear,gavi
bgd,Bangladesh,2003,dtp1,93,3352776,3118082,234694,sear,gavi
bgd,Bangladesh,2004,dtp1,99,3321812,3288594,33218,sear,gavi
bgd,Bangladesh,2004,mcv1,81,3321812,2690668,631144,sear,gavi
bgd,Bangladesh,2004,dtp3,99,3321812,3288594,33218,sear,gavi
bgd,Bangladesh,2005,dtp3,93,3286158,3056127,230031,sear,gavi
bgd,Bangladesh,2005,dtp1,97,3286158,3187573,98585,sear,gavi
bgd,Bangladesh,2005,mcv1,88,3286158,2891819,394339,sear,gavi
bgd,Bangladesh,2006,dtp3,94,3248024,3053143,194881,sear,gavi
bgd,Bangladesh,2006,mcv1,83,3248024,2695860,552164,sear,gavi
bgd,Bangladesh,2006,dtp1,97,3248024,3150583,97441,sear,gavi
bgd,Bangladesh,2007,dtp3,94,3209973,3017375,192598,sear,gavi
bgd,Bangladesh,2007,dtp1,98,3209973,3145774,64199,sear,gavi
bgd,Bangladesh,2007,mcv1,89,3209973,2856876,353097,sear,gavi
bgd,Bangladesh,2008,dtp3,96,3174171,3047204,126967,sear,gavi
bgd,Bangladesh,2008,dtp1,99,3174171,3142429,31742,sear,gavi
bgd,Bangladesh,2008,mcv1,92,3174171,2920237,253934,sear,gavi
bgd,Bangladesh,2009,dtp3,97,3141883,3047627,94256,sear,gavi
bgd,Bangladesh,2009,dtp1,99,3141883,3110464,31419,sear,gavi
bgd,Bangladesh,2009,mcv1,93,3141883,2921951,219932,sear,gavi
bgd,Bangladesh,2010,dtp3,94,3113977,2927138,186839,sear,gavi
bgd,Bangladesh,2010,dtp1,98,3113977,3051697,62280,sear,gavi
bgd,Bangladesh,2010,mcv1,88,3113977,2740300,373677,sear,gavi
bgd,Bangladesh,2011,dtp1,99,3090560,3059654,30906,sear,gavi
bgd,Bangladesh,2011,dtp3,96,3090560,2966938,123622,sear,gavi
bgd,Bangladesh,2011,mcv1,93,3090560,2874221,216339,sear,gavi
bgd,Bangladesh,2012,dtp3,94,3070337,2886117,184220,sear,gavi
bgd,Bangladesh,2012,mcv1,88,3070337,2701897,368440,sear,gavi
bgd,Bangladesh,2012,dtp1,97,3070337,2978227,92110,sear,gavi
bgd,Bangladesh,2012,mcv2,35,3068245,1073886,1994359,sear,gavi
bgd,Bangladesh,2013,dtp3,96,3052000,2929920,122080,sear,gavi
bgd,Bangladesh,2013,dtp1,98,3052000,2990960,61040,sear,gavi
bgd,Bangladesh,2013,mcv1,91,3052000,2777320,274680,sear,gavi
bgd,Bangladesh,2013,mcv2,70,3081399,2156979,924420,sear,gavi
bgd,Bangladesh,2014,dtp1,99,3034869,3004520,30349,sear,gavi
bgd,Bangladesh,2014,dtp3,97,3034869,2943823,91046,sear,gavi
bgd,Bangladesh,2014,mcv1,94,3034869,2852777,182092,sear,gavi
bgd,Bangladesh,2014,mcv2,83,3057801,2537975,519826,sear,gavi
bgd,Bangladesh,2015,mcv1,94,3018135,2837047,181088,sear,gavi
bgd,Bangladesh,2015,dtp3,97,3018135,2927591,90544,sear,gavi
bgd,Bangladesh,2015,dtp1,99,3018135,2987954,30181,sear,gavi
bgd,Bangladesh,2015,mcv2,83,3037623,2521227,516396,sear,gavi
bgd,Bangladesh,2016,dtp3,97,3001023,2910992,90031,sear,gavi
bgd,Bangladesh,2016,dtp1,99,3001023,2971013,30010,sear,gavi
bgd,Bangladesh,2016,mcv1,94,3001023,2820962,180061,sear,gavi
bgd,Bangladesh,2016,mcv2,93,3040253,2827435,212818,sear,gavi
bgr,Bulgaria,2000,dtp3,93,64309,59807,4502,eur,mic_nongavi
bgr,Bulgaria,2000,dtp1,95,64309,61094,3215,eur,mic_nongavi
bgr,Bulgaria,2000,mcv1,89,64309,57235,7074,eur,mic_nongavi
bgr,Bulgaria,2000,mcv2,83,105595,87644,17951,eur,mic_nongavi
bgr,Bulgaria,2001,dtp3,94,64531,60659,3872,eur,mic_nongavi
bgr,Bulgaria,2001,dtp1,95,64531,61304,3227,eur,mic_nongavi
bgr,Bulgaria,2001,mcv1,90,64531,58078,6453,eur,mic_nongavi
bgr,Bulgaria,2001,mcv2,85,101610,86368,15242,eur,mic_nongavi
bgr,Bulgaria,2002,dtp3,93,65371,60795,4576,eur,mic_nongavi
bgr,Bulgaria,2002,dtp1,97,65371,63410,1961,eur,mic_nongavi
bgr,Bulgaria,2002,mcv1,92,65371,60141,5230,eur,mic_nongavi
bgr,Bulgaria,2002,mcv2,79,96136,75947,20189,eur,mic_nongavi
bgr,Bulgaria,2003,dtp1,96,66582,63919,2663,eur,mic_nongavi
bgr,Bulgaria,2003,mcv1,96,66582,63919,2663,eur,mic_nongavi
bgr,Bulgaria,2003,dtp3,96,66582,63919,2663,eur,mic_nongavi
bgr,Bulgaria,2003,mcv2,89,91017,81005,10012,eur,mic_nongavi
bgr,Bulgaria,2004,dtp1,95,67964,64566,3398,eur,mic_nongavi
bgr,Bulgaria,2004,dtp3,95,67964,64566,3398,eur,mic_nongavi
bgr,Bulgaria,2004,mcv1,95,67964,64566,3398,eur,mic_nongavi
bgr,Bulgaria,2004,mcv2,91,86079,78332,7747,eur,mic_nongavi
bgr,Bulgaria,2005,mcv1,96,69283,66512,2771,eur,mic_nongavi
bgr,Bulgaria,2005,dtp1,97,69283,67205,2078,eur,mic_nongavi
bgr,Bulgaria,2005,dtp3,96,69283,66512,2771,eur,mic_nongavi
bgr,Bulgaria,2005,mcv2,92,81056,74572,6484,eur,mic_nongavi
bgr,Bulgaria,2006,dtp1,97,70337,68227,2110,eur,mic_nongavi
bgr,Bulgaria,2006,dtp3,95,70337,66820,3517,eur,mic_nongavi
bgr,Bulgaria,2006,mcv1,96,70337,67524,2813,eur,mic_nongavi
bgr,Bulgaria,2006,mcv2,93,76013,70692,5321,eur,mic_nongavi
bgr,Bulgaria,2007,dtp3,95,71039,67487,3552,eur,mic_nongavi
bgr,Bulgaria,2007,dtp1,96,71039,68197,2842,eur,mic_nongavi
bgr,Bulgaria,2007,mcv1,96,71039,68197,2842,eur,mic_nongavi
bgr,Bulgaria,2007,mcv2,94,71313,67034,4279,eur,mic_nongavi
bgr,Bulgaria,2008,dtp1,97,71343,69203,2140,eur,mic_nongavi
bgr,Bulgaria,2008,mcv1,96,71343,68489,2854,eur,mic_nongavi
bgr,Bulgaria,2008,dtp3,95,71343,67776,3567,eur,mic_nongavi
bgr,Bulgaria,2008,mcv2,94,66942,62925,4017,eur,mic_nongavi
bgr,Bulgaria,2009,mcv1,96,71210,68362,2848,eur,mic_nongavi
bgr,Bulgaria,2009,dtp3,94,71210,66937,4273,eur,mic_nongavi
bgr,Bulgaria,2009,dtp1,96,71210,68362,2848,eur,mic_nongavi
bgr,Bulgaria,2009,mcv2,93,62604,58222,4382,eur,mic_nongavi
bgr,Bulgaria,2010,dtp1,96,70679,67852,2827,eur,mic_nongavi
bgr,Bulgaria,2010,dtp3,94,70679,66438,4241,eur,mic_nongavi
bgr,Bulgaria,2010,mcv1,97,70679,68559,2120,eur,mic_nongavi
bgr,Bulgaria,2010,mcv2,96,59468,57089,2379,eur,mic_nongavi
bgr,Bulgaria,2011,dtp1,96,69854,67060,2794,eur,mic_nongavi
bgr,Bulgaria,2011,mcv1,95,69854,66361,3493,eur,mic_nongavi
bgr,Bulgaria,2011,dtp3,95,69854,66361,3493,eur,mic_nongavi
bgr,Bulgaria,2011,mcv2,94,58687,55166,3521,eur,mic_nongavi
bgr,Bulgaria,2012,mcv1,94,68909,64774,4135,eur,mic_nongavi
bgr,Bulgaria,2012,dtp3,95,68909,65464,3445,eur,mic_nongavi
bgr,Bulgaria,2012,dtp1,96,68909,66153,2756,eur,mic_nongavi
bgr,Bulgaria,2012,mcv2,94,59514,55943,3571,eur,mic_nongavi
bgr,Bulgaria,2013,mcv1,95,67985,64586,3399,eur,mic_nongavi
bgr,Bulgaria,2013,dtp1,96,67985,65266,2719,eur,mic_nongavi
bgr,Bulgaria,2013,dtp3,95,67985,64586,3399,eur,mic_nongavi
bgr,Bulgaria,2013,mcv2,94,60387,56764,3623,eur,mic_nongavi
bgr,Bulgaria,2014,mcv1,93,67139,62439,4700,eur,mic_nongavi
bgr,Bulgaria,2014,dtp3,88,67139,59082,8057,eur,mic_nongavi
bgr,Bulgaria,2014,dtp1,90,67139,60425,6714,eur,mic_nongavi
bgr,Bulgaria,2014,mcv2,89,61401,54647,6754,eur,mic_nongavi
bgr,Bulgaria,2015,dtp3,91,66397,60421,5976,eur,mic_nongavi
bgr,Bulgaria,2015,dtp1,93,66397,61749,4648,eur,mic_nongavi
bgr,Bulgaria,2015,mcv1,92,66397,61085,5312,eur,mic_nongavi
bgr,Bulgaria,2015,mcv2,87,62772,54612,8160,eur,mic_nongavi
bgr,Bulgaria,2016,dtp1,94,65746,61801,3945,eur,mic_nongavi
bgr,Bulgaria,2016,dtp3,92,65746,60486,5260,eur,mic_nongavi
bgr,Bulgaria,2016,mcv1,92,65746,60486,5260,eur,mic_nongavi
bgr,Bulgaria,2016,mcv2,88,64515,56773,7742,eur,mic_nongavi
bhr,Bahrain,2000,dtp1,98,14675,14381,294,emr,hic
bhr,Bahrain,2000,dtp3,97,14675,14235,440,emr,hic
bhr,Bahrain,2000,mcv1,98,14675,14381,294,emr,hic
bhr,Bahrain,2000,mcv2,92,14792,13609,1183,emr,hic
bhr,Bahrain,2001,dtp3,99,15045,14895,150,emr,hic
bhr,Bahrain,2001,dtp1,99,15045,14895,150,emr,hic
bhr,Bahrain,2001,mcv1,98,15045,14744,301,emr,hic
bhr,Bahrain,2001,mcv2,99,14798,14650,148,emr,hic
bhr,Bahrain,2002,dtp1,99,15471,15316,155,emr,hic
bhr,Bahrain,2002,dtp3,98,15471,15162,309,emr,hic
bhr,Bahrain,2002,mcv1,99,15471,15316,155,emr,hic
bhr,Bahrain,2002,mcv2,97,14919,14471,448,emr,hic
bhr,Bahrain,2003,mcv1,99,15940,15781,159,emr,hic
bhr,Bahrain,2003,dtp3,97,15940,15462,478,emr,hic
bhr,Bahrain,2003,dtp1,99,15940,15781,159,emr,hic
bhr,Bahrain,2003,mcv2,99,15218,15066,152,emr,hic
bhr,Bahrain,2004,dtp3,98,16438,16109,329,emr,hic
bhr,Bahrain,2004,dtp1,99,16438,16274,164,emr,hic
bhr,Bahrain,2004,mcv1,99,16438,16274,164,emr,hic
bhr,Bahrain,2004,mcv2,99,13387,13253,134,emr,hic
bhr,Bahrain,2005,mcv1,99,16958,16788,170,emr,hic
bhr,Bahrain,2005,dtp1,99,16958,16788,170,emr,hic
bhr,Bahrain,2005,dtp3,98,16958,16619,339,emr,hic
bhr,Bahrain,2005,mcv2,99,13958,13818,140,emr,hic
bhr,Bahrain,2006,dtp1,99,17497,17322,175,emr,hic
bhr,Bahrain,2006,dtp3,98,17497,17147,350,emr,hic
bhr,Bahrain,2006,mcv1,99,17497,17322,175,emr,hic
bhr,Bahrain,2006,mcv2,99,16640,16474,166,emr,hic
bhr,Bahrain,2007,dtp1,97,18046,17505,541,emr,hic
bhr,Bahrain,2007,mcv1,99,18046,17866,180,emr,hic
bhr,Bahrain,2007,dtp3,97,18046,17505,541,emr,hic
bhr,Bahrain,2007,mcv2,99,16725,16558,167,emr,hic
bhr,Bahrain,2008,dtp1,98,18595,18223,372,emr,hic
bhr,Bahrain,2008,dtp3,97,18595,18037,558,emr,hic
bhr,Bahrain,2008,mcv1,99,18595,18409,186,emr,hic
bhr,Bahrain,2008,mcv2,97,16838,16333,505,emr,hic
bhr,Bahrain,2009,dtp1,98,19130,18747,383,emr,hic
bhr,Bahrain,2009,dtp3,98,19130,18747,383,emr,hic
bhr,Bahrain,2009,mcv1,99,19130,18939,191,emr,hic
bhr,Bahrain,2009,mcv2,99,16979,16809,170,emr,hic
bhr,Bahrain,2010,dtp3,99,19631,19435,196,emr,hic
bhr,Bahrain,2010,dtp1,99,19631,19435,196,emr,hic
bhr,Bahrain,2010,mcv1,99,19631,19435,196,emr,hic
bhr,Bahrain,2010,mcv2,98,17229,16884,345,emr,hic
bhr,Bahrain,2011,dtp3,99,20086,19885,201,emr,hic
bhr,Bahrain,2011,dtp1,99,20086,19885,201,emr,hic
bhr,Bahrain,2011,mcv1,99,20086,19885,201,emr,hic
bhr,Bahrain,2011,mcv2,98,17857,17500,357,emr,hic
bhr,Bahrain,2012,dtp3,99,20487,20282,205,emr,hic
bhr,Bahrain,2012,dtp1,99,20487,20282,205,emr,hic
bhr,Bahrain,2012,mcv1,99,20487,20282,205,emr,hic
bhr,Bahrain,2012,mcv2,99,18337,18154,183,emr,hic
bhr,Bahrain,2013,dtp3,99,20832,20624,208,emr,hic
bhr,Bahrain,2013,mcv1,99,20832,20624,208,emr,hic
bhr,Bahrain,2013,dtp1,99,20832,20624,208,emr,hic
bhr,Bahrain,2013,mcv2,99,18773,18585,188,emr,hic
bhr,Bahrain,2014,dtp3,98,21118,20696,422,emr,hic
bhr,Bahrain,2014,dtp1,98,21118,20696,422,emr,hic
bhr,Bahrain,2014,mcv1,99,21118,20907,211,emr,hic
bhr,Bahrain,2014,mcv2,99,19321,19128,193,emr,hic
bhr,Bahrain,2015,mcv1,99,21351,21137,214,emr,hic
bhr,Bahrain,2015,dtp3,98,21351,20924,427,emr,hic
bhr,Bahrain,2015,dtp1,98,21351,20924,427,emr,hic
bhr,Bahrain,2015,mcv2,99,20088,19887,201,emr,hic
bhr,Bahrain,2016,dtp1,99,21539,21324,215,emr,hic
bhr,Bahrain,2016,dtp3,99,21539,21324,215,emr,hic
bhr,Bahrain,2016,mcv1,99,21539,21324,215,emr,hic
bhr,Bahrain,2016,mcv2,99,20352,20148,204,emr,hic
bhs,Bahamas,2000,dtp3,99,5217,5165,52,amr,hic
bhs,Bahamas,2000,dtp1,99,5217,5165,52,amr,hic
bhs,Bahamas,2000,mcv1,93,5217,4852,365,amr,hic
bhs,Bahamas,2001,dtp1,99,5074,5023,51,amr,hic
bhs,Bahamas,2001,mcv1,94,5074,4770,304,amr,hic
bhs,Bahamas,2001,dtp3,99,5074,5023,51,amr,hic
bhs,Bahamas,2002,dtp1,99,4983,4933,50,amr,hic
bhs,Bahamas,2002,mcv1,94,4983,4684,299,amr,hic
bhs,Bahamas,2002,dtp3,94,4983,4684,299,amr,hic
bhs,Bahamas,2003,dtp3,92,4949,4553,396,amr,hic
bhs,Bahamas,2003,mcv1,90,4949,4454,495,amr,hic
bhs,Bahamas,2003,dtp1,99,4949,4900,49,amr,hic
bhs,Bahamas,2004,dtp3,93,4973,4625,348,amr,hic
bhs,Bahamas,2004,mcv1,89,4973,4426,547,amr,hic
bhs,Bahamas,2004,dtp1,99,4973,4923,50,amr,hic
bhs,Bahamas,2004,mcv2,95,5352,5084,268,amr,hic
bhs,Bahamas,2005,dtp1,99,5045,4995,50,amr,hic
bhs,Bahamas,2005,dtp3,93,5045,4692,353,amr,hic
bhs,Bahamas,2005,mcv1,85,5045,4288,757,amr,hic
bhs,Bahamas,2005,mcv2,88,5424,4773,651,amr,hic
bhs,Bahamas,2006,dtp1,95,5146,4889,257,amr,hic
bhs,Bahamas,2006,mcv1,88,5146,4528,618,amr,hic
bhs,Bahamas,2006,dtp3,95,5146,4889,257,amr,hic
bhs,Bahamas,2006,mcv2,88,5354,4712,642,amr,hic
bhs,Bahamas,2007,dtp1,98,5253,5148,105,amr,hic
bhs,Bahamas,2007,mcv1,96,5253,5043,210,amr,hic
bhs,Bahamas,2007,dtp3,95,5253,4990,263,amr,hic
bhs,Bahamas,2007,mcv2,84,5233,4396,837,amr,hic
bhs,Bahamas,2008,dtp1,99,5348,5295,53,amr,hic
bhs,Bahamas,2008,mcv1,90,5348,4813,535,amr,hic
bhs,Bahamas,2008,dtp3,93,5348,4974,374,amr,hic
bhs,Bahamas,2008,mcv2,80,5086,4069,1017,amr,hic
bhs,Bahamas,2009,dtp1,99,5418,5364,54,amr,hic
bhs,Bahamas,2009,dtp3,96,5418,5201,217,amr,hic
bhs,Bahamas,2009,mcv1,98,5418,5310,108,amr,hic
bhs,Bahamas,2009,mcv2,76,4942,3756,1186,amr,hic
bhs,Bahamas,2010,dtp3,99,5463,5408,55,amr,hic
bhs,Bahamas,2010,dtp1,99,5463,5408,55,amr,hic
bhs,Bahamas,2010,mcv1,94,5463,5135,328,amr,hic
bhs,Bahamas,2010,mcv2,78,4836,3772,1064,amr,hic
bhs,Bahamas,2011,dtp3,98,5485,5375,110,amr,hic
bhs,Bahamas,2011,mcv1,90,5485,4936,549,amr,hic
bhs,Bahamas,2011,dtp1,99,5485,5430,55,amr,hic
bhs,Bahamas,2011,mcv2,79,5056,3994,1062,amr,hic
bhs,Bahamas,2012,dtp3,98,5496,5386,110,amr,hic
bhs,Bahamas,2012,dtp1,99,5496,5441,55,amr,hic
bhs,Bahamas,2012,mcv1,91,5496,5001,495,amr,hic
bhs,Bahamas,2012,mcv2,73,5342,3900,1442,amr,hic
bhs,Bahamas,2013,dtp3,97,5504,5339,165,amr,hic
bhs,Bahamas,2013,mcv1,92,5504,5064,440,amr,hic
bhs,Bahamas,2013,dtp1,99,5504,5449,55,amr,hic
bhs,Bahamas,2013,mcv2,69,5618,3876,1742,amr,hic
bhs,Bahamas,2014,dtp3,96,5514,5293,221,amr,hic
bhs,Bahamas,2014,mcv1,92,5514,5073,441,amr,hic
bhs,Bahamas,2014,dtp1,96,5514,5293,221,amr,hic
bhs,Bahamas,2014,mcv2,72,5786,4166,1620,amr,hic
bhs,Bahamas,2015,dtp1,99,5523,5468,55,amr,hic
bhs,Bahamas,2015,mcv1,94,5523,5192,331,amr,hic
bhs,Bahamas,2015,dtp3,95,5523,5247,276,amr,hic
bhs,Bahamas,2015,mcv2,76,5730,4355,1375,amr,hic
bhs,Bahamas,2016,dtp3,94,5531,5199,332,amr,hic
bhs,Bahamas,2016,mcv1,89,5531,4923,608,amr,hic
bhs,Bahamas,2016,dtp1,95,5531,5254,277,amr,hic
bhs,Bahamas,2016,mcv2,74,5717,4231,1486,amr,hic
bih,Bosnia and Herzegovina,2000,dtp3,85,40930,34790,6140,eur,mic_nongavi
bih,Bosnia and Herzegovina,2000,mcv1,80,40930,32744,8186,eur,mic_nongavi
bih,Bosnia and Herzegovina,2000,dtp1,90,40930,36837,4093,eur,mic_nongavi
bih,Bosnia and Herzegovina,2000,mcv2,74,51329,37983,13346,eur,mic_nongavi
bih,Bosnia and Herzegovina,2001,dtp3,91,38858,35361,3497,eur,mic_nongavi
bih,Bosnia and Herzegovina,2001,dtp1,94,38858,36527,2331,eur,mic_nongavi
bih,Bosnia and Herzegovina,2001,mcv1,92,38858,35749,3109,eur,mic_nongavi
bih,Bosnia and Herzegovina,2001,mcv2,86,49898,42912,6986,eur,mic_nongavi
bih,Bosnia and Herzegovina,2002,dtp3,80,37126,29701,7425,eur,mic_nongavi
bih,Bosnia and Herzegovina,2002,dtp1,86,37126,31928,5198,eur,mic_nongavi
bih,Bosnia and Herzegovina,2002,mcv1,89,37126,33042,4084,eur,mic_nongavi
bih,Bosnia and Herzegovina,2002,mcv2,90,49107,44196,4911,eur,mic_nongavi
bih,Bosnia and Herzegovina,2003,dtp1,93,35835,33327,2508,eur,mic_nongavi
bih,Bosnia and Herzegovina,2003,dtp3,87,35835,31176,4659,eur,mic_nongavi
bih,Bosnia and Herzegovina,2003,mcv1,84,35835,30101,5734,eur,mic_nongavi
bih,Bosnia and Herzegovina,2003,mcv2,85,47827,40653,7174,eur,mic_nongavi
bih,Bosnia and Herzegovina,2004,dtp1,93,34994,32544,2450,eur,mic_nongavi
bih,Bosnia and Herzegovina,2004,mcv1,88,34994,30795,4199,eur,mic_nongavi
bih,Bosnia and Herzegovina,2004,dtp3,84,34994,29395,5599,eur,mic_nongavi
bih,Bosnia and Herzegovina,2004,mcv2,88,47190,41527,5663,eur,mic_nongavi
bih,Bosnia and Herzegovina,2005,dtp3,93,34546,32128,2418,eur,mic_nongavi
bih,Bosnia and Herzegovina,2005,dtp1,95,34546,32819,1727,eur,mic_nongavi
bih,Bosnia and Herzegovina,2005,mcv1,90,34546,31091,3455,eur,mic_nongavi
bih,Bosnia and Herzegovina,2005,mcv2,90,45918,41326,4592,eur,mic_nongavi
bih,Bosnia and Herzegovina,2006,dtp1,94,34371,32309,2062,eur,mic_nongavi
bih,Bosnia and Herzegovina,2006,mcv1,85,34371,29215,5156,eur,mic_nongavi
bih,Bosnia and Herzegovina,2006,dtp3,87,34371,29903,4468,eur,mic_nongavi
bih,Bosnia and Herzegovina,2006,mcv2,93,44047,40964,3083,eur,mic_nongavi
bih,Bosnia and Herzegovina,2007,mcv1,96,34299,32927,1372,eur,mic_nongavi
bih,Bosnia and Herzegovina,2007,dtp1,96,34299,32927,1372,eur,mic_nongavi
bih,Bosnia and Herzegovina,2007,dtp3,95,34299,32584,1715,eur,mic_nongavi
bih,Bosnia and Herzegovina,2007,mcv2,95,41353,39285,2068,eur,mic_nongavi
bih,Bosnia and Herzegovina,2008,mcv1,84,34194,28723,5471,eur,mic_nongavi
bih,Bosnia and Herzegovina,2008,dtp3,91,34194,31117,3077,eur,mic_nongavi
bih,Bosnia and Herzegovina,2008,dtp1,95,34194,32484,1710,eur,mic_nongavi
bih,Bosnia and Herzegovina,2008,mcv2,92,38315,35250,3065,eur,mic_nongavi
bih,Bosnia and Herzegovina,2009,dtp1,95,34000,32300,1700,eur,mic_nongavi
bih,Bosnia and Herzegovina,2009,mcv1,93,34000,31620,2380,eur,mic_nongavi
bih,Bosnia and Herzegovina,2009,dtp3,90,34000,30600,3400,eur,mic_nongavi
bih,Bosnia and Herzegovina,2009,mcv2,88,35426,31175,4251,eur,mic_nongavi
bih,Bosnia and Herzegovina,2010,mcv1,91,33701,30668,3033,eur,mic_nongavi
bih,Bosnia and Herzegovina,2010,dtp1,95,33701,32016,1685,eur,mic_nongavi
bih,Bosnia and Herzegovina,2010,dtp3,89,33701,29994,3707,eur,mic_nongavi
bih,Bosnia and Herzegovina,2010,mcv2,91,33363,30360,3003,eur,mic_nongavi
bih,Bosnia and Herzegovina,2011,mcv1,89,33327,29661,3666,eur,mic_nongavi
bih,Bosnia and Herzegovina,2011,dtp3,88,33327,29328,3999,eur,mic_nongavi
bih,Bosnia and Herzegovina,2011,dtp1,94,33327,31327,2000,eur,mic_nongavi
bih,Bosnia and Herzegovina,2011,mcv2,88,35931,31619,4312,eur,mic_nongavi
bih,Bosnia and Herzegovina,2012,dtp3,92,32958,30321,2637,eur,mic_nongavi
bih,Bosnia and Herzegovina,2012,mcv1,94,32958,30981,1977,eur,mic_nongavi
bih,Bosnia and Herzegovina,2012,dtp1,95,32958,31310,1648,eur,mic_nongavi
bih,Bosnia and Herzegovina,2012,mcv2,94,32696,30734,1962,eur,mic_nongavi
bih,Bosnia and Herzegovina,2013,mcv1,92,32656,30044,2612,eur,mic_nongavi
bih,Bosnia and Herzegovina,2013,dtp3,89,32656,29064,3592,eur,mic_nongavi
bih,Bosnia and Herzegovina,2013,dtp1,94,32656,30697,1959,eur,mic_nongavi
bih,Bosnia and Herzegovina,2013,mcv2,93,33430,31090,2340,eur,mic_nongavi
bih,Bosnia and Herzegovina,2014,dtp3,86,32434,27893,4541,eur,mic_nongavi
bih,Bosnia and Herzegovina,2014,mcv1,89,32434,28866,3568,eur,mic_nongavi
bih,Bosnia and Herzegovina,2014,dtp1,92,32434,29839,2595,eur,mic_nongavi
bih,Bosnia and Herzegovina,2014,mcv2,92,34323,31577,2746,eur,mic_nongavi
bih,Bosnia and Herzegovina,2015,mcv1,83,32299,26808,5491,eur,mic_nongavi
bih,Bosnia and Herzegovina,2015,dtp1,89,32299,28746,3553,eur,mic_nongavi
bih,Bosnia and Herzegovina,2015,dtp3,82,32299,26485,5814,eur,mic_nongavi
bih,Bosnia and Herzegovina,2015,mcv2,88,34731,30563,4168,eur,mic_nongavi
bih,Bosnia and Herzegovina,2016,dtp1,90,32253,29028,3225,eur,mic_nongavi
bih,Bosnia and Herzegovina,2016,mcv1,83,32253,26770,5483,eur,mic_nongavi
bih,Bosnia and Herzegovina,2016,dtp3,78,32253,25157,7096,eur,mic_nongavi
bih,Bosnia and Herzegovina,2016,mcv2,78,34461,26880,7581,eur,mic_nongavi
blr,Belarus,2000,mcv1,98,87628,85875,1753,eur,mic_nongavi
blr,Belarus,2000,dtp1,99,87628,86752,876,eur,mic_nongavi
blr,Belarus,2000,dtp3,99,87628,86752,876,eur,mic_nongavi
blr,Belarus,2000,mcv2,92,109930,101136,8794,eur,mic_nongavi
blr,Belarus,2001,mcv1,99,87423,86549,874,eur,mic_nongavi
blr,Belarus,2001,dtp3,99,87423,86549,874,eur,mic_nongavi
blr,Belarus,2001,dtp1,99,87423,86549,874,eur,mic_nongavi
blr,Belarus,2001,mcv2,97,103053,99961,3092,eur,mic_nongavi
blr,Belarus,2002,dtp3,99,88131,87250,881,eur,mic_nongavi
blr,Belarus,2002,dtp1,99,88131,87250,881,eur,mic_nongavi
blr,Belarus,2002,mcv1,99,88131,87250,881,eur,mic_nongavi
blr,Belarus,2002,mcv2,98,97667,95714,1953,eur,mic_nongavi
blr,Belarus,2003,mcv1,99,89567,88671,896,eur,mic_nongavi
blr,Belarus,2003,dtp3,50,89567,44784,44783,eur,mic_nongavi
blr,Belarus,2003,dtp1,74,89567,66280,23287,eur,mic_nongavi
blr,Belarus,2003,mcv2,98,93507,91637,1870,eur,mic_nongavi
blr,Belarus,2004,dtp3,99,91577,90661,916,eur,mic_nongavi
blr,Belarus,2004,dtp1,99,91577,90661,916,eur,mic_nongavi
blr,Belarus,2004,mcv1,99,91577,90661,916,eur,mic_nongavi
blr,Belarus,2004,mcv2,98,90262,88457,1805,eur,mic_nongavi
blr,Belarus,2005,dtp1,99,94044,93104,940,eur,mic_nongavi
blr,Belarus,2005,mcv1,99,94044,93104,940,eur,mic_nongavi
blr,Belarus,2005,dtp3,99,94044,93104,940,eur,mic_nongavi
blr,Belarus,2005,mcv2,98,87387,85639,1748,eur,mic_nongavi
blr,Belarus,2006,mcv1,97,96884,93977,2907,eur,mic_nongavi
blr,Belarus,2006,dtp1,99,96884,95915,969,eur,mic_nongavi
blr,Belarus,2006,dtp3,99,96884,95915,969,eur,mic_nongavi
blr,Belarus,2006,mcv2,95,85461,81188,4273,eur,mic_nongavi
blr,Belarus,2007,mcv1,99,99981,98981,1000,eur,mic_nongavi
blr,Belarus,2007,dtp1,99,99981,98981,1000,eur,mic_nongavi
blr,Belarus,2007,dtp3,95,99981,94982,4999,eur,mic_nongavi
blr,Belarus,2007,mcv2,99,85071,84220,851,eur,mic_nongavi
blr,Belarus,2008,dtp1,98,103171,101108,2063,eur,mic_nongavi
blr,Belarus,2008,mcv1,99,103171,102139,1032,eur,mic_nongavi
blr,Belarus,2008,dtp3,97,103171,100076,3095,eur,mic_nongavi
blr,Belarus,2008,mcv2,99,85821,84963,858,eur,mic_nongavi
blr,Belarus,2009,dtp1,98,106254,104129,2125,eur,mic_nongavi
blr,Belarus,2009,mcv1,99,106254,105191,1063,eur,mic_nongavi
blr,Belarus,2009,dtp3,96,106254,102004,4250,eur,mic_nongavi
blr,Belarus,2009,mcv2,99,87346,86473,873,eur,mic_nongavi
blr,Belarus,2010,dtp1,99,109004,107914,1090,eur,mic_nongavi
blr,Belarus,2010,mcv1,99,109004,107914,1090,eur,mic_nongavi
blr,Belarus,2010,dtp3,98,109004,106824,2180,eur,mic_nongavi
blr,Belarus,2010,mcv2,99,89063,88172,891,eur,mic_nongavi
blr,Belarus,2011,dtp1,99,111235,110123,1112,eur,mic_nongavi
blr,Belarus,2011,mcv1,99,111235,110123,1112,eur,mic_nongavi
blr,Belarus,2011,dtp3,98,111235,109010,2225,eur,mic_nongavi
blr,Belarus,2011,mcv2,99,91598,90682,916,eur,mic_nongavi
blr,Belarus,2012,mcv1,98,112876,110618,2258,eur,mic_nongavi
blr,Belarus,2012,dtp3,98,112876,110618,2258,eur,mic_nongavi
blr,Belarus,2012,dtp1,98,112876,110618,2258,eur,mic_nongavi
blr,Belarus,2012,mcv2,97,94834,91989,2845,eur,mic_nongavi
blr,Belarus,2013,dtp1,99,113894,112755,1139,eur,mic_nongavi
blr,Belarus,2013,mcv1,99,113894,112755,1139,eur,mic_nongavi
blr,Belarus,2013,dtp3,98,113894,111616,2278,eur,mic_nongavi
blr,Belarus,2013,mcv2,99,98482,97497,985,eur,mic_nongavi
blr,Belarus,2014,dtp3,97,114257,110829,3428,eur,mic_nongavi
blr,Belarus,2014,dtp1,97,114257,110829,3428,eur,mic_nongavi
blr,Belarus,2014,mcv1,99,114257,113114,1143,eur,mic_nongavi
blr,Belarus,2014,mcv2,98,102251,100206,2045,eur,mic_nongavi
blr,Belarus,2015,mcv1,99,113983,112843,1140,eur,mic_nongavi
blr,Belarus,2015,dtp3,99,113983,112843,1140,eur,mic_nongavi
blr,Belarus,2015,dtp1,99,113983,112843,1140,eur,mic_nongavi
blr,Belarus,2015,mcv2,99,105790,104732,1058,eur,mic_nongavi
blr,Belarus,2016,dtp1,99,113145,112014,1131,eur,mic_nongavi
blr,Belarus,2016,dtp3,98,113145,110882,2263,eur,mic_nongavi
blr,Belarus,2016,mcv1,98,113145,110882,2263,eur,mic_nongavi
blr,Belarus,2016,mcv2,98,108987,106807,2180,eur,mic_nongavi
blz,Belize,2000,dtp1,96,7194,6906,288,amr,mic_nongavi
blz,Belize,2000,dtp3,91,7194,6547,647,amr,mic_nongavi
blz,Belize,2000,mcv1,96,7194,6906,288,amr,mic_nongavi
blz,Belize,2001,mcv1,94,7273,6837,436,amr,mic_nongavi
blz,Belize,2001,dtp3,96,7273,6982,291,amr,mic_nongavi
blz,Belize,2001,dtp1,97,7273,7055,218,amr,mic_nongavi
blz,Belize,2002,dtp1,97,7325,7105,220,amr,mic_nongavi
blz,Belize,2002,mcv1,88,7325,6446,879,amr,mic_nongavi
blz,Belize,2002,dtp3,89,7325,6519,806,amr,mic_nongavi
blz,Belize,2003,dtp3,96,7351,7057,294,amr,mic_nongavi
blz,Belize,2003,mcv1,96,7351,7057,294,amr,mic_nongavi
blz,Belize,2003,dtp1,98,7351,7204,147,amr,mic_nongavi
blz,Belize,2004,dtp1,98,7353,7206,147,amr,mic_nongavi
blz,Belize,2004,dtp3,97,7353,7132,221,amr,mic_nongavi
blz,Belize,2004,mcv1,97,7353,7132,221,amr,mic_nongavi
blz,Belize,2005,dtp3,96,7342,7048,294,amr,mic_nongavi
blz,Belize,2005,dtp1,98,7342,7195,147,amr,mic_nongavi
blz,Belize,2005,mcv1,95,7342,6975,367,amr,mic_nongavi
blz,Belize,2005,mcv2,87,7715,6712,1003,amr,mic_nongavi
blz,Belize,2006,dtp1,98,7330,7183,147,amr,mic_nongavi
blz,Belize,2006,mcv1,99,7330,7257,73,amr,mic_nongavi
blz,Belize,2006,dtp3,98,7330,7183,147,amr,mic_nongavi
blz,Belize,2006,mcv2,92,7630,7020,610,amr,mic_nongavi
blz,Belize,2007,dtp3,96,7333,7040,293,amr,mic_nongavi
blz,Belize,2007,dtp1,98,7333,7186,147,amr,mic_nongavi
blz,Belize,2007,mcv1,96,7333,7040,293,amr,mic_nongavi
blz,Belize,2007,mcv2,89,7554,6723,831,amr,mic_nongavi
blz,Belize,2008,dtp1,98,7360,7213,147,amr,mic_nongavi
blz,Belize,2008,mcv1,96,7360,7066,294,amr,mic_nongavi
blz,Belize,2008,dtp3,94,7360,6918,442,amr,mic_nongavi
blz,Belize,2008,mcv2,90,7641,6877,764,amr,mic_nongavi
blz,Belize,2009,dtp1,99,7415,7341,74,amr,mic_nongavi
blz,Belize,2009,mcv1,97,7415,7193,222,amr,mic_nongavi
blz,Belize,2009,dtp3,97,7415,7193,222,amr,mic_nongavi
blz,Belize,2009,mcv2,92,7614,7005,609,amr,mic_nongavi
blz,Belize,2010,dtp1,99,7499,7424,75,amr,mic_nongavi
blz,Belize,2010,dtp3,96,7499,7199,300,amr,mic_nongavi
blz,Belize,2010,mcv1,98,7499,7349,150,amr,mic_nongavi
blz,Belize,2010,mcv2,91,7596,6912,684,amr,mic_nongavi
blz,Belize,2011,dtp3,95,7605,7225,380,amr,mic_nongavi
blz,Belize,2011,dtp1,98,7605,7453,152,amr,mic_nongavi
blz,Belize,2011,mcv1,98,7605,7453,152,amr,mic_nongavi
blz,Belize,2011,mcv2,98,7473,7324,149,amr,mic_nongavi
blz,Belize,2012,dtp3,98,7725,7571,154,amr,mic_nongavi
blz,Belize,2012,dtp1,99,7725,7648,77,amr,mic_nongavi
blz,Belize,2012,mcv1,96,7725,7416,309,amr,mic_nongavi
blz,Belize,2012,mcv2,93,7379,6862,517,amr,mic_nongavi
blz,Belize,2013,dtp1,96,7847,7533,314,amr,mic_nongavi
blz,Belize,2013,mcv1,99,7847,7769,78,amr,mic_nongavi
blz,Belize,2013,dtp3,95,7847,7455,392,amr,mic_nongavi
blz,Belize,2013,mcv2,92,7683,7068,615,amr,mic_nongavi
blz,Belize,2014,dtp3,95,7965,7567,398,amr,mic_nongavi
blz,Belize,2014,dtp1,96,7965,7646,319,amr,mic_nongavi
blz,Belize,2014,mcv1,95,7965,7567,398,amr,mic_nongavi
blz,Belize,2014,mcv2,92,7743,7124,619,amr,mic_nongavi
blz,Belize,2015,dtp3,94,8075,7590,485,amr,mic_nongavi
blz,Belize,2015,mcv1,96,8075,7752,323,amr,mic_nongavi
blz,Belize,2015,dtp1,97,8075,7833,242,amr,mic_nongavi
blz,Belize,2015,mcv2,95,7825,7434,391,amr,mic_nongavi
blz,Belize,2016,mcv1,95,8177,7768,409,amr,mic_nongavi
blz,Belize,2016,dtp3,95,8177,7768,409,amr,mic_nongavi
blz,Belize,2016,dtp1,98,8177,8013,164,amr,mic_nongavi
blz,Belize,2016,mcv2,96,8032,7711,321,amr,mic_nongavi
bol,Bolivia (Plurinational State of),2000,dtp1,92,240593,221346,19247,amr,gavi
bol,Bolivia (Plurinational State of),2000,dtp3,75,240593,180445,60148,amr,gavi
bol,Bolivia (Plurinational State of),2000,mcv1,84,240593,202098,38495,amr,gavi
bol,Bolivia (Plurinational State of),2001,dtp1,91,241322,219603,21719,amr,gavi
bol,Bolivia (Plurinational State of),2001,mcv1,88,241322,212363,28959,amr,gavi
bol,Bolivia (Plurinational State of),2001,dtp3,71,241322,171339,69983,amr,gavi
bol,Bolivia (Plurinational State of),2002,dtp1,94,241827,227317,14510,amr,gavi
bol,Bolivia (Plurinational State of),2002,mcv1,91,241827,220063,21764,amr,gavi
bol,Bolivia (Plurinational State of),2002,dtp3,77,241827,186207,55620,amr,gavi
bol,Bolivia (Plurinational State of),2003,dtp1,96,242166,232479,9687,amr,gavi
bol,Bolivia (Plurinational State of),2003,mcv1,96,242166,232479,9687,amr,gavi
bol,Bolivia (Plurinational State of),2003,dtp3,88,242166,213106,29060,amr,gavi
bol,Bolivia (Plurinational State of),2004,mcv1,90,242373,218136,24237,amr,gavi
bol,Bolivia (Plurinational State of),2004,dtp1,88,242373,213288,29085,amr,gavi
bol,Bolivia (Plurinational State of),2004,dtp3,84,242373,203593,38780,amr,gavi
bol,Bolivia (Plurinational State of),2005,dtp1,93,242451,225479,16972,amr,gavi
bol,Bolivia (Plurinational State of),2005,mcv1,89,242451,215781,26670,amr,gavi
bol,Bolivia (Plurinational State of),2005,dtp3,85,242451,206083,36368,amr,gavi
bol,Bolivia (Plurinational State of),2006,dtp3,83,242382,201177,41205,amr,gavi
bol,Bolivia (Plurinational State of),2006,dtp1,87,242382,210872,31510,amr,gavi
bol,Bolivia (Plurinational State of),2006,mcv1,88,242382,213296,29086,amr,gavi
bol,Bolivia (Plurinational State of),2007,dtp1,85,242173,205847,36326,amr,gavi
bol,Bolivia (Plurinational State of),2007,dtp3,84,242173,203425,38748,amr,gavi
bol,Bolivia (Plurinational State of),2007,mcv1,86,242173,208269,33904,amr,gavi
bol,Bolivia (Plurinational State of),2008,dtp1,96,241859,232185,9674,amr,gavi
bol,Bolivia (Plurinational State of),2008,dtp3,88,241859,212836,29023,amr,gavi
bol,Bolivia (Plurinational State of),2008,mcv1,92,241859,222510,19349,amr,gavi
bol,Bolivia (Plurinational State of),2009,dtp1,97,241502,234257,7245,amr,gavi
bol,Bolivia (Plurinational State of),2009,dtp3,93,241502,224597,16905,amr,gavi
bol,Bolivia (Plurinational State of),2009,mcv1,93,241502,224597,16905,amr,gavi
bol,Bolivia (Plurinational State of),2010,dtp1,97,241203,233967,7236,amr,gavi
bol,Bolivia (Plurinational State of),2010,mcv1,88,241203,212259,28944,amr,gavi
bol,Bolivia (Plurinational State of),2010,dtp3,91,241203,219495,21708,amr,gavi
bol,Bolivia (Plurinational State of),2011,dtp1,98,241071,236250,4821,amr,gavi
bol,Bolivia (Plurinational State of),2011,dtp3,95,241071,229017,12054,amr,gavi
bol,Bolivia (Plurinational State of),2011,mcv1,96,241071,231428,9643,amr,gavi
bol,Bolivia (Plurinational State of),2012,dtp3,93,241170,224288,16882,amr,gavi
bol,Bolivia (Plurinational State of),2012,mcv1,96,241170,231523,9647,amr,gavi
bol,Bolivia (Plurinational State of),2012,dtp1,97,241170,233935,7235,amr,gavi
bol,Bolivia (Plurinational State of),2013,dtp3,94,241527,227035,14492,amr,gavi
bol,Bolivia (Plurinational State of),2013,mcv1,95,241527,229451,12076,amr,gavi
bol,Bolivia (Plurinational State of),2013,dtp1,98,241527,236696,4831,amr,gavi
bol,Bolivia (Plurinational State of),2014,mcv1,99,242141,239720,2421,amr,gavi
bol,Bolivia (Plurinational State of),2014,dtp3,98,242141,237298,4843,amr,gavi
bol,Bolivia (Plurinational State of),2014,dtp1,99,242141,239720,2421,amr,gavi
bol,Bolivia (Plurinational State of),2015,dtp3,99,242972,240542,2430,amr,gavi
bol,Bolivia (Plurinational State of),2015,mcv1,99,242972,240542,2430,amr,gavi
bol,Bolivia (Plurinational State of),2015,dtp1,99,242972,240542,2430,amr,gavi
bol,Bolivia (Plurinational State of),2016,dtp1,99,243945,241506,2439,amr,gavi
bol,Bolivia (Plurinational State of),2016,dtp3,99,243945,241506,2439,amr,gavi
bol,Bolivia (Plurinational State of),2016,mcv1,99,243945,241506,2439,amr,gavi
bra,Brazil,2000,dtp3,98,3428049,3359488,68561,amr,mic_nongavi
bra,Brazil,2000,dtp1,99,3428049,3393769,34280,amr,mic_nongavi
bra,Brazil,2000,mcv1,99,3428049,3393769,34280,amr,mic_nongavi
bra,Brazil,2000,mcv2,95,3473106,3299451,173655,amr,mic_nongavi
bra,Brazil,2001,mcv1,99,3378917,3345128,33789,amr,mic_nongavi
bra,Brazil,2001,dtp3,98,3378917,3311339,67578,amr,mic_nongavi
bra,Brazil,2001,dtp1,99,3378917,3345128,33789,amr,mic_nongavi
bra,Brazil,2001,mcv2,95,3487803,3313413,174390,amr,mic_nongavi
bra,Brazil,2002,dtp1,99,3323582,3290346,33236,amr,mic_nongavi
bra,Brazil,2002,dtp3,99,3323582,3290346,33236,amr,mic_nongavi
bra,Brazil,2002,mcv1,96,3323582,3190639,132943,amr,mic_nongavi
bra,Brazil,2002,mcv2,80,3504547,2803638,700909,amr,mic_nongavi
bra,Brazil,2003,dtp1,99,3265766,3233108,32658,amr,mic_nongavi
bra,Brazil,2003,mcv1,97,3265766,3167793,97973,amr,mic_nongavi
bra,Brazil,2003,dtp3,99,3265766,3233108,32658,amr,mic_nongavi
bra,Brazil,2003,mcv2,74,3511714,2598668,913046,amr,mic_nongavi
bra,Brazil,2004,dtp1,99,3208199,3176117,32082,amr,mic_nongavi
bra,Brazil,2004,dtp3,99,3208199,3176117,32082,amr,mic_nongavi
bra,Brazil,2004,mcv1,97,3208199,3111953,96246,amr,mic_nongavi
bra,Brazil,2004,mcv2,68,3494596,2376325,1118271,amr,mic_nongavi
bra,Brazil,2005,dtp1,99,3154356,3122812,31544,amr,mic_nongavi
bra,Brazil,2005,mcv1,98,3154356,3091269,63087,amr,mic_nongavi
bra,Brazil,2005,dtp3,99,3154356,3122812,31544,amr,mic_nongavi
bra,Brazil,2005,mcv2,61,3436607,2096330,1340277,amr,mic_nongavi
bra,Brazil,2006,dtp3,99,3107386,3076312,31074,amr,mic_nongavi
bra,Brazil,2006,dtp1,99,3107386,3076312,31074,amr,mic_nongavi
bra,Brazil,2006,mcv1,99,3107386,3076312,31074,amr,mic_nongavi
bra,Brazil,2006,mcv2,55,3374470,1855959,1518511,amr,mic_nongavi
bra,Brazil,2007,dtp3,99,3068330,3037647,30683,amr,mic_nongavi
bra,Brazil,2007,dtp1,99,3068330,3037647,30683,amr,mic_nongavi
bra,Brazil,2007,mcv1,99,3068330,3037647,30683,amr,mic_nongavi
bra,Brazil,2007,mcv2,49,3298534,1616282,1682252,amr,mic_nongavi
bra,Brazil,2008,mcv1,99,3037382,3007008,30374,amr,mic_nongavi
bra,Brazil,2008,dtp1,99,3037382,3007008,30374,amr,mic_nongavi
bra,Brazil,2008,dtp3,99,3037382,3007008,30374,amr,mic_nongavi
bra,Brazil,2008,mcv2,56,3219854,1803118,1416736,amr,mic_nongavi
bra,Brazil,2009,dtp1,99,3014342,2984199,30143,amr,mic_nongavi
bra,Brazil,2009,dtp3,99,3014342,2984199,30143,amr,mic_nongavi
bra,Brazil,2009,mcv1,99,3014342,2984199,30143,amr,mic_nongavi
bra,Brazil,2009,mcv2,55,3153067,1734187,1418880,amr,mic_nongavi
bra,Brazil,2010,dtp1,99,2997821,2967843,29978,amr,mic_nongavi
bra,Brazil,2010,dtp3,99,2997821,2967843,29978,amr,mic_nongavi
bra,Brazil,2010,mcv1,99,2997821,2967843,29978,amr,mic_nongavi
bra,Brazil,2010,mcv2,53,3115525,1651228,1464297,amr,mic_nongavi
bra,Brazil,2011,dtp3,99,2985416,2955562,29854,amr,mic_nongavi
bra,Brazil,2011,mcv1,99,2985416,2955562,29854,amr,mic_nongavi
bra,Brazil,2011,dtp1,99,2985416,2955562,29854,amr,mic_nongavi
bra,Brazil,2011,mcv2,71,3067216,2177723,889493,amr,mic_nongavi
bra,Brazil,2012,dtp3,95,2973891,2825196,148695,amr,mic_nongavi
bra,Brazil,2012,mcv1,99,2973891,2944152,29739,amr,mic_nongavi
bra,Brazil,2012,dtp1,99,2973891,2944152,29739,amr,mic_nongavi
bra,Brazil,2012,mcv2,70,3023809,2116666,907143,amr,mic_nongavi
bra,Brazil,2013,dtp3,97,2960552,2871735,88817,amr,mic_nongavi
bra,Brazil,2013,dtp1,98,2960552,2901341,59211,amr,mic_nongavi
bra,Brazil,2013,mcv1,98,2960552,2901341,59211,amr,mic_nongavi
bra,Brazil,2013,mcv2,69,2987472,2061356,926116,amr,mic_nongavi
bra,Brazil,2014,dtp3,93,2944039,2737956,206083,amr,mic_nongavi
bra,Brazil,2014,dtp1,98,2944039,2885158,58881,amr,mic_nongavi
bra,Brazil,2014,mcv1,97,2944039,2855718,88321,amr,mic_nongavi
bra,Brazil,2014,mcv2,89,2960396,2634752,325644,amr,mic_nongavi
bra,Brazil,2015,dtp1,97,2923611,2835903,87708,amr,mic_nongavi
bra,Brazil,2015,mcv1,96,2923611,2806667,116944,amr,mic_nongavi
bra,Brazil,2015,dtp3,96,2923611,2806667,116944,amr,mic_nongavi
bra,Brazil,2015,mcv2,80,2944626,2355701,588925,amr,mic_nongavi
bra,Brazil,2016,dtp3,86,2899421,2493502,405919,amr,mic_nongavi
bra,Brazil,2016,dtp1,89,2899421,2580485,318936,amr,mic_nongavi
bra,Brazil,2016,mcv1,96,2899421,2783444,115977,amr,mic_nongavi
bra,Brazil,2016,mcv2,72,2950062,2124045,826017,amr,mic_nongavi
brb,Barbados,2000,dtp1,93,3671,3414,257,amr,hic
brb,Barbados,2000,dtp3,93,3671,3414,257,amr,hic
brb,Barbados,2000,mcv1,94,3671,3451,220,amr,hic
brb,Barbados,2001,dtp1,92,3629,3339,290,amr,hic
brb,Barbados,2001,mcv1,93,3629,3375,254,amr,hic
brb,Barbados,2001,dtp3,84,3629,3048,581,amr,hic
brb,Barbados,2001,mcv2,12,3778,453,3325,amr,hic
brb,Barbados,2002,mcv1,91,3591,3268,323,amr,hic
brb,Barbados,2002,dtp1,92,3591,3304,287,amr,hic
brb,Barbados,2002,dtp3,87,3591,3124,467,amr,hic
brb,Barbados,2002,mcv2,41,3680,1509,2171,amr,hic
brb,Barbados,2003,dtp1,91,3560,3240,320,amr,hic
brb,Barbados,2003,mcv1,90,3560,3204,356,amr,hic
brb,Barbados,2003,dtp3,89,3560,3168,392,amr,hic
brb,Barbados,2003,mcv2,71,3608,2562,1046,amr,hic
brb,Barbados,2004,dtp3,93,3535,3288,247,amr,hic
brb,Barbados,2004,dtp1,97,3535,3429,106,amr,hic
brb,Barbados,2004,mcv1,98,3535,3464,71,amr,hic
brb,Barbados,2004,mcv2,99,3673,3636,37,amr,hic
brb,Barbados,2005,dtp3,92,3516,3235,281,amr,hic
brb,Barbados,2005,dtp1,97,3516,3411,105,amr,hic
brb,Barbados,2005,mcv1,93,3516,3270,246,amr,hic
brb,Barbados,2005,mcv2,98,3641,3568,73,amr,hic
brb,Barbados,2006,dtp1,94,3502,3292,210,amr,hic
brb,Barbados,2006,mcv1,92,3502,3222,280,amr,hic
brb,Barbados,2006,dtp3,84,3502,2942,560,amr,hic
brb,Barbados,2006,mcv2,94,3656,3437,219,amr,hic
brb,Barbados,2007,dtp3,93,3489,3245,244,amr,hic
brb,Barbados,2007,dtp1,93,3489,3245,244,amr,hic
brb,Barbados,2007,mcv1,75,3489,2617,872,amr,hic
brb,Barbados,2007,mcv2,96,3680,3533,147,amr,hic
brb,Barbados,2008,dtp1,85,3477,2955,522,amr,hic
brb,Barbados,2008,dtp3,85,3477,2955,522,amr,hic
brb,Barbados,2008,mcv1,94,3477,3268,209,amr,hic
brb,Barbados,2008,mcv2,97,3700,3589,111,amr,hic
brb,Barbados,2009,dtp1,93,3464,3222,242,amr,hic
brb,Barbados,2009,mcv1,94,3464,3256,208,amr,hic
brb,Barbados,2009,dtp3,93,3464,3222,242,amr,hic
brb,Barbados,2009,mcv2,97,3649,3540,109,amr,hic
brb,Barbados,2010,dtp1,94,3451,3244,207,amr,hic
brb,Barbados,2010,mcv1,85,3451,2933,518,amr,hic
brb,Barbados,2010,dtp3,86,3451,2968,483,amr,hic
brb,Barbados,2010,mcv2,96,3646,3500,146,amr,hic
brb,Barbados,2011,mcv1,93,3437,3196,241,amr,hic
brb,Barbados,2011,dtp1,95,3437,3265,172,amr,hic
brb,Barbados,2011,dtp3,91,3437,3128,309,amr,hic
brb,Barbados,2011,mcv2,94,3591,3376,215,amr,hic
brb,Barbados,2012,dtp3,87,3422,2977,445,amr,hic
brb,Barbados,2012,mcv1,90,3422,3080,342,amr,hic
brb,Barbados,2012,dtp1,96,3422,3285,137,amr,hic
brb,Barbados,2012,mcv2,90,3538,3184,354,amr,hic
brb,Barbados,2013,dtp3,91,3408,3101,307,amr,hic
brb,Barbados,2013,dtp1,97,3408,3306,102,amr,hic
brb,Barbados,2013,mcv1,87,3408,2965,443,amr,hic
brb,Barbados,2013,mcv2,89,3500,3115,385,amr,hic
brb,Barbados,2014,dtp3,94,3393,3189,204,amr,hic
brb,Barbados,2014,dtp1,98,3393,3325,68,amr,hic
brb,Barbados,2014,mcv1,95,3393,3223,170,amr,hic
brb,Barbados,2014,mcv2,91,3554,3234,320,amr,hic
brb,Barbados,2015,dtp3,97,3378,3277,101,amr,hic
brb,Barbados,2015,dtp1,99,3378,3344,34,amr,hic
brb,Barbados,2015,mcv1,96,3378,3243,135,amr,hic
brb,Barbados,2015,mcv2,89,3529,3141,388,amr,hic
brb,Barbados,2016,dtp3,97,3362,3261,101,amr,hic
brb,Barbados,2016,mcv1,92,3362,3093,269,amr,hic
brb,Barbados,2016,dtp1,99,3362,3328,34,amr,hic
brb,Barbados,2016,mcv2,87,3512,3055,457,amr,hic
brn,Brunei Darussalam,2000,dtp1,99,7070,6999,71,wpr,hic
brn,Brunei Darussalam,2000,dtp3,99,7070,6999,71,wpr,hic
brn,Brunei Darussalam,2000,mcv1,99,7070,6999,71,wpr,hic
brn,Brunei Darussalam,2000,mcv2,95,6750,6412,338,wpr,hic
brn,Brunei Darussalam,2001,mcv1,99,6896,6827,69,wpr,hic
brn,Brunei Darussalam,2001,dtp1,99,6896,6827,69,wpr,hic
brn,Brunei Darussalam,2001,dtp3,97,6896,6689,207,wpr,hic
brn,Brunei Darussalam,2001,mcv2,95,6797,6457,340,wpr,hic
brn,Brunei Darussalam,2002,dtp1,99,6727,6660,67,wpr,hic
brn,Brunei Darussalam,2002,mcv1,99,6727,6660,67,wpr,hic
brn,Brunei Darussalam,2002,dtp3,94,6727,6323,404,wpr,hic
brn,Brunei Darussalam,2002,mcv2,96,6871,6596,275,wpr,hic
brn,Brunei Darussalam,2003,dtp1,99,6570,6504,66,wpr,hic
brn,Brunei Darussalam,2003,mcv1,98,6570,6439,131,wpr,hic
brn,Brunei Darussalam,2003,dtp3,92,6570,6044,526,wpr,hic
brn,Brunei Darussalam,2003,mcv2,96,6942,6664,278,wpr,hic
brn,Brunei Darussalam,2004,dtp1,99,6434,6370,64,wpr,hic
brn,Brunei Darussalam,2004,mcv1,99,6434,6370,64,wpr,hic
brn,Brunei Darussalam,2004,dtp3,92,6434,5919,515,wpr,hic
brn,Brunei Darussalam,2004,mcv2,97,6965,6756,209,wpr,hic
brn,Brunei Darussalam,2005,dtp3,94,6333,5953,380,wpr,hic
brn,Brunei Darussalam,2005,dtp1,99,6333,6270,63,wpr,hic
brn,Brunei Darussalam,2005,mcv1,98,6333,6206,127,wpr,hic
brn,Brunei Darussalam,2005,mcv2,95,6930,6584,346,wpr,hic
brn,Brunei Darussalam,2006,dtp1,99,6277,6214,63,wpr,hic
brn,Brunei Darussalam,2006,dtp3,97,6277,6089,188,wpr,hic
brn,Brunei Darussalam,2006,mcv1,97,6277,6089,188,wpr,hic
brn,Brunei Darussalam,2006,mcv2,94,6971,6553,418,wpr,hic
brn,Brunei Darussalam,2007,mcv1,97,6264,6076,188,wpr,hic
brn,Brunei Darussalam,2007,dtp3,99,6264,6201,63,wpr,hic
brn,Brunei Darussalam,2007,dtp1,99,6264,6201,63,wpr,hic
brn,Brunei Darussalam,2007,mcv2,92,7031,6469,562,wpr,hic
brn,Brunei Darussalam,2008,dtp1,99,6290,6227,63,wpr,hic
brn,Brunei Darussalam,2008,mcv1,99,6290,6227,63,wpr,hic
brn,Brunei Darussalam,2008,dtp3,98,6290,6164,126,wpr,hic
brn,Brunei Darussalam,2008,mcv2,90,6496,5846,650,wpr,hic
brn,Brunei Darussalam,2009,dtp3,99,6349,6286,63,wpr,hic
brn,Brunei Darussalam,2009,mcv1,99,6349,6286,63,wpr,hic
brn,Brunei Darussalam,2009,dtp1,99,6349,6286,63,wpr,hic
brn,Brunei Darussalam,2009,mcv2,99,6429,6365,64,wpr,hic
brn,Brunei Darussalam,2010,dtp1,98,6428,6299,129,wpr,hic
brn,Brunei Darussalam,2010,dtp3,95,6428,6107,321,wpr,hic
brn,Brunei Darussalam,2010,mcv1,94,6428,6042,386,wpr,hic
brn,Brunei Darussalam,2010,mcv2,93,6384,5937,447,wpr,hic
brn,Brunei Darussalam,2011,dtp1,99,6515,6450,65,wpr,hic
brn,Brunei Darussalam,2011,mcv1,91,6515,5929,586,wpr,hic
brn,Brunei Darussalam,2011,dtp3,97,6515,6320,195,wpr,hic
brn,Brunei Darussalam,2011,mcv2,93,6275,5836,439,wpr,hic
brn,Brunei Darussalam,2012,mcv1,99,6594,6528,66,wpr,hic
brn,Brunei Darussalam,2012,dtp1,99,6594,6528,66,wpr,hic
brn,Brunei Darussalam,2012,dtp3,99,6594,6528,66,wpr,hic
brn,Brunei Darussalam,2012,mcv2,92,6196,5700,496,wpr,hic
brn,Brunei Darussalam,2013,mcv1,96,6653,6387,266,wpr,hic
brn,Brunei Darussalam,2013,dtp1,99,6653,6586,67,wpr,hic
brn,Brunei Darussalam,2013,dtp3,99,6653,6586,67,wpr,hic
brn,Brunei Darussalam,2013,mcv2,92,6172,5678,494,wpr,hic
brn,Brunei Darussalam,2014,mcv1,97,6685,6484,201,wpr,hic
brn,Brunei Darussalam,2014,dtp3,99,6685,6618,67,wpr,hic
brn,Brunei Darussalam,2014,dtp1,99,6685,6618,67,wpr,hic
brn,Brunei Darussalam,2014,mcv2,96,6370,6115,255,wpr,hic
brn,Brunei Darussalam,2015,dtp3,99,6689,6622,67,wpr,hic
brn,Brunei Darussalam,2015,mcv1,96,6689,6421,268,wpr,hic
brn,Brunei Darussalam,2015,dtp1,99,6689,6622,67,wpr,hic
brn,Brunei Darussalam,2015,mcv2,97,6421,6228,193,wpr,hic
brn,Brunei Darussalam,2016,dtp1,99,6668,6601,67,wpr,hic
brn,Brunei Darussalam,2016,mcv1,98,6668,6535,133,wpr,hic
brn,Brunei Darussalam,2016,dtp3,99,6668,6601,67,wpr,hic
brn,Brunei Darussalam,2016,mcv2,97,6630,6431,199,wpr,hic
btn,Bhutan,2000,dtp3,92,15176,13962,1214,sear,gavi
btn,Bhutan,2000,dtp1,96,15176,14569,607,sear,gavi
btn,Bhutan,2000,mcv1,78,15176,11837,3339,sear,gavi
btn,Bhutan,2001,dtp3,88,14981,13183,1798,sear,gavi
btn,Bhutan,2001,dtp1,96,14981,14382,599,sear,gavi
btn,Bhutan,2001,mcv1,78,14981,11685,3296,sear,gavi
btn,Bhutan,2002,mcv1,78,14838,11574,3264,sear,gavi
btn,Bhutan,2002,dtp3,86,14838,12761,2077,sear,gavi
btn,Bhutan,2002,dtp1,95,14838,14096,742,sear,gavi
btn,Bhutan,2003,dtp1,96,14745,14155,590,sear,gavi
btn,Bhutan,2003,mcv1,88,14745,12976,1769,sear,gavi
btn,Bhutan,2003,dtp3,95,14745,14008,737,sear,gavi
btn,Bhutan,2004,mcv1,87,14697,12786,1911,sear,gavi
btn,Bhutan,2004,dtp3,89,14697,13080,1617,sear,gavi
btn,Bhutan,2004,dtp1,92,14697,13521,1176,sear,gavi
btn,Bhutan,2005,dtp3,95,14676,13942,734,sear,gavi
btn,Bhutan,2005,dtp1,97,14676,14236,440,sear,gavi
btn,Bhutan,2005,mcv1,93,14676,13649,1027,sear,gavi
btn,Bhutan,2006,dtp3,95,14664,13931,733,sear,gavi
btn,Bhutan,2006,dtp1,97,14664,14224,440,sear,gavi
btn,Bhutan,2006,mcv1,90,14664,13198,1466,sear,gavi
btn,Bhutan,2007,dtp1,98,14643,14350,293,sear,gavi
btn,Bhutan,2007,dtp3,95,14643,13911,732,sear,gavi
btn,Bhutan,2007,mcv1,95,14643,13911,732,sear,gavi
btn,Bhutan,2008,mcv1,99,14600,14454,146,sear,gavi
btn,Bhutan,2008,dtp1,97,14600,14162,438,sear,gavi
btn,Bhutan,2008,dtp3,96,14600,14016,584,sear,gavi
btn,Bhutan,2008,mcv2,72,14637,10539,4098,sear,gavi
btn,Bhutan,2009,mcv1,94,14532,13660,872,sear,gavi
btn,Bhutan,2009,dtp1,97,14532,14096,436,sear,gavi
btn,Bhutan,2009,dtp3,93,14532,13515,1017,sear,gavi
btn,Bhutan,2009,mcv2,79,14643,11568,3075,sear,gavi
btn,Bhutan,2010,mcv1,95,14444,13722,722,sear,gavi
btn,Bhutan,2010,dtp3,91,14444,13144,1300,sear,gavi
btn,Bhutan,2010,dtp1,94,14444,13577,867,sear,gavi
btn,Bhutan,2010,mcv2,85,14621,12428,2193,sear,gavi
btn,Bhutan,2011,mcv1,95,14350,13632,718,sear,gavi
btn,Bhutan,2011,dtp3,95,14350,13632,718,sear,gavi
btn,Bhutan,2011,dtp1,98,14350,14063,287,sear,gavi
btn,Bhutan,2011,mcv2,95,14800,14060,740,sear,gavi
btn,Bhutan,2012,dtp3,97,14266,13838,428,sear,gavi
btn,Bhutan,2012,mcv1,95,14266,13553,713,sear,gavi
btn,Bhutan,2012,dtp1,97,14266,13838,428,sear,gavi
btn,Bhutan,2012,mcv2,90,14941,13447,1494,sear,gavi
btn,Bhutan,2013,dtp3,97,14205,13779,426,sear,gavi
btn,Bhutan,2013,mcv1,94,14205,13353,852,sear,gavi
btn,Bhutan,2013,dtp1,97,14205,13779,426,sear,gavi
btn,Bhutan,2013,mcv2,89,14417,12831,1586,sear,gavi
btn,Bhutan,2014,mcv1,97,14163,13738,425,sear,gavi
btn,Bhutan,2014,dtp1,99,14163,14021,142,sear,gavi
btn,Bhutan,2014,dtp3,99,14163,14021,142,sear,gavi
btn,Bhutan,2014,mcv2,92,14319,13173,1146,sear,gavi
btn,Bhutan,2015,dtp3,99,14138,13997,141,sear,gavi
btn,Bhutan,2015,mcv1,97,14138,13714,424,sear,gavi
btn,Bhutan,2015,dtp1,99,14138,13997,141,sear,gavi
btn,Bhutan,2015,mcv2,94,14225,13372,853,sear,gavi
btn,Bhutan,2016,mcv1,97,14115,13692,423,sear,gavi
btn,Bhutan,2016,dtp1,99,14115,13974,141,sear,gavi
btn,Bhutan,2016,dtp3,98,14115,13833,282,sear,gavi
btn,Bhutan,2016,mcv2,90,13963,12567,1396,sear,gavi
bwa,Botswana,2000,dtp3,97,44222,42895,1327,afr,mic_nongavi
bwa,Botswana,2000,dtp1,98,44222,43338,884,afr,mic_nongavi
bwa,Botswana,2000,mcv1,91,44222,40242,3980,afr,mic_nongavi
bwa,Botswana,2001,dtp3,97,44204,42878,1326,afr,mic_nongavi
bwa,Botswana,2001,mcv1,91,44204,40226,3978,afr,mic_nongavi
bwa,Botswana,2001,dtp1,98,44204,43320,884,afr,mic_nongavi
bwa,Botswana,2002,mcv1,92,44258,40717,3541,afr,mic_nongavi
bwa,Botswana,2002,dtp1,98,44258,43373,885,afr,mic_nongavi
bwa,Botswana,2002,dtp3,97,44258,42930,1328,afr,mic_nongavi
bwa,Botswana,2003,mcv1,92,44411,40858,3553,afr,mic_nongavi
bwa,Botswana,2003,dtp1,98,44411,43523,888,afr,mic_nongavi
bwa,Botswana,2003,dtp3,96,44411,42635,1776,afr,mic_nongavi
bwa,Botswana,2004,dtp3,96,44679,42892,1787,afr,mic_nongavi
bwa,Botswana,2004,dtp1,98,44679,43785,894,afr,mic_nongavi
bwa,Botswana,2004,mcv1,93,44679,41551,3128,afr,mic_nongavi
bwa,Botswana,2005,dtp1,98,45094,44192,902,afr,mic_nongavi
bwa,Botswana,2005,mcv1,93,45094,41937,3157,afr,mic_nongavi
bwa,Botswana,2005,dtp3,96,45094,43290,1804,afr,mic_nongavi
bwa,Botswana,2006,mcv1,94,45680,42939,2741,afr,mic_nongavi
bwa,Botswana,2006,dtp3,96,45680,43853,1827,afr,mic_nongavi
bwa,Botswana,2006,dtp1,98,45680,44766,914,afr,mic_nongavi
bwa,Botswana,2007,dtp3,96,46417,44560,1857,afr,mic_nongavi
bwa,Botswana,2007,dtp1,98,46417,45489,928,afr,mic_nongavi
bwa,Botswana,2007,mcv1,95,46417,44096,2321,afr,mic_nongavi
bwa,Botswana,2008,dtp1,98,47266,46321,945,afr,mic_nongavi
bwa,Botswana,2008,dtp3,96,47266,45375,1891,afr,mic_nongavi
bwa,Botswana,2008,mcv1,95,47266,44903,2363,afr,mic_nongavi
bwa,Botswana,2009,dtp1,98,48181,47217,964,afr,mic_nongavi
bwa,Botswana,2009,mcv1,96,48181,46254,1927,afr,mic_nongavi
bwa,Botswana,2009,dtp3,96,48181,46254,1927,afr,mic_nongavi
bwa,Botswana,2010,dtp1,98,49097,48115,982,afr,mic_nongavi
bwa,Botswana,2010,mcv1,96,49097,47133,1964,afr,mic_nongavi
bwa,Botswana,2010,dtp3,95,49097,46642,2455,afr,mic_nongavi
bwa,Botswana,2011,dtp1,98,49937,48938,999,afr,mic_nongavi
bwa,Botswana,2011,mcv1,97,49937,48439,1498,afr,mic_nongavi
bwa,Botswana,2011,dtp3,95,49937,47440,2497,afr,mic_nongavi
bwa,Botswana,2012,dtp3,95,50645,48113,2532,afr,mic_nongavi
bwa,Botswana,2012,mcv1,97,50645,49126,1519,afr,mic_nongavi
bwa,Botswana,2012,dtp1,98,50645,49632,1013,afr,mic_nongavi
bwa,Botswana,2013,dtp3,95,51181,48622,2559,afr,mic_nongavi
bwa,Botswana,2013,dtp1,98,51181,50157,1024,afr,mic_nongavi
bwa,Botswana,2013,mcv1,97,51181,49646,1535,afr,mic_nongavi
bwa,Botswana,2013,mcv2,83,49281,40903,8378,afr,mic_nongavi
bwa,Botswana,2014,mcv1,97,51524,49978,1546,afr,mic_nongavi
bwa,Botswana,2014,dtp3,95,51524,48948,2576,afr,mic_nongavi
bwa,Botswana,2014,dtp1,98,51524,50494,1030,afr,mic_nongavi
bwa,Botswana,2014,mcv2,85,50272,42731,7541,afr,mic_nongavi
bwa,Botswana,2015,mcv1,97,51675,50125,1550,afr,mic_nongavi
bwa,Botswana,2015,dtp1,98,51675,50642,1033,afr,mic_nongavi
bwa,Botswana,2015,dtp3,95,51675,49091,2584,afr,mic_nongavi
bwa,Botswana,2015,mcv2,80,51065,40852,10213,afr,mic_nongavi
bwa,Botswana,2016,mcv1,97,51661,50111,1550,afr,mic_nongavi
bwa,Botswana,2016,dtp3,95,51661,49078,2583,afr,mic_nongavi
bwa,Botswana,2016,dtp1,98,51661,50628,1033,afr,mic_nongavi
bwa,Botswana,2016,mcv2,74,52091,38547,13544,afr,mic_nongavi
caf,Central African Republic,2000,dtp1,60,133005,79803,53202,afr,gavi
caf,Central African Republic,2000,dtp3,37,133005,49212,83793,afr,gavi
caf,Central African Republic,2000,mcv1,36,133005,47882,85123,afr,gavi
caf,Central African Republic,2001,dtp1,65,135506,88079,47427,afr,gavi
caf,Central African Republic,2001,mcv1,35,135506,47427,88079,afr,gavi
caf,Central African Republic,2001,dtp3,40,135506,54202,81304,afr,gavi
caf,Central African Republic,2002,dtp1,65,137886,89626,48260,afr,gavi
caf,Central African Republic,2002,dtp3,44,137886,60670,77216,afr,gavi
caf,Central African Republic,2002,mcv1,42,137886,57912,79974,afr,gavi
caf,Central African Republic,2003,dtp3,47,140124,65858,74266,afr,gavi
caf,Central African Republic,2003,dtp1,65,140124,91081,49043,afr,gavi
caf,Central African Republic,2003,mcv1,49,140124,68661,71463,afr,gavi
caf,Central African Republic,2004,dtp3,51,142195,72519,69676,afr,gavi
caf,Central African Republic,2004,dtp1,64,142195,91005,51190,afr,gavi
caf,Central African Republic,2004,mcv1,55,142195,78207,63988,afr,gavi
caf,Central African Republic,2005,dtp1,64,144075,92208,51867,afr,gavi
caf,Central African Republic,2005,dtp3,54,144075,77800,66275,afr,gavi
caf,Central African Republic,2005,mcv1,62,144075,89326,54749,afr,gavi
caf,Central African Republic,2006,dtp3,51,145750,74332,71418,afr,gavi
caf,Central African Republic,2006,dtp1,64,145750,93280,52470,afr,gavi
caf,Central African Republic,2006,mcv1,61,145750,88908,56842,afr,gavi
caf,Central African Republic,2007,mcv1,59,147227,86864,60363,afr,gavi
caf,Central African Republic,2007,dtp1,65,147227,95698,51529,afr,gavi
caf,Central African Republic,2007,dtp3,48,147227,70669,76558,afr,gavi
caf,Central African Republic,2008,mcv1,58,148513,86138,62375,afr,gavi
caf,Central African Republic,2008,dtp1,65,148513,96533,51980,afr,gavi
caf,Central African Republic,2008,dtp3,45,148513,66831,81682,afr,gavi
caf,Central African Republic,2009,dtp1,65,149609,97246,52363,afr,gavi
caf,Central African Republic,2009,dtp3,42,149609,62836,86773,afr,gavi
caf,Central African Republic,2009,mcv1,56,149609,83781,65828,afr,gavi
caf,Central African Republic,2010,dtp1,67,150471,100816,49655,afr,gavi
caf,Central African Republic,2010,mcv1,53,150471,79750,70721,afr,gavi
caf,Central African Republic,2010,dtp3,45,150471,67712,82759,afr,gavi
caf,Central African Republic,2011,dtp1,69,151040,104218,46822,afr,gavi
caf,Central African Republic,2011,mcv1,49,151040,74010,77030,afr,gavi
caf,Central African Republic,2011,dtp3,47,151040,70989,80051,afr,gavi
caf,Central African Republic,2012,dtp1,69,151336,104422,46914,afr,gavi
caf,Central African Republic,2012,mcv1,49,151336,74155,77181,afr,gavi
caf,Central African Republic,2012,dtp3,47,151336,71128,80208,afr,gavi
caf,Central African Republic,2013,dtp3,23,151428,34828,116600,afr,gavi
caf,Central African Republic,2013,dtp1,35,151428,53000,98428,afr,gavi
caf,Central African Republic,2013,mcv1,25,151428,37857,113571,afr,gavi
caf,Central African Republic,2014,mcv1,49,151423,74197,77226,afr,gavi
caf,Central African Republic,2014,dtp3,47,151423,71169,80254,afr,gavi
caf,Central African Republic,2014,dtp1,69,151423,104482,46941,afr,gavi
caf,Central African Republic,2015,mcv1,49,151491,74231,77260,afr,gavi
caf,Central African Republic,2015,dtp1,69,151491,104529,46962,afr,gavi
caf,Central African Republic,2015,dtp3,47,151491,71201,80290,afr,gavi
caf,Central African Republic,2016,dtp3,47,151820,71355,80465,afr,gavi
caf,Central African Republic,2016,dtp1,69,151820,104756,47064,afr,gavi
caf,Central African Republic,2016,mcv1,49,151820,74392,77428,afr,gavi
can,Canada,2000,dtp3,89,332182,295642,36540,amr,hic
can,Canada,2000,dtp1,95,332182,315573,16609,amr,hic
can,Canada,2000,mcv1,96,332182,318895,13287,amr,hic
can,Canada,2001,dtp1,95,330603,314073,16530,amr,hic
can,Canada,2001,mcv1,95,330603,314073,16530,amr,hic
can,Canada,2001,dtp3,89,330603,294237,36366,amr,hic
can,Canada,2002,dtp3,88,331633,291837,39796,amr,hic
can,Canada,2002,mcv1,95,331633,315051,16582,amr,hic
can,Canada,2002,dtp1,95,331633,315051,16582,amr,hic
can,Canada,2003,dtp1,95,334918,318172,16746,amr,hic
can,Canada,2003,dtp3,91,334918,304775,30143,amr,hic
can,Canada,2003,mcv1,95,334918,318172,16746,amr,hic
can,Canada,2004,mcv1,94,340141,319733,20408,amr,hic
can,Canada,2004,dtp3,91,340141,309528,30613,amr,hic
can,Canada,2004,dtp1,96,340141,326535,13606,amr,hic
can,Canada,2005,dtp3,93,346747,322475,24272,amr,hic
can,Canada,2005,dtp1,96,346747,332877,13870,amr,hic
can,Canada,2005,mcv1,94,346747,325942,20805,amr,hic
can,Canada,2006,dtp3,95,354023,336322,17701,amr,hic
can,Canada,2006,mcv1,93,354023,329241,24782,amr,hic
can,Canada,2006,dtp1,96,354023,339862,14161,amr,hic
can,Canada,2007,dtp1,96,361207,346759,14448,amr,hic
can,Canada,2007,dtp3,94,361207,339535,21672,amr,hic
can,Canada,2007,mcv1,94,361207,339535,21672,amr,hic
can,Canada,2008,dtp3,92,367662,338249,29413,amr,hic
can,Canada,2008,mcv1,93,367662,341926,25736,amr,hic
can,Canada,2008,dtp1,96,367662,352956,14706,amr,hic
can,Canada,2009,dtp3,91,373002,339432,33570,amr,hic
can,Canada,2009,dtp1,96,373002,358082,14920,amr,hic
can,Canada,2009,mcv1,91,373002,339432,33570,amr,hic
can,Canada,2010,dtp1,96,377017,361936,15081,amr,hic
can,Canada,2010,mcv1,90,377017,339315,37702,amr,hic
can,Canada,2010,dtp3,89,377017,335545,41472,amr,hic
can,Canada,2011,mcv1,88,379756,334185,45571,amr,hic
can,Canada,2011,dtp1,96,379756,364566,15190,amr,hic
can,Canada,2011,dtp3,87,379756,330388,49368,amr,hic
can,Canada,2012,dtp3,95,381645,362563,19082,amr,hic
can,Canada,2012,dtp1,99,381645,377829,3816,amr,hic
can,Canada,2012,mcv1,98,381645,374012,7633,amr,hic
can,Canada,2012,mcv2,94,396656,372857,23799,amr,hic
can,Canada,2013,dtp3,91,383061,348586,34475,amr,hic
can,Canada,2013,mcv1,90,383061,344755,38306,amr,hic
can,Canada,2013,dtp1,96,383061,367739,15322,amr,hic
can,Canada,2013,mcv2,92,388836,357729,31107,amr,hic
can,Canada,2014,dtp3,91,384143,349570,34573,amr,hic
can,Canada,2014,mcv1,90,384143,345729,38414,amr,hic
can,Canada,2014,dtp1,96,384143,368777,15366,amr,hic
can,Canada,2014,mcv2,90,391419,352277,39142,amr,hic
can,Canada,2015,mcv1,90,385029,346526,38503,amr,hic
can,Canada,2015,dtp3,91,385029,350376,34653,amr,hic
can,Canada,2015,dtp1,96,385029,369628,15401,amr,hic
can,Canada,2015,mcv2,88,393261,346070,47191,amr,hic
can,Canada,2016,dtp3,91,385822,351098,34724,amr,hic
can,Canada,2016,mcv1,90,385822,347240,38582,amr,hic
can,Canada,2016,dtp1,96,385822,370389,15433,amr,hic
can,Canada,2016,mcv2,86,387034,332849,54185,amr,hic
che,Switzerland,2000,dtp1,95,75816,72025,3791,eur,hic
che,Switzerland,2000,dtp3,93,75816,70509,5307,eur,hic
che,Switzerland,2000,mcv1,82,75816,62169,13647,eur,hic
che,Switzerland,2001,dtp3,93,74680,69452,5228,eur,hic
che,Switzerland,2001,dtp1,95,74680,70946,3734,eur,hic
che,Switzerland,2001,mcv1,82,74680,61238,13442,eur,hic
che,Switzerland,2002,mcv1,82,73840,60549,13291,eur,hic
che,Switzerland,2002,dtp1,95,73840,70148,3692,eur,hic
che,Switzerland,2002,dtp3,93,73840,68671,5169,eur,hic
che,Switzerland,2003,mcv1,82,73377,60169,13208,eur,hic
che,Switzerland,2003,dtp1,95,73377,69708,3669,eur,hic
che,Switzerland,2003,dtp3,93,73377,68241,5136,eur,hic
che,Switzerland,2004,dtp1,95,73336,69669,3667,eur,hic
che,Switzerland,2004,dtp3,93,73336,68202,5134,eur,hic
che,Switzerland,2004,mcv1,82,73336,60136,13200,eur,hic
che,Switzerland,2005,dtp3,94,73732,69308,4424,eur,hic
che,Switzerland,2005,mcv1,87,73732,64147,9585,eur,hic
che,Switzerland,2005,dtp1,95,73732,70045,3687,eur,hic
che,Switzerland,2005,mcv2,71,72866,51735,21131,eur,hic
che,Switzerland,2006,dtp3,94,74531,70059,4472,eur,hic
che,Switzerland,2006,dtp1,95,74531,70804,3727,eur,hic
che,Switzerland,2006,mcv1,87,74531,64842,9689,eur,hic
che,Switzerland,2006,mcv2,71,72372,51384,20988,eur,hic
che,Switzerland,2007,dtp1,95,75615,71834,3781,eur,hic
che,Switzerland,2007,dtp3,94,75615,71078,4537,eur,hic
che,Switzerland,2007,mcv1,87,75615,65785,9830,eur,hic
che,Switzerland,2007,mcv2,71,72372,51384,20988,eur,hic
che,Switzerland,2008,dtp3,95,76867,73024,3843,eur,hic
che,Switzerland,2008,dtp1,95,76867,73024,3843,eur,hic
che,Switzerland,2008,mcv1,92,76867,70718,6149,eur,hic
che,Switzerland,2008,mcv2,83,73500,61005,12495,eur,hic
che,Switzerland,2009,dtp3,95,78214,74303,3911,eur,hic
che,Switzerland,2009,mcv1,92,78214,71957,6257,eur,hic
che,Switzerland,2009,dtp1,95,78214,74303,3911,eur,hic
che,Switzerland,2009,mcv2,83,74702,62003,12699,eur,hic
che,Switzerland,2010,dtp3,95,79600,75620,3980,eur,hic
che,Switzerland,2010,mcv1,92,79600,73232,6368,eur,hic
che,Switzerland,2010,dtp1,95,79600,75620,3980,eur,hic
che,Switzerland,2010,mcv2,83,76178,63228,12950,eur,hic
che,Switzerland,2011,mcv1,93,80987,75318,5669,eur,hic
che,Switzerland,2011,dtp3,96,80987,77748,3239,eur,hic
che,Switzerland,2011,dtp1,98,80987,79367,1620,eur,hic
che,Switzerland,2011,mcv2,86,78772,67744,11028,eur,hic
che,Switzerland,2012,dtp3,96,82359,79065,3294,eur,hic
che,Switzerland,2012,dtp1,98,82359,80712,1647,eur,hic
che,Switzerland,2012,mcv1,93,82359,76594,5765,eur,hic
che,Switzerland,2012,mcv2,86,81469,70063,11406,eur,hic
che,Switzerland,2013,dtp1,98,83685,82011,1674,eur,hic
che,Switzerland,2013,mcv1,93,83685,77827,5858,eur,hic
che,Switzerland,2013,dtp3,96,83685,80338,3347,eur,hic
che,Switzerland,2013,mcv2,86,81941,70469,11472,eur,hic
che,Switzerland,2014,dtp3,96,84919,81522,3397,eur,hic
che,Switzerland,2014,dtp1,98,84919,83221,1698,eur,hic
che,Switzerland,2014,mcv1,93,84919,78975,5944,eur,hic
che,Switzerland,2014,mcv2,87,83890,72984,10906,eur,hic
che,Switzerland,2015,dtp3,97,86014,83434,2580,eur,hic
che,Switzerland,2015,mcv1,94,86014,80853,5161,eur,hic
che,Switzerland,2015,dtp1,99,86014,85154,860,eur,hic
che,Switzerland,2015,mcv2,89,85579,76165,9414,eur,hic
che,Switzerland,2016,dtp1,99,86942,86073,869,eur,hic
che,Switzerland,2016,dtp3,97,86942,84334,2608,eur,hic
che,Switzerland,2016,mcv1,94,86942,81725,5217,eur,hic
che,Switzerland,2016,mcv2,89,86827,77276,9551,eur,hic
chl,Chile,2000,dtp1,98,256403,251275,5128,amr,hic
chl,Chile,2000,dtp3,91,256403,233327,23076,amr,hic
chl,Chile,2000,mcv1,97,256403,248711,7692,amr,hic
chl,Chile,2001,mcv1,96,254053,243891,10162,amr,hic
chl,Chile,2001,dtp1,99,254053,251512,2541,amr,hic
chl,Chile,2001,dtp3,97,254053,246431,7622,amr,hic
chl,Chile,2002,dtp3,97,252210,244644,7566,amr,hic
chl,Chile,2002,dtp1,98,252210,247166,5044,amr,hic
chl,Chile,2002,mcv1,95,252210,239600,12610,amr,hic
chl,Chile,2003,dtp1,98,250836,245819,5017,amr,hic
chl,Chile,2003,dtp3,96,250836,240803,10033,amr,hic
chl,Chile,2003,mcv1,96,250836,240803,10033,amr,hic
chl,Chile,2004,dtp1,94,249871,234879,14992,amr,hic
chl,Chile,2004,mcv1,94,249871,234879,14992,amr,hic
chl,Chile,2004,dtp3,93,249871,232380,17491,amr,hic
chl,Chile,2004,mcv2,96,263534,252993,10541,amr,hic
chl,Chile,2005,mcv1,90,249164,224248,24916,amr,hic
chl,Chile,2005,dtp3,91,249164,226739,22425,amr,hic
chl,Chile,2005,dtp1,92,249164,229231,19933,amr,hic
chl,Chile,2005,mcv2,96,260186,249779,10407,amr,hic
chl,Chile,2006,mcv1,91,248514,226148,22366,amr,hic
chl,Chile,2006,dtp1,95,248514,236088,12426,amr,hic
chl,Chile,2006,dtp3,94,248514,233603,14911,amr,hic
chl,Chile,2006,mcv2,95,257295,244430,12865,amr,hic
chl,Chile,2007,dtp3,96,247734,237825,9909,amr,hic
chl,Chile,2007,mcv1,92,247734,227915,19819,amr,hic
chl,Chile,2007,dtp1,98,247734,242779,4955,amr,hic
chl,Chile,2007,mcv2,95,254693,241958,12735,amr,hic
chl,Chile,2008,dtp3,95,246701,234366,12335,amr,hic
chl,Chile,2008,mcv1,96,246701,236833,9868,amr,hic
chl,Chile,2008,dtp1,96,246701,236833,9868,amr,hic
chl,Chile,2008,mcv2,89,252393,224630,27763,amr,hic
chl,Chile,2009,dtp1,94,245380,230657,14723,amr,hic
chl,Chile,2009,dtp3,94,245380,230657,14723,amr,hic
chl,Chile,2009,mcv1,93,245380,228203,17177,amr,hic
chl,Chile,2009,mcv2,89,250428,222881,27547,amr,hic
chl,Chile,2010,mcv1,93,243822,226754,17068,amr,hic
chl,Chile,2010,dtp1,93,243822,226754,17068,amr,hic
chl,Chile,2010,dtp3,92,243822,224316,19506,amr,hic
chl,Chile,2010,mcv2,84,248778,208974,39804,amr,hic
chl,Chile,2011,mcv1,91,242155,220361,21794,amr,hic
chl,Chile,2011,dtp3,94,242155,227626,14529,amr,hic
chl,Chile,2011,dtp1,98,242155,237312,4843,amr,hic
chl,Chile,2011,mcv2,77,248037,190988,57049,amr,hic
chl,Chile,2012,mcv1,90,240556,216500,24056,amr,hic
chl,Chile,2012,dtp3,90,240556,216500,24056,amr,hic
chl,Chile,2012,dtp1,90,240556,216500,24056,amr,hic
chl,Chile,2012,mcv2,74,248116,183606,64510,amr,hic
chl,Chile,2013,mcv1,90,239157,215241,23916,amr,hic
chl,Chile,2013,dtp1,92,239157,220024,19133,amr,hic
chl,Chile,2013,dtp3,91,239157,217633,21524,amr,hic
chl,Chile,2013,mcv2,78,248548,193867,54681,amr,hic
chl,Chile,2014,mcv1,97,237991,230851,7140,amr,hic
chl,Chile,2014,dtp3,95,237991,226091,11900,amr,hic
chl,Chile,2014,dtp1,99,237991,235611,2380,amr,hic
chl,Chile,2014,mcv2,88,248852,218990,29862,amr,hic
chl,Chile,2015,mcv1,96,237055,227573,9482,amr,hic
chl,Chile,2015,dtp3,96,237055,227573,9482,amr,hic
chl,Chile,2015,dtp1,97,237055,229943,7112,amr,hic
chl,Chile,2015,mcv2,89,248383,221061,27322,amr,hic
chl,Chile,2016,mcv1,93,236302,219761,16541,amr,hic
chl,Chile,2016,dtp1,99,236302,233939,2363,amr,hic
chl,Chile,2016,dtp3,95,236302,224487,11815,amr,hic
chl,Chile,2016,mcv2,87,247264,215120,32144,amr,hic
chn,China,2000,mcv1,84,15772301,13248733,2523568,wpr,mic_nongavi
chn,China,2000,dtp1,94,15772301,14825963,946338,wpr,mic_nongavi
chn,China,2000,dtp3,85,15772301,13406456,2365845,wpr,mic_nongavi
chn,China,2001,dtp3,86,15721432,13520432,2201000,wpr,mic_nongavi
chn,China,2001,dtp1,95,15721432,14935360,786072,wpr,mic_nongavi
chn,China,2001,mcv1,85,15721432,13363217,2358215,wpr,mic_nongavi
chn,China,2002,dtp3,86,15760777,13554268,2206509,wpr,mic_nongavi
chn,China,2002,mcv1,85,15760777,13396660,2364117,wpr,mic_nongavi
chn,China,2002,dtp1,95,15760777,14972738,788039,wpr,mic_nongavi
chn,China,2003,dtp3,86,15856944,13636972,2219972,wpr,mic_nongavi
chn,China,2003,dtp1,95,15856944,15064097,792847,wpr,mic_nongavi
chn,China,2003,mcv1,85,15856944,13478402,2378542,wpr,mic_nongavi
chn,China,2004,mcv1,86,15986061,13748012,2238049,wpr,mic_nongavi
chn,China,2004,dtp1,95,15986061,15186758,799303,wpr,mic_nongavi
chn,China,2004,dtp3,87,15986061,13907873,2078188,wpr,mic_nongavi
chn,China,2005,dtp3,87,16134216,14036768,2097448,wpr,mic_nongavi
chn,China,2005,dtp1,95,16134216,15327505,806711,wpr,mic_nongavi
chn,China,2005,mcv1,86,16134216,13875426,2258790,wpr,mic_nongavi
chn,China,2005,mcv2,84,15615382,13116921,2498461,wpr,mic_nongavi
chn,China,2006,dtp3,93,16297774,15156930,1140844,wpr,mic_nongavi
chn,China,2006,dtp1,99,16297774,16134796,162978,wpr,mic_nongavi
chn,China,2006,mcv1,93,16297774,15156930,1140844,wpr,mic_nongavi
chn,China,2006,mcv2,94,16105565,15139231,966334,wpr,mic_nongavi
chn,China,2007,mcv1,94,16477652,15488993,988659,wpr,mic_nongavi
chn,China,2007,dtp3,93,16477652,15324216,1153436,wpr,mic_nongavi
chn,China,2007,dtp1,99,16477652,16312875,164777,wpr,mic_nongavi
chn,China,2007,mcv2,92,16610605,15281757,1328848,wpr,mic_nongavi
chn,China,2008,mcv1,97,16667028,16167017,500011,wpr,mic_nongavi
chn,China,2008,dtp3,97,16667028,16167017,500011,wpr,mic_nongavi
chn,China,2008,dtp1,99,16667028,16500358,166670,wpr,mic_nongavi
chn,China,2008,mcv2,95,16181611,15372530,809081,wpr,mic_nongavi
chn,China,2009,dtp3,99,16848359,16679875,168484,wpr,mic_nongavi
chn,China,2009,mcv1,99,16848359,16679875,168484,wpr,mic_nongavi
chn,China,2009,dtp1,99,16848359,16679875,168484,wpr,mic_nongavi
chn,China,2009,mcv2,98,16375153,16047650,327503,wpr,mic_nongavi
chn,China,2010,mcv1,99,16999705,16829708,169997,wpr,mic_nongavi
chn,China,2010,dtp1,99,16999705,16829708,169997,wpr,mic_nongavi
chn,China,2010,dtp3,99,16999705,16829708,169997,wpr,mic_nongavi
chn,China,2010,mcv2,99,16572557,16406831,165726,wpr,mic_nongavi
chn,China,2011,mcv1,99,17100616,16929610,171006,wpr,mic_nongavi
chn,China,2011,dtp3,99,17100616,16929610,171006,wpr,mic_nongavi
chn,China,2011,dtp1,99,17100616,16929610,171006,wpr,mic_nongavi
chn,China,2011,mcv2,99,16660374,16493770,166604,wpr,mic_nongavi
chn,China,2012,mcv1,99,17141018,16969608,171410,wpr,mic_nongavi
chn,China,2012,dtp3,99,17141018,16969608,171410,wpr,mic_nongavi
chn,China,2012,dtp1,99,17141018,16969608,171410,wpr,mic_nongavi
chn,China,2012,mcv2,99,16736080,16568719,167361,wpr,mic_nongavi
chn,China,2013,mcv1,99,17115112,16943961,171151,wpr,mic_nongavi
chn,China,2013,dtp1,99,17115112,16943961,171151,wpr,mic_nongavi
chn,China,2013,dtp3,99,17115112,16943961,171151,wpr,mic_nongavi
chn,China,2013,mcv2,99,17118721,16947534,171187,wpr,mic_nongavi
chn,China,2014,mcv1,99,17019761,16849563,170198,wpr,mic_nongavi
chn,China,2014,dtp3,99,17019761,16849563,170198,wpr,mic_nongavi
chn,China,2014,dtp1,99,17019761,16849563,170198,wpr,mic_nongavi
chn,China,2014,mcv2,99,17206787,17034719,172068,wpr,mic_nongavi
chn,China,2015,dtp1,99,16855347,16686794,168553,wpr,mic_nongavi
chn,China,2015,mcv1,99,16855347,16686794,168553,wpr,mic_nongavi
chn,China,2015,dtp3,99,16855347,16686794,168553,wpr,mic_nongavi
chn,China,2015,mcv2,99,17221755,17049537,172218,wpr,mic_nongavi
chn,China,2016,dtp3,99,16628087,16461806,166281,wpr,mic_nongavi
chn,China,2016,dtp1,99,16628087,16461806,166281,wpr,mic_nongavi
chn,China,2016,mcv1,99,16628087,16461806,166281,wpr,mic_nongavi
chn,China,2016,mcv2,99,17261558,17088942,172616,wpr,mic_nongavi
civ,Côte d’Ivoire,2000,dtp1,85,613092,521128,91964,afr,gavi
civ,Côte d’Ivoire,2000,mcv1,68,613092,416903,196189,afr,gavi
civ,Côte d’Ivoire,2000,dtp3,65,613092,398510,214582,afr,gavi
civ,Côte d’Ivoire,2001,dtp3,66,623172,411294,211878,afr,gavi
civ,Côte d’Ivoire,2001,mcv1,71,623172,442452,180720,afr,gavi
civ,Côte d’Ivoire,2001,dtp1,81,623172,504769,118403,afr,gavi
civ,Côte d’Ivoire,2002,dtp1,76,632581,480762,151819,afr,gavi
civ,Côte d’Ivoire,2002,mcv1,71,632581,449133,183448,afr,gavi
civ,Côte d’Ivoire,2002,dtp3,64,632581,404852,227729,afr,gavi
civ,Côte d’Ivoire,2003,mcv1,70,641673,449171,192502,afr,gavi
civ,Côte d’Ivoire,2003,dtp1,71,641673,455588,186085,afr,gavi
civ,Côte d’Ivoire,2003,dtp3,61,641673,391421,250252,afr,gavi
civ,Côte d’Ivoire,2004,dtp3,67,650750,436002,214748,afr,gavi
civ,Côte d’Ivoire,2004,dtp1,73,650750,475048,175702,afr,gavi
civ,Côte d’Ivoire,2004,mcv1,78,650750,507585,143165,afr,gavi
civ,Côte d’Ivoire,2005,dtp3,76,660193,501747,158446,afr,gavi
civ,Côte d’Ivoire,2005,dtp1,83,660193,547960,112233,afr,gavi
civ,Côte d’Ivoire,2005,mcv1,84,660193,554562,105631,afr,gavi
civ,Côte d’Ivoire,2006,dtp1,95,670359,636841,33518,afr,gavi
civ,Côte d’Ivoire,2006,dtp3,77,670359,516176,154183,afr,gavi
civ,Côte d’Ivoire,2006,mcv1,73,670359,489362,180997,afr,gavi
civ,Côte d’Ivoire,2007,mcv1,67,681446,456569,224877,afr,gavi
civ,Côte d’Ivoire,2007,dtp1,93,681446,633745,47701,afr,gavi
civ,Côte d’Ivoire,2007,dtp3,76,681446,517899,163547,afr,gavi
civ,Côte d’Ivoire,2008,dtp1,89,693584,617290,76294,afr,gavi
civ,Côte d’Ivoire,2008,dtp3,74,693584,513252,180332,afr,gavi
civ,Côte d’Ivoire,2008,mcv1,63,693584,436958,256626,afr,gavi
civ,Côte d’Ivoire,2009,dtp1,95,706851,671508,35343,afr,gavi
civ,Côte d’Ivoire,2009,dtp3,81,706851,572549,134302,afr,gavi
civ,Côte d’Ivoire,2009,mcv1,67,706851,473590,233261,afr,gavi
civ,Côte d’Ivoire,2010,mcv1,70,721259,504881,216378,afr,gavi
civ,Côte d’Ivoire,2010,dtp1,95,721259,685196,36063,afr,gavi
civ,Côte d’Ivoire,2010,dtp3,85,721259,613070,108189,afr,gavi
civ,Côte d’Ivoire,2011,dtp1,75,736708,552531,184177,afr,gavi
civ,Côte d’Ivoire,2011,mcv1,49,736708,360987,375721,afr,gavi
civ,Côte d’Ivoire,2011,dtp3,62,736708,456759,279949,afr,gavi
civ,Côte d’Ivoire,2012,dtp1,93,752901,700198,52703,afr,gavi
civ,Côte d’Ivoire,2012,dtp3,82,752901,617379,135522,afr,gavi
civ,Côte d’Ivoire,2012,mcv1,74,752901,557147,195754,afr,gavi
civ,Côte d’Ivoire,2013,dtp3,80,769536,615629,153907,afr,gavi
civ,Côte d’Ivoire,2013,dtp1,89,769536,684887,84649,afr,gavi
civ,Côte d’Ivoire,2013,mcv1,76,769536,584847,184689,afr,gavi
civ,Côte d’Ivoire,2014,dtp3,76,786411,597672,188739,afr,gavi
civ,Côte d’Ivoire,2014,dtp1,93,786411,731362,55049,afr,gavi
civ,Côte d’Ivoire,2014,mcv1,62,786411,487575,298836,afr,gavi
civ,Côte d’Ivoire,2015,dtp1,99,803335,795302,8033,afr,gavi
civ,Côte d’Ivoire,2015,dtp3,83,803335,666768,136567,afr,gavi
civ,Côte d’Ivoire,2015,mcv1,72,803335,578401,224934,afr,gavi
civ,Côte d’Ivoire,2016,dtp1,98,820166,803763,16403,afr,gavi
civ,Côte d’Ivoire,2016,mcv1,77,820166,631528,188638,afr,gavi
civ,Côte d’Ivoire,2016,dtp3,85,820166,697141,123025,afr,gavi
cmr,Cameroon,2000,dtp1,66,571814,377397,194417,afr,gavi
cmr,Cameroon,2000,mcv1,49,571814,280189,291625,afr,gavi
cmr,Cameroon,2000,dtp3,62,571814,354525,217289,afr,gavi
cmr,Cameroon,2001,dtp3,63,586934,369768,217166,afr,gavi
cmr,Cameroon,2001,dtp1,70,586934,410854,176080,afr,gavi
cmr,Cameroon,2001,mcv1,51,586934,299336,287598,afr,gavi
cmr,Cameroon,2002,dtp1,75,602908,452181,150727,afr,gavi
cmr,Cameroon,2002,dtp3,66,602908,397919,204989,afr,gavi
cmr,Cameroon,2002,mcv1,53,602908,319541,283367,afr,gavi
cmr,Cameroon,2003,dtp1,79,619366,489299,130067,afr,gavi
cmr,Cameroon,2003,mcv1,61,619366,377813,241553,afr,gavi
cmr,Cameroon,2003,dtp3,73,619366,452137,167229,afr,gavi
cmr,Cameroon,2004,dtp1,80,636032,508826,127206,afr,gavi
cmr,Cameroon,2004,dtp3,73,636032,464303,171729,afr,gavi
cmr,Cameroon,2004,mcv1,64,636032,407060,228972,afr,gavi
cmr,Cameroon,2005,dtp1,85,652644,554747,97897,afr,gavi
cmr,Cameroon,2005,mcv1,68,652644,443798,208846,afr,gavi
cmr,Cameroon,2005,dtp3,80,652644,522115,130529,afr,gavi
cmr,Cameroon,2006,mcv1,73,668996,488367,180629,afr,gavi
cmr,Cameroon,2006,dtp1,87,668996,582027,86969,afr,gavi
cmr,Cameroon,2006,dtp3,81,668996,541887,127109,afr,gavi
cmr,Cameroon,2007,dtp1,90,684981,616483,68498,afr,gavi
cmr,Cameroon,2007,mcv1,74,684981,506886,178095,afr,gavi
cmr,Cameroon,2007,dtp3,82,684981,561684,123297,afr,gavi
cmr,Cameroon,2008,dtp3,84,700483,588406,112077,afr,gavi
cmr,Cameroon,2008,dtp1,93,700483,651449,49034,afr,gavi
cmr,Cameroon,2008,mcv1,80,700483,560386,140097,afr,gavi
cmr,Cameroon,2009,dtp1,88,715354,629512,85842,afr,gavi
cmr,Cameroon,2009,dtp3,80,715354,572283,143071,afr,gavi
cmr,Cameroon,2009,mcv1,74,715354,529362,185992,afr,gavi
cmr,Cameroon,2010,dtp1,92,729456,671100,58356,afr,gavi
cmr,Cameroon,2010,mcv1,79,729456,576270,153186,afr,gavi
cmr,Cameroon,2010,dtp3,84,729456,612743,116713,afr,gavi
cmr,Cameroon,2011,dtp1,90,742715,668444,74271,afr,gavi
cmr,Cameroon,2011,mcv1,76,742715,564463,178252,afr,gavi
cmr,Cameroon,2011,dtp3,82,742715,609026,133689,afr,gavi
cmr,Cameroon,2012,dtp1,94,755220,709907,45313,afr,gavi
cmr,Cameroon,2012,mcv1,82,755220,619280,135940,afr,gavi
cmr,Cameroon,2012,dtp3,85,755220,641937,113283,afr,gavi
cmr,Cameroon,2013,dtp3,89,767095,682715,84380,afr,gavi
cmr,Cameroon,2013,dtp1,95,767095,728740,38355,afr,gavi
cmr,Cameroon,2013,mcv1,83,767095,636689,130406,afr,gavi
cmr,Cameroon,2014,mcv1,80,778431,622745,155686,afr,gavi
cmr,Cameroon,2014,dtp3,87,778431,677235,101196,afr,gavi
cmr,Cameroon,2014,dtp1,93,778431,723941,54490,afr,gavi
cmr,Cameroon,2015,mcv1,79,789343,623581,165762,afr,gavi
cmr,Cameroon,2015,dtp1,92,789343,726196,63147,afr,gavi
cmr,Cameroon,2015,dtp3,84,789343,663048,126295,afr,gavi
cmr,Cameroon,2016,dtp1,92,799954,735958,63996,afr,gavi
cmr,Cameroon,2016,mcv1,78,799954,623964,175990,afr,gavi
cmr,Cameroon,2016,dtp3,85,799954,679961,119993,afr,gavi
cod,Democratic Republic of the Congo,2000,dtp3,40,1945775,778310,1167465,afr,gavi
cod,Democratic Republic of the Congo,2000,dtp1,49,1945775,953430,992345,afr,gavi
cod,Democratic Republic of the Congo,2000,mcv1,46,1945775,895056,1050719,afr,gavi
cod,Democratic Republic of the Congo,2001,dtp3,30,2006083,601825,1404258,afr,gavi
cod,Democratic Republic of the Congo,2001,mcv1,35,2006083,702129,1303954,afr,gavi
cod,Democratic Republic of the Congo,2001,dtp1,49,2006083,982981,1023102,afr,gavi
cod,Democratic Republic of the Congo,2002,dtp1,47,2070066,972931,1097135,afr,gavi
cod,Democratic Republic of the Congo,2002,mcv1,42,2070066,869428,1200638,afr,gavi
cod,Democratic Republic of the Congo,2002,dtp3,38,2070066,786625,1283441,afr,gavi
cod,Democratic Republic of the Congo,2003,dtp3,41,2137632,876429,1261203,afr,gavi
cod,Democratic Republic of the Congo,2003,dtp1,53,2137632,1132945,1004687,afr,gavi
cod,Democratic Republic of the Congo,2003,mcv1,49,2137632,1047440,1090192,afr,gavi
cod,Democratic Republic of the Congo,2004,dtp1,66,2208586,1457667,750919,afr,gavi
cod,Democratic Republic of the Congo,2004,dtp3,54,2208586,1192636,1015950,afr,gavi
cod,Democratic Republic of the Congo,2004,mcv1,57,2208586,1258894,949692,afr,gavi
cod,Democratic Republic of the Congo,2005,dtp1,68,2282694,1552232,730462,afr,gavi
cod,Democratic Republic of the Congo,2005,mcv1,61,2282694,1392443,890251,afr,gavi
cod,Democratic Republic of the Congo,2005,dtp3,60,2282694,1369616,913078,afr,gavi
cod,Democratic Republic of the Congo,2006,dtp3,62,2359591,1462946,896645,afr,gavi
cod,Democratic Republic of the Congo,2006,dtp1,71,2359591,1675310,684281,afr,gavi
cod,Democratic Republic of the Congo,2006,mcv1,63,2359591,1486542,873049,afr,gavi
cod,Democratic Republic of the Congo,2007,dtp1,78,2438430,1901975,536455,afr,gavi
cod,Democratic Republic of the Congo,2007,dtp3,70,2438430,1706901,731529,afr,gavi
cod,Democratic Republic of the Congo,2007,mcv1,68,2438430,1658132,780298,afr,gavi
cod,Democratic Republic of the Congo,2008,dtp3,65,2518233,1636851,881382,afr,gavi
cod,Democratic Republic of the Congo,2008,dtp1,73,2518233,1838310,679923,afr,gavi
cod,Democratic Republic of the Congo,2008,mcv1,64,2518233,1611669,906564,afr,gavi
cod,Democratic Republic of the Congo,2009,dtp3,72,2598136,1870658,727478,afr,gavi
cod,Democratic Republic of the Congo,2009,dtp1,82,2598136,2130472,467664,afr,gavi
cod,Democratic Republic of the Congo,2009,mcv1,72,2598136,1870658,727478,afr,gavi
cod,Democratic Republic of the Congo,2010,dtp1,71,2677164,1900786,776378,afr,gavi
cod,Democratic Republic of the Congo,2010,mcv1,74,2677164,1981101,696063,afr,gavi
cod,Democratic Republic of the Congo,2010,dtp3,60,2677164,1606298,1070866,afr,gavi
cod,Democratic Republic of the Congo,2011,dtp3,74,2754497,2038328,716169,afr,gavi
cod,Democratic Republic of the Congo,2011,mcv1,74,2754497,2038328,716169,afr,gavi
cod,Democratic Republic of the Congo,2011,dtp1,85,2754497,2341322,413175,afr,gavi
cod,Democratic Republic of the Congo,2012,mcv1,72,2829867,2037504,792363,afr,gavi
cod,Democratic Republic of the Congo,2012,dtp3,75,2829867,2122400,707467,afr,gavi
cod,Democratic Republic of the Congo,2012,dtp1,81,2829867,2292192,537675,afr,gavi
cod,Democratic Republic of the Congo,2013,mcv1,76,2903160,2206402,696758,afr,gavi
cod,Democratic Republic of the Congo,2013,dtp3,74,2903160,2148338,754822,afr,gavi
cod,Democratic Republic of the Congo,2013,dtp1,79,2903160,2293496,609664,afr,gavi
cod,Democratic Republic of the Congo,2014,mcv1,77,2974279,2290195,684084,afr,gavi
cod,Democratic Republic of the Congo,2014,dtp3,80,2974279,2379423,594856,afr,gavi
cod,Democratic Republic of the Congo,2014,dtp1,81,2974279,2409166,565113,afr,gavi
cod,Democratic Republic of the Congo,2015,dtp3,81,3043347,2465111,578236,afr,gavi
cod,Democratic Republic of the Congo,2015,mcv1,79,3043347,2404244,639103,afr,gavi
cod,Democratic Republic of the Congo,2015,dtp1,82,3043347,2495545,547802,afr,gavi
cod,Democratic Republic of the Congo,2016,dtp1,80,3110732,2488586,622146,afr,gavi
cod,Democratic Republic of the Congo,2016,mcv1,77,3110732,2395264,715468,afr,gavi
cod,Democratic Republic of the Congo,2016,dtp3,79,3110732,2457478,653254,afr,gavi
cog,Congo,2000,dtp1,45,116065,52229,63836,afr,gavi
cog,Congo,2000,dtp3,33,116065,38301,77764,afr,gavi
cog,Congo,2000,mcv1,34,116065,39462,76603,afr,gavi
cog,Congo,2001,dtp1,44,119844,52731,67113,afr,gavi
cog,Congo,2001,dtp3,31,119844,37152,82692,afr,gavi
cog,Congo,2001,mcv1,35,119844,41945,77899,afr,gavi
cog,Congo,2002,dtp1,50,123833,61916,61917,afr,gavi
cog,Congo,2002,dtp3,41,123833,50772,73061,afr,gavi
cog,Congo,2002,mcv1,37,123833,45818,78015,afr,gavi
cog,Congo,2003,dtp3,50,128021,64010,64011,afr,gavi
cog,Congo,2003,dtp1,62,128021,79373,48648,afr,gavi
cog,Congo,2003,mcv1,50,128021,64010,64011,afr,gavi
cog,Congo,2004,dtp1,67,132359,88681,43678,afr,gavi
cog,Congo,2004,dtp3,67,132359,88681,43678,afr,gavi
cog,Congo,2004,mcv1,65,132359,86033,46326,afr,gavi
cog,Congo,2005,dtp1,73,136788,99855,36933,afr,gavi
cog,Congo,2005,dtp3,62,136788,84809,51979,afr,gavi
cog,Congo,2005,mcv1,54,136788,73866,62922,afr,gavi
cog,Congo,2006,dtp3,73,141230,103098,38132,afr,gavi
cog,Congo,2006,dtp1,81,141230,114396,26834,afr,gavi
cog,Congo,2006,mcv1,61,141230,86150,55080,afr,gavi
cog,Congo,2007,dtp3,72,145593,104827,40766,afr,gavi
cog,Congo,2007,dtp1,80,145593,116474,29119,afr,gavi
cog,Congo,2007,mcv1,59,145593,85900,59693,afr,gavi
cog,Congo,2008,dtp1,93,149777,139293,10484,afr,gavi
cog,Congo,2008,dtp3,79,149777,118324,31453,afr,gavi
cog,Congo,2008,mcv1,69,149777,103346,46431,afr,gavi
cog,Congo,2009,dtp1,92,153702,141406,12296,afr,gavi
cog,Congo,2009,dtp3,78,153702,119888,33814,afr,gavi
cog,Congo,2009,mcv1,63,153702,96832,56870,afr,gavi
cog,Congo,2010,mcv1,75,157259,117944,39315,afr,gavi
cog,Congo,2010,dtp1,90,157259,141533,15726,afr,gavi
cog,Congo,2010,dtp3,74,157259,116372,40887,afr,gavi
cog,Congo,2011,dtp3,82,160356,131492,28864,afr,gavi
cog,Congo,2011,mcv1,83,160356,133095,27261,afr,gavi
cog,Congo,2011,dtp1,90,160356,144320,16036,afr,gavi
cog,Congo,2012,mcv1,80,163008,130406,32602,afr,gavi
cog,Congo,2012,dtp3,85,163008,138557,24451,afr,gavi
cog,Congo,2012,dtp1,90,163008,146707,16301,afr,gavi
cog,Congo,2013,dtp3,85,165277,140485,24792,afr,gavi
cog,Congo,2013,dtp1,90,165277,148749,16528,afr,gavi
cog,Congo,2013,mcv1,80,165277,132222,33055,afr,gavi
cog,Congo,2014,dtp1,95,167238,158876,8362,afr,gavi
cog,Congo,2014,mcv1,80,167238,133790,33448,afr,gavi
cog,Congo,2014,dtp3,90,167238,150514,16724,afr,gavi
cog,Congo,2015,dtp3,80,169005,135204,33801,afr,gavi
cog,Congo,2015,dtp1,85,169005,143654,25351,afr,gavi
cog,Congo,2015,mcv1,80,169005,135204,33801,afr,gavi
cog,Congo,2016,dtp1,85,170713,145106,25607,afr,gavi
cog,Congo,2016,mcv1,80,170713,136570,34143,afr,gavi
cog,Congo,2016,dtp3,80,170713,136570,34143,afr,gavi
cok,Cook Islands,2000,dtp1,99,461.6373157575,457,4.6373157575,wpr,NA
cok,Cook Islands,2000,mcv1,76,461.6373157575,351,110.6373157575,wpr,NA
cok,Cook Islands,2000,dtp3,92,461.6373157575,425,36.6373157575,wpr,NA
cok,Cook Islands,2000,mcv2,70,461.6373157575,323,138.6373157575,wpr,NA
cok,Cook Islands,2001,dtp1,97,459.1694527981,445,14.1694527981,wpr,NA
cok,Cook Islands,2001,mcv1,83,459.1694527981,381,78.1694527981,wpr,NA
cok,Cook Islands,2001,dtp3,90,459.1694527981,413,46.1694527981,wpr,NA
cok,Cook Islands,2001,mcv2,50,459.1694527981,230,229.1694527981,wpr,NA
cok,Cook Islands,2002,dtp1,99,461.5529825922,457,4.5529825922,wpr,NA
cok,Cook Islands,2002,dtp3,97,461.5529825922,448,13.5529825922,wpr,NA
cok,Cook Islands,2002,mcv1,95,461.5529825922,438,23.5529825922,wpr,NA
cok,Cook Islands,2002,mcv2,61,461.5529825922,282,179.5529825922,wpr,NA
cok,Cook Islands,2003,mcv1,99,465.8556654212,461,4.8556654212,wpr,NA
cok,Cook Islands,2003,dtp1,96,465.8556654212,447,18.8556654212,wpr,NA
cok,Cook Islands,2003,dtp3,96,465.8556654212,447,18.8556654212,wpr,NA
cok,Cook Islands,2003,mcv2,88,465.8556654212,410,55.8556654212,wpr,NA
cok,Cook Islands,2004,dtp1,99,468.5485662375,464,4.5485662375,wpr,NA
cok,Cook Islands,2004,dtp3,99,468.5485662375,464,4.5485662375,wpr,NA
cok,Cook Islands,2004,mcv1,99,468.5485662375,464,4.5485662375,wpr,NA
cok,Cook Islands,2004,mcv2,86,468.5485662375,403,65.5485662375,wpr,NA
cok,Cook Islands,2005,dtp3,99,467.1957879385,463,4.1957879385,wpr,NA
cok,Cook Islands,2005,mcv1,99,467.1957879385,463,4.1957879385,wpr,NA
cok,Cook Islands,2005,dtp1,99,467.1957879385,463,4.1957879385,wpr,NA
cok,Cook Islands,2005,mcv2,97,467.1957879385,453,14.1957879385,wpr,NA
cok,Cook Islands,2006,dtp1,99,460.9448036457,456,4.9448036457,wpr,NA
cok,Cook Islands,2006,dtp3,99,460.9448036457,456,4.9448036457,wpr,NA
cok,Cook Islands,2006,mcv1,99,460.9448036457,456,4.9448036457,wpr,NA
cok,Cook Islands,2006,mcv2,99,460.9448036457,456,4.9448036457,wpr,NA
cok,Cook Islands,2007,dtp3,99,450.808718414,446,4.808718414,wpr,NA
cok,Cook Islands,2007,dtp1,99,450.808718414,446,4.808718414,wpr,NA
cok,Cook Islands,2007,mcv1,98,450.808718414,442,8.808718414,wpr,NA
cok,Cook Islands,2007,mcv2,98,450.808718414,442,8.808718414,wpr,NA
cok,Cook Islands,2008,dtp3,99,437.8601310549,433,4.8601310549,wpr,NA
cok,Cook Islands,2008,mcv1,95,437.8601310549,416,21.8601310549,wpr,NA
cok,Cook Islands,2008,dtp1,99,437.8601310549,433,4.8601310549,wpr,NA
cok,Cook Islands,2008,mcv2,95,437.8601310549,416,21.8601310549,wpr,NA
cok,Cook Islands,2009,dtp1,99,423.7260136455,419,4.7260136455,wpr,NA
cok,Cook Islands,2009,dtp3,82,423.7260136455,347,76.7260136455,wpr,NA
cok,Cook Islands,2009,mcv1,78,423.7260136455,331,92.7260136455,wpr,NA
cok,Cook Islands,2009,mcv2,61,423.7260136455,258,165.7260136455,wpr,NA
cok,Cook Islands,2010,dtp3,99,409.8546036185,406,3.8546036185,wpr,NA
cok,Cook Islands,2010,mcv1,99,409.8546036185,406,3.8546036185,wpr,NA
cok,Cook Islands,2010,dtp1,99,409.8546036185,406,3.8546036185,wpr,NA
cok,Cook Islands,2010,mcv2,98,409.8546036185,402,7.8546036185,wpr,NA
cok,Cook Islands,2011,mcv1,89,396.8730924754,353,43.8730924754,wpr,NA
cok,Cook Islands,2011,dtp3,93,396.8730924754,369,27.8730924754,wpr,NA
cok,Cook Islands,2011,dtp1,98,396.8730924754,389,7.8730924754,wpr,NA
cok,Cook Islands,2011,mcv2,96,396.8730924754,381,15.8730924754,wpr,NA
cok,Cook Islands,2012,mcv1,97,384.6641430446,373,11.6641430446,wpr,NA
cok,Cook Islands,2012,dtp3,98,384.6641430446,377,7.6641430446,wpr,NA
cok,Cook Islands,2012,dtp1,98,384.6641430446,377,7.6641430446,wpr,NA
cok,Cook Islands,2012,mcv2,98,384.6641430446,377,7.6641430446,wpr,NA
cok,Cook Islands,2013,mcv1,97,373.5949956882,362,11.5949956882,wpr,NA
cok,Cook Islands,2013,dtp1,98,373.5949956882,366,7.5949956882,wpr,NA
cok,Cook Islands,2013,dtp3,98,373.5949956882,366,7.5949956882,wpr,NA
cok,Cook Islands,2013,mcv2,95,373.5949956882,355,18.5949956882,wpr,NA
cok,Cook Islands,2014,mcv1,98,363.9926025254,357,6.9926025254,wpr,NA
cok,Cook Islands,2014,dtp1,99,363.9926025254,360,3.9926025254,wpr,NA
cok,Cook Islands,2014,dtp3,99,363.9926025254,360,3.9926025254,wpr,NA
cok,Cook Islands,2014,mcv2,98,363.9926025254,357,6.9926025254,wpr,NA
cok,Cook Islands,2015,mcv1,99,355.7296654447,352,3.7296654447,wpr,NA
cok,Cook Islands,2015,dtp1,99,355.7296654447,352,3.7296654447,wpr,NA
cok,Cook Islands,2015,dtp3,99,355.7296654447,352,3.7296654447,wpr,NA
cok,Cook Islands,2015,mcv2,95,355.7296654447,338,17.7296654447,wpr,NA
cok,Cook Islands,2016,dtp1,99,349.3187761505,346,3.3187761505,wpr,NA
cok,Cook Islands,2016,dtp3,99,349.3187761505,346,3.3187761505,wpr,NA
cok,Cook Islands,2016,mcv1,90,349.3187761505,314,35.3187761505,wpr,NA
cok,Cook Islands,2016,mcv2,90,NA,NA,#VALUE!,wpr,NA
col,Colombia,2000,dtp1,91,829200,754572,74628,amr,mic_nongavi
col,Colombia,2000,dtp3,79,829200,655068,174132,amr,mic_nongavi
col,Colombia,2000,mcv1,88,829200,729696,99504,amr,mic_nongavi
col,Colombia,2000,mcv2,84,858085,720791,137294,amr,mic_nongavi
col,Colombia,2001,dtp3,80,826962,661570,165392,amr,mic_nongavi
col,Colombia,2001,mcv1,93,826962,769075,57887,amr,mic_nongavi
col,Colombia,2001,dtp1,82,826962,678109,148853,amr,mic_nongavi
col,Colombia,2001,mcv2,83,849782,705319,144463,amr,mic_nongavi
col,Colombia,2002,dtp3,81,824307,667689,156618,amr,mic_nongavi
col,Colombia,2002,dtp1,93,824307,766606,57701,amr,mic_nongavi
col,Colombia,2002,mcv1,93,824307,766606,57701,amr,mic_nongavi
col,Colombia,2002,mcv2,93,838761,780048,58713,amr,mic_nongavi
col,Colombia,2003,dtp1,94,820594,771358,49236,amr,mic_nongavi
col,Colombia,2003,mcv1,93,820594,763152,57442,amr,mic_nongavi
col,Colombia,2003,dtp3,92,820594,754946,65648,amr,mic_nongavi
col,Colombia,2003,mcv2,70,826968,578878,248090,amr,mic_nongavi
col,Colombia,2004,dtp3,89,815607,725890,89717,amr,mic_nongavi
col,Colombia,2004,dtp1,90,815607,734046,81561,amr,mic_nongavi
col,Colombia,2004,mcv1,94,815607,766671,48936,amr,mic_nongavi
col,Colombia,2004,mcv2,70,817154,572008,245146,amr,mic_nongavi
col,Colombia,2005,dtp1,97,809310,785031,24279,amr,mic_nongavi
col,Colombia,2005,dtp3,93,809310,752658,56652,amr,mic_nongavi
col,Colombia,2005,mcv1,96,809310,776938,32372,amr,mic_nongavi
col,Colombia,2005,mcv2,73,812454,593091,219363,amr,mic_nongavi
col,Colombia,2006,dtp3,93,801890,745758,56132,amr,mic_nongavi
col,Colombia,2006,dtp1,97,801890,777833,24057,amr,mic_nongavi
col,Colombia,2006,mcv1,95,801890,761796,40094,amr,mic_nongavi
col,Colombia,2006,mcv2,85,812080,690268,121812,amr,mic_nongavi
col,Colombia,2007,dtp3,93,793846,738277,55569,amr,mic_nongavi
col,Colombia,2007,dtp1,97,793846,770031,23815,amr,mic_nongavi
col,Colombia,2007,mcv1,93,793846,738277,55569,amr,mic_nongavi
col,Colombia,2007,mcv2,93,814833,757795,57038,amr,mic_nongavi
col,Colombia,2008,dtp1,97,785620,762051,23569,amr,mic_nongavi
col,Colombia,2008,dtp3,92,785620,722770,62850,amr,mic_nongavi
col,Colombia,2008,mcv1,95,785620,746339,39281,amr,mic_nongavi
col,Colombia,2008,mcv2,70,818328,572830,245498,amr,mic_nongavi
col,Colombia,2009,dtp1,97,777425,754102,23323,amr,mic_nongavi
col,Colombia,2009,dtp3,92,777425,715231,62194,amr,mic_nongavi
col,Colombia,2009,mcv1,89,777425,691908,85517,amr,mic_nongavi
col,Colombia,2009,mcv2,71,819179,581617,237562,amr,mic_nongavi
col,Colombia,2010,dtp1,96,769456,738678,30778,amr,mic_nongavi
col,Colombia,2010,mcv1,88,769456,677121,92335,amr,mic_nongavi
col,Colombia,2010,dtp3,88,769456,677121,92335,amr,mic_nongavi
col,Colombia,2010,mcv2,74,813380,601901,211479,amr,mic_nongavi
col,Colombia,2011,mcv1,88,761830,670410,91420,amr,mic_nongavi
col,Colombia,2011,dtp3,85,761830,647555,114275,amr,mic_nongavi
col,Colombia,2011,dtp1,95,761830,723738,38092,amr,mic_nongavi
col,Colombia,2011,mcv2,76,806171,612690,193481,amr,mic_nongavi
col,Colombia,2012,dtp3,91,754502,686597,67905,amr,mic_nongavi
col,Colombia,2012,mcv1,94,754502,709232,45270,amr,mic_nongavi
col,Colombia,2012,dtp1,91,754502,686597,67905,amr,mic_nongavi
col,Colombia,2012,mcv2,80,796196,636957,159239,amr,mic_nongavi
col,Colombia,2013,dtp3,91,747421,680153,67268,amr,mic_nongavi
col,Colombia,2013,dtp1,97,747421,724998,22423,amr,mic_nongavi
col,Colombia,2013,mcv1,92,747421,687627,59794,amr,mic_nongavi
col,Colombia,2013,mcv2,72,784729,565005,219724,amr,mic_nongavi
col,Colombia,2014,mcv1,91,740574,673922,66652,amr,mic_nongavi
col,Colombia,2014,dtp3,90,740574,666517,74057,amr,mic_nongavi
col,Colombia,2014,dtp1,91,740574,673922,66652,amr,mic_nongavi
col,Colombia,2014,mcv2,88,773699,680855,92844,amr,mic_nongavi
col,Colombia,2015,mcv1,94,733891,689858,44033,amr,mic_nongavi
col,Colombia,2015,dtp1,93,733891,682519,51372,amr,mic_nongavi
col,Colombia,2015,dtp3,91,733891,667841,66050,amr,mic_nongavi
col,Colombia,2015,mcv2,86,765457,658293,107164,amr,mic_nongavi
col,Colombia,2016,dtp1,93,727252,676344,50908,amr,mic_nongavi
col,Colombia,2016,mcv1,93,727252,676344,50908,amr,mic_nongavi
col,Colombia,2016,dtp3,91,727252,661799,65453,amr,mic_nongavi
col,Colombia,2016,mcv2,87,758073,659524,98549,amr,mic_nongavi
com,Comoros,2000,dtp3,70,18854,13198,5656,afr,gavi
com,Comoros,2000,mcv1,70,18854,13198,5656,afr,gavi
com,Comoros,2000,dtp1,85,18854,16026,2828,afr,gavi
com,Comoros,2001,dtp3,70,19195,13436,5759,afr,gavi
com,Comoros,2001,dtp1,85,19195,16316,2879,afr,gavi
com,Comoros,2001,mcv1,70,19195,13436,5759,afr,gavi
com,Comoros,2002,dtp3,89,19550,17399,2151,afr,gavi
com,Comoros,2002,dtp1,96,19550,18768,782,afr,gavi
com,Comoros,2002,mcv1,71,19550,13880,5670,afr,gavi
com,Comoros,2003,dtp3,80,19921,15937,3984,afr,gavi
com,Comoros,2003,dtp1,82,19921,16335,3586,afr,gavi
com,Comoros,2003,mcv1,67,19921,13347,6574,afr,gavi
com,Comoros,2004,dtp1,85,20304,17258,3046,afr,gavi
com,Comoros,2004,dtp3,76,20304,15431,4873,afr,gavi
com,Comoros,2004,mcv1,76,20304,15431,4873,afr,gavi
com,Comoros,2005,dtp3,68,20701,14077,6624,afr,gavi
com,Comoros,2005,dtp1,77,20701,15940,4761,afr,gavi
com,Comoros,2005,mcv1,67,20701,13870,6831,afr,gavi
com,Comoros,2006,dtp3,69,21115,14569,6546,afr,gavi
com,Comoros,2006,dtp1,78,21115,16470,4645,afr,gavi
com,Comoros,2006,mcv1,66,21115,13936,7179,afr,gavi
com,Comoros,2007,mcv1,65,21541,14002,7539,afr,gavi
com,Comoros,2007,dtp3,75,21541,16156,5385,afr,gavi
com,Comoros,2007,dtp1,79,21541,17017,4524,afr,gavi
com,Comoros,2008,dtp1,85,21973,18677,3296,afr,gavi
com,Comoros,2008,mcv1,76,21973,16699,5274,afr,gavi
com,Comoros,2008,dtp3,81,21973,17798,4175,afr,gavi
com,Comoros,2009,dtp1,89,22404,19940,2464,afr,gavi
com,Comoros,2009,dtp3,83,22404,18595,3809,afr,gavi
com,Comoros,2009,mcv1,79,22404,17699,4705,afr,gavi
com,Comoros,2010,dtp1,81,22824,18487,4337,afr,gavi
com,Comoros,2010,mcv1,72,22824,16433,6391,afr,gavi
com,Comoros,2010,dtp3,74,22824,16890,5934,afr,gavi
com,Comoros,2011,mcv1,79,23221,18345,4876,afr,gavi
com,Comoros,2011,dtp3,83,23221,19273,3948,afr,gavi
com,Comoros,2011,dtp1,92,23221,21363,1858,afr,gavi
com,Comoros,2012,dtp1,91,23590,21467,2123,afr,gavi
com,Comoros,2012,mcv1,85,23590,20052,3538,afr,gavi
com,Comoros,2012,dtp3,86,23590,20287,3303,afr,gavi
com,Comoros,2013,dtp1,90,23926,21533,2393,afr,gavi
com,Comoros,2013,mcv1,85,23926,20337,3589,afr,gavi
com,Comoros,2013,dtp3,87,23926,20816,3110,afr,gavi
com,Comoros,2014,dtp3,87,24225,21076,3149,afr,gavi
com,Comoros,2014,dtp1,93,24225,22529,1696,afr,gavi
com,Comoros,2014,mcv1,86,24225,20833,3392,afr,gavi
com,Comoros,2015,dtp3,91,24490,22286,2204,afr,gavi
com,Comoros,2015,dtp1,96,24490,23510,980,afr,gavi
com,Comoros,2015,mcv1,90,24490,22041,2449,afr,gavi
com,Comoros,2016,dtp3,91,24727,22502,2225,afr,gavi
com,Comoros,2016,dtp1,96,24727,23738,989,afr,gavi
com,Comoros,2016,mcv1,99,24727,24480,247,afr,gavi
cpv,Cabo Verde,2000,dtp3,90,12297,11067,1230,afr,mic_nongavi
cpv,Cabo Verde,2000,mcv1,86,12297,10575,1722,afr,mic_nongavi
cpv,Cabo Verde,2000,dtp1,94,12297,11559,738,afr,mic_nongavi
cpv,Cabo Verde,2001,dtp1,94,12198,11466,732,afr,mic_nongavi
cpv,Cabo Verde,2001,dtp3,90,12198,10978,1220,afr,mic_nongavi
cpv,Cabo Verde,2001,mcv1,88,12198,10734,1464,afr,mic_nongavi
cpv,Cabo Verde,2002,dtp3,91,12100,11011,1089,afr,mic_nongavi
cpv,Cabo Verde,2002,dtp1,95,12100,11495,605,afr,mic_nongavi
cpv,Cabo Verde,2002,mcv1,89,12100,10769,1331,afr,mic_nongavi
cpv,Cabo Verde,2003,dtp1,95,12004,11404,600,afr,mic_nongavi
cpv,Cabo Verde,2003,dtp3,92,12004,11044,960,afr,mic_nongavi
cpv,Cabo Verde,2003,mcv1,90,12004,10804,1200,afr,mic_nongavi
cpv,Cabo Verde,2004,dtp1,96,11907,11431,476,afr,mic_nongavi
cpv,Cabo Verde,2004,dtp3,93,11907,11074,833,afr,mic_nongavi
cpv,Cabo Verde,2004,mcv1,91,11907,10835,1072,afr,mic_nongavi
cpv,Cabo Verde,2005,dtp1,97,11808,11454,354,afr,mic_nongavi
cpv,Cabo Verde,2005,dtp3,95,11808,11218,590,afr,mic_nongavi
cpv,Cabo Verde,2005,mcv1,92,11808,10863,945,afr,mic_nongavi
cpv,Cabo Verde,2006,dtp3,96,11704,11236,468,afr,mic_nongavi
cpv,Cabo Verde,2006,mcv1,94,11704,11002,702,afr,mic_nongavi
cpv,Cabo Verde,2006,dtp1,98,11704,11470,234,afr,mic_nongavi
cpv,Cabo Verde,2007,dtp3,98,11595,11363,232,afr,mic_nongavi
cpv,Cabo Verde,2007,mcv1,95,11595,11015,580,afr,mic_nongavi
cpv,Cabo Verde,2007,dtp1,99,11595,11479,116,afr,mic_nongavi
cpv,Cabo Verde,2008,dtp1,99,11482,11367,115,afr,mic_nongavi
cpv,Cabo Verde,2008,dtp3,99,11482,11367,115,afr,mic_nongavi
cpv,Cabo Verde,2008,mcv1,96,11482,11023,459,afr,mic_nongavi
cpv,Cabo Verde,2009,dtp3,99,11368,11254,114,afr,mic_nongavi
cpv,Cabo Verde,2009,dtp1,99,11368,11254,114,afr,mic_nongavi
cpv,Cabo Verde,2009,mcv1,97,11368,11027,341,afr,mic_nongavi
cpv,Cabo Verde,2010,dtp1,99,11262,11149,113,afr,mic_nongavi
cpv,Cabo Verde,2010,mcv1,97,11262,10924,338,afr,mic_nongavi
cpv,Cabo Verde,2010,dtp3,99,11262,11149,113,afr,mic_nongavi
cpv,Cabo Verde,2011,dtp3,90,11172,10055,1117,afr,mic_nongavi
cpv,Cabo Verde,2011,dtp1,99,11172,11060,112,afr,mic_nongavi
cpv,Cabo Verde,2011,mcv1,96,11172,10725,447,afr,mic_nongavi
cpv,Cabo Verde,2011,mcv2,99,11178,11066,112,afr,mic_nongavi
cpv,Cabo Verde,2012,dtp3,94,11106,10440,666,afr,mic_nongavi
cpv,Cabo Verde,2012,mcv1,91,11106,10106,1000,afr,mic_nongavi
cpv,Cabo Verde,2012,dtp1,98,11106,10884,222,afr,mic_nongavi
cpv,Cabo Verde,2012,mcv2,94,11201,10529,672,afr,mic_nongavi
cpv,Cabo Verde,2013,dtp3,93,11064,10290,774,afr,mic_nongavi
cpv,Cabo Verde,2013,mcv1,91,11064,10068,996,afr,mic_nongavi
cpv,Cabo Verde,2013,dtp1,93,11064,10290,774,afr,mic_nongavi
cpv,Cabo Verde,2013,mcv2,89,10974,9767,1207,afr,mic_nongavi
cpv,Cabo Verde,2014,dtp3,95,11048,10496,552,afr,mic_nongavi
cpv,Cabo Verde,2014,mcv1,93,11048,10275,773,afr,mic_nongavi
cpv,Cabo Verde,2014,dtp1,99,11048,10938,110,afr,mic_nongavi
cpv,Cabo Verde,2014,mcv2,79,10957,8656,2301,afr,mic_nongavi
cpv,Cabo Verde,2015,mcv1,92,11050,10166,884,afr,mic_nongavi
cpv,Cabo Verde,2015,dtp1,97,11050,10718,332,afr,mic_nongavi
cpv,Cabo Verde,2015,dtp3,93,11050,10276,774,afr,mic_nongavi
cpv,Cabo Verde,2015,mcv2,95,10955,10407,548,afr,mic_nongavi
cpv,Cabo Verde,2016,mcv1,92,11063,10178,885,afr,mic_nongavi
cpv,Cabo Verde,2016,dtp1,96,11063,10620,443,afr,mic_nongavi
cpv,Cabo Verde,2016,dtp3,96,11063,10620,443,afr,mic_nongavi
cpv,Cabo Verde,2016,mcv2,95,10910,10364,546,afr,mic_nongavi
cri,Costa Rica,2000,dtp1,90,75356,67820,7536,amr,mic_nongavi
cri,Costa Rica,2000,dtp3,88,75356,66313,9043,amr,mic_nongavi
cri,Costa Rica,2000,mcv1,82,75356,61792,13564,amr,mic_nongavi
cri,Costa Rica,2001,mcv1,82,74172,60821,13351,amr,mic_nongavi
cri,Costa Rica,2001,dtp3,91,74172,67497,6675,amr,mic_nongavi
cri,Costa Rica,2001,dtp1,91,74172,67497,6675,amr,mic_nongavi
cri,Costa Rica,2002,mcv1,94,73192,68800,4392,amr,mic_nongavi
cri,Costa Rica,2002,dtp1,98,73192,71728,1464,amr,mic_nongavi
cri,Costa Rica,2002,dtp3,94,73192,68800,4392,amr,mic_nongavi
cri,Costa Rica,2003,dtp1,89,72476,64504,7972,amr,mic_nongavi
cri,Costa Rica,2003,dtp3,88,72476,63779,8697,amr,mic_nongavi
cri,Costa Rica,2003,mcv1,89,72476,64504,7972,amr,mic_nongavi
cri,Costa Rica,2004,dtp3,90,72039,64835,7204,amr,mic_nongavi
cri,Costa Rica,2004,dtp1,96,72039,69157,2882,amr,mic_nongavi
cri,Costa Rica,2004,mcv1,88,72039,63394,8645,amr,mic_nongavi
cri,Costa Rica,2005,dtp3,91,71843,65377,6466,amr,mic_nongavi
cri,Costa Rica,2005,dtp1,97,71843,69688,2155,amr,mic_nongavi
cri,Costa Rica,2005,mcv1,89,71843,63940,7903,amr,mic_nongavi
cri,Costa Rica,2006,dtp1,89,71804,63906,7898,amr,mic_nongavi
cri,Costa Rica,2006,dtp3,89,71804,63906,7898,amr,mic_nongavi
cri,Costa Rica,2006,mcv1,90,71804,64624,7180,amr,mic_nongavi
cri,Costa Rica,2007,dtp3,89,71798,63900,7898,amr,mic_nongavi
cri,Costa Rica,2007,mcv1,90,71798,64618,7180,amr,mic_nongavi
cri,Costa Rica,2007,dtp1,90,71798,64618,7180,amr,mic_nongavi
cri,Costa Rica,2008,dtp1,90,71728,64555,7173,amr,mic_nongavi
cri,Costa Rica,2008,dtp3,90,71728,64555,7173,amr,mic_nongavi
cri,Costa Rica,2008,mcv1,89,71728,63838,7890,amr,mic_nongavi
cri,Costa Rica,2008,mcv2,89,75031,66778,8253,amr,mic_nongavi
cri,Costa Rica,2009,dtp3,86,71552,61535,10017,amr,mic_nongavi
cri,Costa Rica,2009,dtp1,91,71552,65112,6440,amr,mic_nongavi
cri,Costa Rica,2009,mcv1,81,71552,57957,13595,amr,mic_nongavi
cri,Costa Rica,2009,mcv2,84,73347,61611,11736,amr,mic_nongavi
cri,Costa Rica,2010,dtp3,88,71260,62709,8551,amr,mic_nongavi
cri,Costa Rica,2010,dtp1,96,71260,68410,2850,amr,mic_nongavi
cri,Costa Rica,2010,mcv1,83,71260,59146,12114,amr,mic_nongavi
cri,Costa Rica,2010,mcv2,79,70882,55997,14885,amr,mic_nongavi
cri,Costa Rica,2011,dtp3,85,70876,60245,10631,amr,mic_nongavi
cri,Costa Rica,2011,dtp1,87,70876,61662,9214,amr,mic_nongavi
cri,Costa Rica,2011,mcv1,83,70876,58827,12049,amr,mic_nongavi
cri,Costa Rica,2011,mcv2,80,70914,56731,14183,amr,mic_nongavi
cri,Costa Rica,2012,dtp3,91,70454,64113,6341,amr,mic_nongavi
cri,Costa Rica,2012,dtp1,92,70454,64818,5636,amr,mic_nongavi
cri,Costa Rica,2012,mcv1,90,70454,63409,7045,amr,mic_nongavi
cri,Costa Rica,2012,mcv2,95,70781,67242,3539,amr,mic_nongavi
cri,Costa Rica,2013,mcv1,91,70037,63734,6303,amr,mic_nongavi
cri,Costa Rica,2013,dtp1,98,70037,68636,1401,amr,mic_nongavi
cri,Costa Rica,2013,dtp3,95,70037,66535,3502,amr,mic_nongavi
cri,Costa Rica,2013,mcv2,92,71162,65469,5693,amr,mic_nongavi
cri,Costa Rica,2014,dtp3,91,69631,63364,6267,amr,mic_nongavi
cri,Costa Rica,2014,dtp1,91,69631,63364,6267,amr,mic_nongavi
cri,Costa Rica,2014,mcv1,95,69631,66149,3482,amr,mic_nongavi
cri,Costa Rica,2014,mcv2,90,71726,64553,7173,amr,mic_nongavi
cri,Costa Rica,2015,mcv1,93,69232,64386,4846,amr,mic_nongavi
cri,Costa Rica,2015,dtp3,92,69232,63693,5539,amr,mic_nongavi
cri,Costa Rica,2015,dtp1,93,69232,64386,4846,amr,mic_nongavi
cri,Costa Rica,2015,mcv2,90,72169,64952,7217,amr,mic_nongavi
cri,Costa Rica,2016,dtp1,99,68825,68137,688,amr,mic_nongavi
cri,Costa Rica,2016,mcv1,93,68825,64007,4818,amr,mic_nongavi
cri,Costa Rica,2016,dtp3,97,68825,66760,2065,amr,mic_nongavi
cri,Costa Rica,2016,mcv2,87,72311,62911,9400,amr,mic_nongavi
cub,Cuba,2000,dtp1,98,143661,140788,2873,amr,gavi
cub,Cuba,2000,dtp3,95,143661,136478,7183,amr,gavi
cub,Cuba,2000,mcv1,94,143661,135041,8620,amr,gavi
cub,Cuba,2001,dtp1,99,140274,138871,1403,amr,gavi
cub,Cuba,2001,mcv1,96,140274,134663,5611,amr,gavi
cub,Cuba,2001,dtp3,98,140274,137469,2805,amr,gavi
cub,Cuba,2002,dtp3,99,136885,135516,1369,amr,gavi
cub,Cuba,2002,dtp1,99,136885,135516,1369,amr,gavi
cub,Cuba,2002,mcv1,98,136885,134147,2738,amr,gavi
cub,Cuba,2003,dtp3,72,133634,96216,37418,amr,gavi
cub,Cuba,2003,dtp1,90,133634,120271,13363,amr,gavi
cub,Cuba,2003,mcv1,99,133634,132298,1336,amr,gavi
cub,Cuba,2004,dtp3,88,130643,114966,15677,amr,gavi
cub,Cuba,2004,dtp1,89,130643,116272,14371,amr,gavi
cub,Cuba,2004,mcv1,99,130643,129337,1306,amr,gavi
cub,Cuba,2005,dtp1,99,128100,126819,1281,amr,gavi
cub,Cuba,2005,dtp3,89,128100,114009,14091,amr,gavi
cub,Cuba,2005,mcv1,98,128100,125538,2562,amr,gavi
cub,Cuba,2005,mcv2,53,151896,80505,71391,amr,gavi
cub,Cuba,2006,mcv1,96,126192,121144,5048,amr,gavi
cub,Cuba,2006,dtp3,89,126192,112311,13881,amr,gavi
cub,Cuba,2006,dtp1,98,126192,123668,2524,amr,gavi
cub,Cuba,2006,mcv2,97,143844,139529,4315,amr,gavi
cub,Cuba,2007,mcv1,97,124960,121211,3749,amr,gavi
cub,Cuba,2007,dtp3,93,124960,116213,8747,amr,gavi
cub,Cuba,2007,dtp1,97,124960,121211,3749,amr,gavi
cub,Cuba,2007,mcv2,99,139501,138106,1395,amr,gavi
cub,Cuba,2008,dtp3,95,124369,118151,6218,amr,gavi
cub,Cuba,2008,mcv1,98,124369,121882,2487,amr,gavi
cub,Cuba,2008,dtp1,96,124369,119394,4975,amr,gavi
cub,Cuba,2008,mcv2,98,134911,132213,2698,amr,gavi
cub,Cuba,2009,mcv1,99,124338,123095,1243,amr,gavi
cub,Cuba,2009,dtp3,96,124338,119364,4974,amr,gavi
cub,Cuba,2009,dtp1,98,124338,121851,2487,amr,gavi
cub,Cuba,2009,mcv2,95,130593,124063,6530,amr,gavi
cub,Cuba,2010,dtp1,96,124690,119702,4988,amr,gavi
cub,Cuba,2010,mcv1,99,124690,123443,1247,amr,gavi
cub,Cuba,2010,dtp3,96,124690,119702,4988,amr,gavi
cub,Cuba,2010,mcv2,98,127225,124680,2545,amr,gavi
cub,Cuba,2011,dtp1,99,125192,123940,1252,amr,gavi
cub,Cuba,2011,mcv1,99,125192,123940,1252,amr,gavi
cub,Cuba,2011,dtp3,97,125192,121436,3756,amr,gavi
cub,Cuba,2011,mcv2,95,124623,118392,6231,amr,gavi
cub,Cuba,2012,mcv1,99,125600,124344,1256,amr,gavi
cub,Cuba,2012,dtp1,99,125600,124344,1256,amr,gavi
cub,Cuba,2012,dtp3,99,125600,124344,1256,amr,gavi
cub,Cuba,2012,mcv2,96,122547,117645,4902,amr,gavi
cub,Cuba,2013,dtp3,99,125723,124466,1257,amr,gavi
cub,Cuba,2013,dtp1,99,125723,124466,1257,amr,gavi
cub,Cuba,2013,mcv1,99,125723,124466,1257,amr,gavi
cub,Cuba,2013,mcv2,97,121025,117394,3631,amr,gavi
cub,Cuba,2014,dtp1,99,125470,124215,1255,amr,gavi
cub,Cuba,2014,mcv1,99,125470,124215,1255,amr,gavi
cub,Cuba,2014,dtp3,99,125470,124215,1255,amr,gavi
cub,Cuba,2014,mcv2,98,120082,117680,2402,amr,gavi
cub,Cuba,2015,dtp3,99,124822,123574,1248,amr,gavi
cub,Cuba,2015,mcv1,99,124822,123574,1248,amr,gavi
cub,Cuba,2015,dtp1,99,124822,123574,1248,amr,gavi
cub,Cuba,2015,mcv2,99,119718,118521,1197,amr,gavi
cub,Cuba,2016,mcv1,99,123851,122612,1239,amr,gavi
cub,Cuba,2016,dtp3,99,123851,122612,1239,amr,gavi
cub,Cuba,2016,dtp1,99,123851,122612,1239,amr,gavi
cub,Cuba,2016,mcv2,99,119908,118709,1199,amr,gavi
cyp,Cyprus,2000,dtp1,98,12370,12123,247,eur,hic
cyp,Cyprus,2000,dtp3,97,12370,11999,371,eur,hic
cyp,Cyprus,2000,mcv1,86,12370,10638,1732,eur,hic
cyp,Cyprus,2001,dtp3,97,12194,11828,366,eur,hic
cyp,Cyprus,2001,mcv1,86,12194,10487,1707,eur,hic
cyp,Cyprus,2001,dtp1,98,12194,11950,244,eur,hic
cyp,Cyprus,2002,mcv1,86,12087,10395,1692,eur,hic
cyp,Cyprus,2002,dtp3,98,12087,11845,242,eur,hic
cyp,Cyprus,2002,dtp1,98,12087,11845,242,eur,hic
cyp,Cyprus,2003,dtp1,98,12044,11803,241,eur,hic
cyp,Cyprus,2003,mcv1,86,12044,10358,1686,eur,hic
cyp,Cyprus,2003,dtp3,98,12044,11803,241,eur,hic
cyp,Cyprus,2004,dtp3,98,12061,11820,241,eur,hic
cyp,Cyprus,2004,dtp1,98,12061,11820,241,eur,hic
cyp,Cyprus,2004,mcv1,86,12061,10372,1689,eur,hic
cyp,Cyprus,2005,dtp3,98,12130,11887,243,eur,hic
cyp,Cyprus,2005,mcv1,86,12130,10432,1698,eur,hic
cyp,Cyprus,2005,dtp1,98,12130,11887,243,eur,hic
cyp,Cyprus,2006,dtp1,98,12238,11993,245,eur,hic
cyp,Cyprus,2006,mcv1,87,12238,10647,1591,eur,hic
cyp,Cyprus,2006,dtp3,97,12238,11871,367,eur,hic
cyp,Cyprus,2007,dtp3,97,12365,11994,371,eur,hic
cyp,Cyprus,2007,dtp1,98,12365,12118,247,eur,hic
cyp,Cyprus,2007,mcv1,87,12365,10758,1607,eur,hic
cyp,Cyprus,2007,mcv2,93,12556,11677,879,eur,hic
cyp,Cyprus,2008,dtp1,98,12490,12240,250,eur,hic
cyp,Cyprus,2008,dtp3,97,12490,12115,375,eur,hic
cyp,Cyprus,2008,mcv1,87,12490,10866,1624,eur,hic
cyp,Cyprus,2008,mcv2,89,12429,11062,1367,eur,hic
cyp,Cyprus,2009,mcv1,87,12604,10965,1639,eur,hic
cyp,Cyprus,2009,dtp1,99,12604,12478,126,eur,hic
cyp,Cyprus,2009,dtp3,99,12604,12478,126,eur,hic
cyp,Cyprus,2009,mcv2,88,12457,10962,1495,eur,hic
cyp,Cyprus,2010,mcv1,87,12692,11042,1650,eur,hic
cyp,Cyprus,2010,dtp1,99,12692,12565,127,eur,hic
cyp,Cyprus,2010,dtp3,99,12692,12565,127,eur,hic
cyp,Cyprus,2010,mcv2,88,12691,11168,1523,eur,hic
cyp,Cyprus,2011,dtp1,99,12750,12622,128,eur,hic
cyp,Cyprus,2011,dtp3,99,12750,12622,128,eur,hic
cyp,Cyprus,2011,mcv1,87,12750,11092,1658,eur,hic
cyp,Cyprus,2011,mcv2,88,12803,11267,1536,eur,hic
cyp,Cyprus,2012,dtp3,99,12781,12653,128,eur,hic
cyp,Cyprus,2012,dtp1,99,12781,12653,128,eur,hic
cyp,Cyprus,2012,mcv1,86,12781,10992,1789,eur,hic
cyp,Cyprus,2012,mcv2,88,12942,11389,1553,eur,hic
cyp,Cyprus,2013,mcv1,86,12786,10996,1790,eur,hic
cyp,Cyprus,2013,dtp1,99,12786,12658,128,eur,hic
cyp,Cyprus,2013,dtp3,99,12786,12658,128,eur,hic
cyp,Cyprus,2013,mcv2,88,13098,11526,1572,eur,hic
cyp,Cyprus,2014,mcv1,86,12766,10979,1787,eur,hic
cyp,Cyprus,2014,dtp3,99,12766,12638,128,eur,hic
cyp,Cyprus,2014,dtp1,99,12766,12638,128,eur,hic
cyp,Cyprus,2014,mcv2,88,13255,11664,1591,eur,hic
cyp,Cyprus,2015,dtp3,97,12719,12337,382,eur,hic
cyp,Cyprus,2015,dtp1,98,12719,12465,254,eur,hic
cyp,Cyprus,2015,mcv1,90,12719,11447,1272,eur,hic
cyp,Cyprus,2015,mcv2,88,13381,11775,1606,eur,hic
cyp,Cyprus,2016,dtp3,97,12647,12268,379,eur,hic
cyp,Cyprus,2016,dtp1,98,12647,12394,253,eur,hic
cyp,Cyprus,2016,mcv1,90,12647,11382,1265,eur,hic
cyp,Cyprus,2016,mcv2,88,13410,11801,1609,eur,hic
cze,Czech Republic,2000,mcv1,97,87836,85201,2635,eur,hic
cze,Czech Republic,2000,dtp1,99,87836,86958,878,eur,hic
cze,Czech Republic,2000,dtp3,98,87836,86079,1757,eur,hic
cze,Czech Republic,2000,mcv2,98,90879,89061,1818,eur,hic
cze,Czech Republic,2001,dtp1,99,89275,88382,893,eur,hic
cze,Czech Republic,2001,mcv1,97,89275,86597,2678,eur,hic
cze,Czech Republic,2001,dtp3,98,89275,87490,1785,eur,hic
cze,Czech Republic,2001,mcv2,98,82138,80495,1643,eur,hic
cze,Czech Republic,2002,mcv1,98,91931,90092,1839,eur,hic
cze,Czech Republic,2002,dtp3,98,91931,90092,1839,eur,hic
cze,Czech Republic,2002,dtp1,99,91931,91012,919,eur,hic
cze,Czech Republic,2002,mcv2,98,75229,73724,1505,eur,hic
cze,Czech Republic,2003,dtp3,97,95352,92491,2861,eur,hic
cze,Czech Republic,2003,mcv1,97,95352,92491,2861,eur,hic
cze,Czech Republic,2003,dtp1,99,95352,94398,954,eur,hic
cze,Czech Republic,2003,mcv2,98,86055,84334,1721,eur,hic
cze,Czech Republic,2004,dtp3,98,99203,97219,1984,eur,hic
cze,Czech Republic,2004,mcv1,97,99203,96227,2976,eur,hic
cze,Czech Republic,2004,dtp1,99,99203,98211,992,eur,hic
cze,Czech Republic,2004,mcv2,98,87435,85686,1749,eur,hic
cze,Czech Republic,2005,mcv1,97,103058,99966,3092,eur,hic
cze,Czech Republic,2005,dtp1,99,103058,102027,1031,eur,hic
cze,Czech Republic,2005,dtp3,97,103058,99966,3092,eur,hic
cze,Czech Republic,2005,mcv2,98,90267,88462,1805,eur,hic
cze,Czech Republic,2006,mcv1,97,106512,103317,3195,eur,hic
cze,Czech Republic,2006,dtp1,99,106512,105447,1065,eur,hic
cze,Czech Republic,2006,dtp3,98,106512,104382,2130,eur,hic
cze,Czech Republic,2006,mcv2,98,98882,96904,1978,eur,hic
cze,Czech Republic,2007,dtp1,99,109329,108236,1093,eur,hic
cze,Czech Republic,2007,dtp3,99,109329,108236,1093,eur,hic
cze,Czech Republic,2007,mcv1,98,109329,107142,2187,eur,hic
cze,Czech Republic,2007,mcv2,98,107980,105820,2160,eur,hic
cze,Czech Republic,2008,dtp1,99,111349,110236,1113,eur,hic
cze,Czech Republic,2008,mcv1,97,111349,108009,3340,eur,hic
cze,Czech Republic,2008,dtp3,99,111349,110236,1113,eur,hic
cze,Czech Republic,2008,mcv2,98,105481,103371,2110,eur,hic
cze,Czech Republic,2009,mcv1,98,112474,110225,2249,eur,hic
cze,Czech Republic,2009,dtp3,99,112474,111349,1125,eur,hic
cze,Czech Republic,2009,dtp1,99,112474,111349,1125,eur,hic
cze,Czech Republic,2009,mcv2,98,110677,108463,2214,eur,hic
cze,Czech Republic,2010,dtp1,99,112735,111608,1127,eur,hic
cze,Czech Republic,2010,dtp3,99,112735,111608,1127,eur,hic
cze,Czech Republic,2010,mcv1,98,112735,110480,2255,eur,hic
cze,Czech Republic,2010,mcv2,98,114249,111964,2285,eur,hic
cze,Czech Republic,2011,dtp1,99,112309,111186,1123,eur,hic
cze,Czech Republic,2011,dtp3,99,112309,111186,1123,eur,hic
cze,Czech Republic,2011,mcv1,98,112309,110063,2246,eur,hic
cze,Czech Republic,2011,mcv2,98,117545,115194,2351,eur,hic
cze,Czech Republic,2012,dtp3,99,111520,110405,1115,eur,hic
cze,Czech Republic,2012,mcv1,98,111520,109290,2230,eur,hic
cze,Czech Republic,2012,dtp1,99,111520,110405,1115,eur,hic
cze,Czech Republic,2012,mcv2,99,119605,118409,1196,eur,hic
cze,Czech Republic,2013,dtp3,98,110637,108424,2213,eur,hic
cze,Czech Republic,2013,mcv1,99,110637,109531,1106,eur,hic
cze,Czech Republic,2013,dtp1,99,110637,109531,1106,eur,hic
cze,Czech Republic,2013,mcv2,99,115684,114527,1157,eur,hic
cze,Czech Republic,2014,dtp1,99,109772,108674,1098,eur,hic
cze,Czech Republic,2014,mcv1,99,109772,108674,1098,eur,hic
cze,Czech Republic,2014,dtp3,97,109772,106479,3293,eur,hic
cze,Czech Republic,2014,mcv2,96,114213,109644,4569,eur,hic
cze,Czech Republic,2015,dtp3,97,108975,105706,3269,eur,hic
cze,Czech Republic,2015,mcv1,99,108975,107885,1090,eur,hic
cze,Czech Republic,2015,dtp1,99,108975,107885,1090,eur,hic
cze,Czech Republic,2015,mcv2,99,112738,111611,1127,eur,hic
cze,Czech Republic,2016,dtp1,98,108228,106063,2165,eur,hic
cze,Czech Republic,2016,mcv1,98,108228,106063,2165,eur,hic
cze,Czech Republic,2016,dtp3,96,108228,103899,4329,eur,hic
cze,Czech Republic,2016,mcv2,93,107248,99741,7507,eur,hic
deu,Germany,2000,dtp3,90,745953,671358,74595,eur,hic
deu,Germany,2000,mcv1,92,745953,686277,59676,eur,hic
deu,Germany,2000,dtp1,95,745953,708655,37298,eur,hic
deu,Germany,2001,dtp1,95,733666,696983,36683,eur,hic
deu,Germany,2001,dtp3,93,733666,682309,51357,eur,hic
deu,Germany,2001,mcv1,94,733666,689646,44020,eur,hic
deu,Germany,2002,dtp3,93,721003,670533,50470,eur,hic
deu,Germany,2002,mcv1,94,721003,677743,43260,eur,hic
deu,Germany,2002,dtp1,95,721003,684953,36050,eur,hic
deu,Germany,2002,mcv2,77,794448,611725,182723,eur,hic
deu,Germany,2003,dtp3,97,708976,687707,21269,eur,hic
deu,Germany,2003,dtp1,99,708976,701886,7090,eur,hic
deu,Germany,2003,mcv1,95,708976,673527,35449,eur,hic
deu,Germany,2003,mcv2,83,745845,619051,126794,eur,hic
deu,Germany,2004,dtp3,96,698209,670281,27928,eur,hic
deu,Germany,2004,dtp1,98,698209,684245,13964,eur,hic
deu,Germany,2004,mcv1,96,698209,670281,27928,eur,hic
deu,Germany,2004,mcv2,89,735886,654939,80947,eur,hic
deu,Germany,2005,mcv1,96,689315,661742,27573,eur,hic
deu,Germany,2005,dtp1,98,689315,675529,13786,eur,hic
deu,Germany,2005,dtp3,96,689315,661742,27573,eur,hic
deu,Germany,2005,mcv2,91,724396,659200,65196,eur,hic
deu,Germany,2006,dtp3,96,682714,655405,27309,eur,hic
deu,Germany,2006,dtp1,98,682714,669060,13654,eur,hic
deu,Germany,2006,mcv1,96,682714,655405,27309,eur,hic
deu,Germany,2006,mcv2,90,701714,631543,70171,eur,hic
deu,Germany,2007,dtp1,98,678364,664797,13567,eur,hic
deu,Germany,2007,dtp3,96,678364,651229,27135,eur,hic
deu,Germany,2007,mcv1,97,678364,658013,20351,eur,hic
deu,Germany,2007,mcv2,92,680572,626126,54446,eur,hic
deu,Germany,2008,dtp3,96,676156,649110,27046,eur,hic
deu,Germany,2008,dtp1,98,676156,662633,13523,eur,hic
deu,Germany,2008,mcv1,97,676156,655871,20285,eur,hic
deu,Germany,2008,mcv2,92,688220,633162,55058,eur,hic
deu,Germany,2009,dtp3,96,676070,649027,27043,eur,hic
deu,Germany,2009,dtp1,98,676070,662549,13521,eur,hic
deu,Germany,2009,mcv1,97,676070,655788,20282,eur,hic
deu,Germany,2009,mcv2,93,679280,631730,47550,eur,hic
deu,Germany,2010,dtp1,95,678079,644175,33904,eur,hic
deu,Germany,2010,dtp3,95,678079,644175,33904,eur,hic
deu,Germany,2010,mcv1,97,678079,657737,20342,eur,hic
deu,Germany,2010,mcv2,93,675157,627896,47261,eur,hic
deu,Germany,2011,dtp3,95,682064,647961,34103,eur,hic
deu,Germany,2011,dtp1,95,682064,647961,34103,eur,hic
deu,Germany,2011,mcv1,97,682064,661602,20462,eur,hic
deu,Germany,2011,mcv2,93,677171,629769,47402,eur,hic
deu,Germany,2012,dtp3,95,687599,653219,34380,eur,hic
deu,Germany,2012,dtp1,95,687599,653219,34380,eur,hic
deu,Germany,2012,mcv1,97,687599,666971,20628,eur,hic
deu,Germany,2012,mcv2,93,682333,634570,47763,eur,hic
deu,Germany,2013,dtp3,95,694171,659462,34709,eur,hic
deu,Germany,2013,mcv1,97,694171,673346,20825,eur,hic
deu,Germany,2013,dtp1,95,694171,659462,34709,eur,hic
deu,Germany,2013,mcv2,93,685172,637210,47962,eur,hic
deu,Germany,2014,dtp1,95,701335,666268,35067,eur,hic
deu,Germany,2014,dtp3,95,701335,666268,35067,eur,hic
deu,Germany,2014,mcv1,97,701335,680295,21040,eur,hic
deu,Germany,2014,mcv2,93,693709,645149,48560,eur,hic
deu,Germany,2015,mcv1,97,708702,687441,21261,eur,hic
deu,Germany,2015,dtp3,95,708702,673267,35435,eur,hic
deu,Germany,2015,dtp1,95,708702,673267,35435,eur,hic
deu,Germany,2015,mcv2,93,702210,653055,49155,eur,hic
deu,Germany,2016,mcv1,97,715987,694507,21480,eur,hic
deu,Germany,2016,dtp1,95,715987,680188,35799,eur,hic
deu,Germany,2016,dtp3,95,715987,680188,35799,eur,hic
deu,Germany,2016,mcv2,93,710915,661151,49764,eur,hic
dji,Djibouti,2000,dtp1,66,20884,13783,7101,emr,gavi
dji,Djibouti,2000,dtp3,46,20884,9607,11277,emr,gavi
dji,Djibouti,2000,mcv1,50,20884,10442,10442,emr,gavi
dji,Djibouti,2001,dtp3,53,20897,11075,9822,emr,gavi
dji,Djibouti,2001,dtp1,65,20897,13583,7314,emr,gavi
dji,Djibouti,2001,mcv1,49,20897,10240,10657,emr,gavi
dji,Djibouti,2002,dtp1,72,20897,15046,5851,emr,gavi
dji,Djibouti,2002,mcv1,62,20897,12956,7941,emr,gavi
dji,Djibouti,2002,dtp3,62,20897,12956,7941,emr,gavi
dji,Djibouti,2003,dtp3,68,20850,14178,6672,emr,gavi
dji,Djibouti,2003,dtp1,76,20850,15846,5004,emr,gavi
dji,Djibouti,2003,mcv1,66,20850,13761,7089,emr,gavi
dji,Djibouti,2004,mcv1,60,20755,12453,8302,emr,gavi
dji,Djibouti,2004,dtp1,81,20755,16812,3943,emr,gavi
dji,Djibouti,2004,dtp3,64,20755,13283,7472,emr,gavi
dji,Djibouti,2005,mcv1,65,20622,13404,7218,emr,gavi
dji,Djibouti,2005,dtp1,73,20622,15054,5568,emr,gavi
dji,Djibouti,2005,dtp3,71,20622,14642,5980,emr,gavi
dji,Djibouti,2006,dtp1,76,20477,15563,4914,emr,gavi
dji,Djibouti,2006,mcv1,67,20477,13720,6757,emr,gavi
dji,Djibouti,2006,dtp3,72,20477,14743,5734,emr,gavi
dji,Djibouti,2007,dtp3,88,20350,17908,2442,emr,gavi
dji,Djibouti,2007,dtp1,92,20350,18722,1628,emr,gavi
dji,Djibouti,2007,mcv1,74,20350,15059,5291,emr,gavi
dji,Djibouti,2008,dtp1,90,20262,18236,2026,emr,gavi
dji,Djibouti,2008,mcv1,73,20262,14791,5471,emr,gavi
dji,Djibouti,2008,dtp3,89,20262,18033,2229,emr,gavi
dji,Djibouti,2009,dtp1,90,20221,18199,2022,emr,gavi
dji,Djibouti,2009,mcv1,84,20221,16986,3235,emr,gavi
dji,Djibouti,2009,dtp3,89,20221,17997,2224,emr,gavi
dji,Djibouti,2010,dtp3,88,20227,17800,2427,emr,gavi
dji,Djibouti,2010,mcv1,85,20227,17193,3034,emr,gavi
dji,Djibouti,2010,dtp1,90,20227,18204,2023,emr,gavi
dji,Djibouti,2011,dtp3,87,20271,17636,2635,emr,gavi
dji,Djibouti,2011,dtp1,89,20271,18041,2230,emr,gavi
dji,Djibouti,2011,mcv1,84,20271,17028,3243,emr,gavi
dji,Djibouti,2012,dtp1,85,20333,17283,3050,emr,gavi
dji,Djibouti,2012,dtp3,81,20333,16470,3863,emr,gavi
dji,Djibouti,2012,mcv1,83,20333,16876,3457,emr,gavi
dji,Djibouti,2012,mcv2,82,19576,16052,3524,emr,gavi
dji,Djibouti,2013,dtp1,87,20397,17745,2652,emr,gavi
dji,Djibouti,2013,dtp3,82,20397,16726,3671,emr,gavi
dji,Djibouti,2013,mcv1,80,20397,16318,4079,emr,gavi
dji,Djibouti,2013,mcv2,82,19940,16351,3589,emr,gavi
dji,Djibouti,2014,mcv1,71,20456,14524,5932,emr,gavi
dji,Djibouti,2014,dtp1,93,20456,19024,1432,emr,gavi
dji,Djibouti,2014,dtp3,78,20456,15956,4500,emr,gavi
dji,Djibouti,2014,mcv2,82,20021,16417,3604,emr,gavi
dji,Djibouti,2015,dtp1,90,20504,18454,2050,emr,gavi
dji,Djibouti,2015,mcv1,74,20504,15173,5331,emr,gavi
dji,Djibouti,2015,dtp3,84,20504,17223,3281,emr,gavi
dji,Djibouti,2015,mcv2,82,20105,16486,3619,emr,gavi
dji,Djibouti,2016,dtp3,84,20543,17256,3287,emr,gavi
dji,Djibouti,2016,dtp1,90,20543,18489,2054,emr,gavi
dji,Djibouti,2016,mcv1,75,20543,15407,5136,emr,gavi
dji,Djibouti,2016,mcv2,82,20429,16752,3677,emr,gavi
dma,Dominica,2000,mcv1,99,1445.5662009294,1431,14.5662009294,amr,mic_nongavi
dma,Dominica,2000,dtp3,99,1445.5662009294,1431,14.5662009294,amr,mic_nongavi
dma,Dominica,2000,dtp1,99,1445.5662009294,1431,14.5662009294,amr,mic_nongavi
dma,Dominica,2001,mcv1,99,1422.7356301173,1409,13.7356301173,amr,mic_nongavi
dma,Dominica,2001,dtp1,99,1422.7356301173,1409,13.7356301173,amr,mic_nongavi
dma,Dominica,2001,dtp3,99,1422.7356301173,1409,13.7356301173,amr,mic_nongavi
dma,Dominica,2001,mcv2,62,1422.7356301173,882,540.7356301173,amr,mic_nongavi
dma,Dominica,2002,dtp1,99,1404.789911668,1391,13.789911668,amr,mic_nongavi
dma,Dominica,2002,mcv1,99,1404.789911668,1391,13.789911668,amr,mic_nongavi
dma,Dominica,2002,dtp3,98,1404.789911668,1377,27.789911668,amr,mic_nongavi
dma,Dominica,2002,mcv2,99,1404.789911668,1391,13.789911668,amr,mic_nongavi
dma,Dominica,2003,dtp1,99,1390.6166271616,1377,13.6166271616,amr,mic_nongavi
dma,Dominica,2003,mcv1,99,1390.6166271616,1377,13.6166271616,amr,mic_nongavi
dma,Dominica,2003,dtp3,99,1390.6166271616,1377,13.6166271616,amr,mic_nongavi
dma,Dominica,2003,mcv2,99,1390.6166271616,1377,13.6166271616,amr,mic_nongavi
dma,Dominica,2004,dtp3,99,1378.0808753024,1364,14.0808753024,amr,mic_nongavi
dma,Dominica,2004,mcv1,99,1378.0808753024,1364,14.0808753024,amr,mic_nongavi
dma,Dominica,2004,dtp1,99,1378.0808753024,1364,14.0808753024,amr,mic_nongavi
dma,Dominica,2004,mcv2,99,1378.0808753024,1364,14.0808753024,amr,mic_nongavi
dma,Dominica,2005,dtp1,99,1365.9780824849,1352,13.9780824848,amr,mic_nongavi
dma,Dominica,2005,dtp3,98,1365.9780824849,1339,26.9780824848,amr,mic_nongavi
dma,Dominica,2005,mcv1,98,1365.9780824849,1339,26.9780824848,amr,mic_nongavi
dma,Dominica,2005,mcv2,99,1365.9780824849,1352,13.9780824848,amr,mic_nongavi
dma,Dominica,2006,dtp1,98,1353.6135612937,1327,26.6135612937,amr,mic_nongavi
dma,Dominica,2006,dtp3,95,1353.6135612937,1286,67.6135612937,amr,mic_nongavi
dma,Dominica,2006,mcv1,97,1353.6135612937,1313,40.6135612937,amr,mic_nongavi
dma,Dominica,2006,mcv2,99,1353.6135612937,1340,13.6135612937,amr,mic_nongavi
dma,Dominica,2007,dtp1,98,1341.3176335914,1314,27.3176335914,amr,mic_nongavi
dma,Dominica,2007,dtp3,96,1341.3176335914,1288,53.3176335914,amr,mic_nongavi
dma,Dominica,2007,mcv1,96,1341.3176335914,1288,53.3176335914,amr,mic_nongavi
dma,Dominica,2007,mcv2,95,1341.3176335914,1274,67.3176335914,amr,mic_nongavi
dma,Dominica,2008,dtp3,96,1329.0756935761,1276,53.0756935761,amr,mic_nongavi
dma,Dominica,2008,dtp1,96,1329.0756935761,1276,53.0756935761,amr,mic_nongavi
dma,Dominica,2008,mcv1,99,1329.0756935761,1316,13.0756935761,amr,mic_nongavi
dma,Dominica,2008,mcv2,95,1329.0756935761,1263,66.0756935761,amr,mic_nongavi
dma,Dominica,2009,dtp3,99,1317.5591734731,1304,13.5591734731,amr,mic_nongavi
dma,Dominica,2009,dtp1,99,1317.5591734731,1304,13.5591734731,amr,mic_nongavi
dma,Dominica,2009,mcv1,99,1317.5591734731,1304,13.5591734731,amr,mic_nongavi
dma,Dominica,2009,mcv2,95,1317.5591734731,1252,65.5591734731,amr,mic_nongavi
dma,Dominica,2010,dtp1,99,1306.9552725935,1294,12.9552725935,amr,mic_nongavi
dma,Dominica,2010,mcv1,99,1306.9552725935,1294,12.9552725935,amr,mic_nongavi
dma,Dominica,2010,dtp3,98,1306.9552725935,1281,25.9552725935,amr,mic_nongavi
dma,Dominica,2010,mcv2,95,1306.9552725935,1242,64.9552725935,amr,mic_nongavi
dma,Dominica,2011,mcv1,99,1297.2588270775,1284,13.2588270775,amr,mic_nongavi
dma,Dominica,2011,dtp3,98,1297.2588270775,1271,26.2588270775,amr,mic_nongavi
dma,Dominica,2011,dtp1,99,1297.2588270775,1284,13.2588270775,amr,mic_nongavi
dma,Dominica,2011,mcv2,94,1297.2588270775,1219,78.2588270775,amr,mic_nongavi
dma,Dominica,2012,mcv1,99,1288.0495400058,1275,13.0495400058,amr,mic_nongavi
dma,Dominica,2012,dtp3,97,1288.0495400058,1249,39.0495400058,amr,mic_nongavi
dma,Dominica,2012,dtp1,98,1288.0495400058,1262,26.0495400058,amr,mic_nongavi
dma,Dominica,2012,mcv2,94,1288.0495400058,1211,77.0495400058,amr,mic_nongavi
dma,Dominica,2013,mcv1,93,1279.0455948904,1190,89.0455948904,amr,mic_nongavi
dma,Dominica,2013,dtp3,96,1279.0455948904,1228,51.0455948904,amr,mic_nongavi
dma,Dominica,2013,dtp1,98,1279.0455948904,1253,26.0455948904,amr,mic_nongavi
dma,Dominica,2013,mcv2,91,1279.0455948904,1164,115.0455948904,amr,mic_nongavi
dma,Dominica,2014,mcv1,94,1270.1389928233,1194,76.1389928233,amr,mic_nongavi
dma,Dominica,2014,dtp3,97,1270.1389928233,1232,38.1389928233,amr,mic_nongavi
dma,Dominica,2014,dtp1,99,1270.1389928233,1257,13.1389928233,amr,mic_nongavi
dma,Dominica,2014,mcv2,89,1270.1389928233,1130,140.1389928233,amr,mic_nongavi
dma,Dominica,2015,mcv1,96,1261.1359059472,1211,50.1359059472,amr,mic_nongavi
dma,Dominica,2015,dtp1,99,1261.1359059472,1249,12.1359059472,amr,mic_nongavi
dma,Dominica,2015,dtp3,98,1261.1359059472,1236,25.1359059472,amr,mic_nongavi
dma,Dominica,2015,mcv2,94,1261.1359059472,1185,76.1359059472,amr,mic_nongavi
dma,Dominica,2016,mcv1,96,1251.8735889801,1202,49.8735889801,amr,mic_nongavi
dma,Dominica,2016,dtp3,99,1251.8735889801,1239,12.8735889801,amr,mic_nongavi
dma,Dominica,2016,dtp1,99,1251.8735889801,1239,12.8735889801,amr,mic_nongavi
dma,Dominica,2016,mcv2,92,NA,NA,#VALUE!,amr,mic_nongavi
dnk,Denmark,2000,dtp3,97,65412,63450,1962,eur,hic
dnk,Denmark,2000,mcv1,99,65412,64758,654,eur,hic
dnk,Denmark,2000,dtp1,98,65412,64104,1308,eur,hic
dnk,Denmark,2001,dtp1,97,65045,63094,1951,eur,hic
dnk,Denmark,2001,mcv1,94,65045,61142,3903,eur,hic
dnk,Denmark,2001,dtp3,97,65045,63094,1951,eur,hic
dnk,Denmark,2001,mcv2,87,62595,54458,8137,eur,hic
dnk,Denmark,2002,dtp3,98,64792,63496,1296,eur,hic
dnk,Denmark,2002,dtp1,99,64792,64144,648,eur,hic
dnk,Denmark,2002,mcv1,95,64792,61552,3240,eur,hic
dnk,Denmark,2002,mcv2,92,64695,59519,5176,eur,hic
dnk,Denmark,2003,dtp3,96,64642,62056,2586,eur,hic
dnk,Denmark,2003,dtp1,98,64642,63349,1293,eur,hic
dnk,Denmark,2003,mcv1,96,64642,62056,2586,eur,hic
dnk,Denmark,2003,mcv2,88,66760,58749,8011,eur,hic
dnk,Denmark,2004,dtp1,95,64576,61347,3229,eur,hic
dnk,Denmark,2004,dtp3,95,64576,61347,3229,eur,hic
dnk,Denmark,2004,mcv1,96,64576,61993,2583,eur,hic
dnk,Denmark,2004,mcv2,88,68972,60695,8277,eur,hic
dnk,Denmark,2005,mcv1,95,64497,61272,3225,eur,hic
dnk,Denmark,2005,dtp3,93,64497,59982,4515,eur,hic
dnk,Denmark,2005,dtp1,93,64497,59982,4515,eur,hic
dnk,Denmark,2005,mcv2,91,70649,64291,6358,eur,hic
dnk,Denmark,2006,dtp3,93,64271,59772,4499,eur,hic
dnk,Denmark,2006,mcv1,90,64271,57844,6427,eur,hic
dnk,Denmark,2006,dtp1,93,64271,59772,4499,eur,hic
dnk,Denmark,2006,mcv2,91,70846,64470,6376,eur,hic
dnk,Denmark,2007,dtp3,87,63809,55514,8295,eur,hic
dnk,Denmark,2007,mcv1,89,63809,56790,7019,eur,hic
dnk,Denmark,2007,dtp1,87,63809,55514,8295,eur,hic
dnk,Denmark,2007,mcv2,88,70268,61836,8432,eur,hic
dnk,Denmark,2008,mcv1,87,63082,54881,8201,eur,hic
dnk,Denmark,2008,dtp1,89,63082,56143,6939,eur,hic
dnk,Denmark,2008,dtp3,88,63082,55512,7570,eur,hic
dnk,Denmark,2008,mcv2,87,69760,60691,9069,eur,hic
dnk,Denmark,2009,dtp1,90,62130,55917,6213,eur,hic
dnk,Denmark,2009,dtp3,89,62130,55296,6834,eur,hic
dnk,Denmark,2009,mcv1,84,62130,52189,9941,eur,hic
dnk,Denmark,2009,mcv2,85,64733,55023,9710,eur,hic
dnk,Denmark,2010,dtp3,90,61065,54959,6106,eur,hic
dnk,Denmark,2010,mcv1,85,61065,51905,9160,eur,hic
dnk,Denmark,2010,dtp1,93,61065,56790,4275,eur,hic
dnk,Denmark,2010,mcv2,85,64645,54948,9697,eur,hic
dnk,Denmark,2011,dtp1,94,60047,56444,3603,eur,hic
dnk,Denmark,2011,dtp3,91,60047,54643,5404,eur,hic
dnk,Denmark,2011,mcv1,87,60047,52241,7806,eur,hic
dnk,Denmark,2011,mcv2,86,65090,55977,9113,eur,hic
dnk,Denmark,2012,mcv1,90,59239,53315,5924,eur,hic
dnk,Denmark,2012,dtp1,97,59239,57462,1777,eur,hic
dnk,Denmark,2012,dtp3,94,59239,55685,3554,eur,hic
dnk,Denmark,2012,mcv2,87,65730,57185,8545,eur,hic
dnk,Denmark,2013,dtp3,94,58762,55236,3526,eur,hic
dnk,Denmark,2013,mcv1,89,58762,52298,6464,eur,hic
dnk,Denmark,2013,dtp1,97,58762,56999,1763,eur,hic
dnk,Denmark,2013,mcv2,86,66210,56941,9269,eur,hic
dnk,Denmark,2014,dtp1,96,58663,56316,2347,eur,hic
dnk,Denmark,2014,dtp3,94,58663,55143,3520,eur,hic
dnk,Denmark,2014,mcv1,90,58663,52797,5866,eur,hic
dnk,Denmark,2014,mcv2,84,66041,55474,10567,eur,hic
dnk,Denmark,2015,dtp1,96,58951,56593,2358,eur,hic
dnk,Denmark,2015,mcv1,91,58951,53645,5306,eur,hic
dnk,Denmark,2015,dtp3,93,58951,54824,4127,eur,hic
dnk,Denmark,2015,mcv2,80,64654,51723,12931,eur,hic
dnk,Denmark,2016,dtp3,94,59583,56008,3575,eur,hic
dnk,Denmark,2016,dtp1,97,59583,57796,1787,eur,hic
dnk,Denmark,2016,mcv1,94,59583,56008,3575,eur,hic
dnk,Denmark,2016,mcv2,85,62386,53028,9358,eur,hic
dom,Dominican Republic,2000,dtp3,78,207572,161906,45666,amr,mic_nongavi
dom,Dominican Republic,2000,dtp1,91,207572,188891,18681,amr,mic_nongavi
dom,Dominican Republic,2000,mcv1,85,207572,176436,31136,amr,mic_nongavi
dom,Dominican Republic,2001,dtp1,95,208860,198417,10443,amr,mic_nongavi
dom,Dominican Republic,2001,dtp3,72,208860,150379,58481,amr,mic_nongavi
dom,Dominican Republic,2001,mcv1,88,208860,183797,25063,amr,mic_nongavi
dom,Dominican Republic,2002,dtp3,82,210160,172331,37829,amr,mic_nongavi
dom,Dominican Republic,2002,mcv1,86,210160,180738,29422,amr,mic_nongavi
dom,Dominican Republic,2002,dtp1,92,210160,193347,16813,amr,mic_nongavi
dom,Dominican Republic,2003,dtp1,88,211318,185960,25358,amr,mic_nongavi
dom,Dominican Republic,2003,mcv1,83,211318,175394,35924,amr,mic_nongavi
dom,Dominican Republic,2003,dtp3,79,211318,166941,44377,amr,mic_nongavi
dom,Dominican Republic,2004,mcv1,81,212265,171935,40330,amr,mic_nongavi
dom,Dominican Republic,2004,dtp3,79,212265,167689,44576,amr,mic_nongavi
dom,Dominican Republic,2004,dtp1,87,212265,184671,27594,amr,mic_nongavi
dom,Dominican Republic,2005,dtp3,87,212964,185279,27685,amr,mic_nongavi
dom,Dominican Republic,2005,dtp1,92,212964,195927,17037,amr,mic_nongavi
dom,Dominican Republic,2005,mcv1,79,212964,168242,44722,amr,mic_nongavi
dom,Dominican Republic,2006,dtp3,89,213429,189952,23477,amr,mic_nongavi
dom,Dominican Republic,2006,mcv1,81,213429,172877,40552,amr,mic_nongavi
dom,Dominican Republic,2006,dtp1,93,213429,198489,14940,amr,mic_nongavi
dom,Dominican Republic,2007,mcv1,82,213722,175252,38470,amr,mic_nongavi
dom,Dominican Republic,2007,dtp3,85,213722,181664,32058,amr,mic_nongavi
dom,Dominican Republic,2007,dtp1,87,213722,185938,27784,amr,mic_nongavi
dom,Dominican Republic,2008,dtp3,82,213890,175390,38500,amr,mic_nongavi
dom,Dominican Republic,2008,dtp1,86,213890,183945,29945,amr,mic_nongavi
dom,Dominican Republic,2008,mcv1,83,213890,177529,36361,amr,mic_nongavi
dom,Dominican Republic,2009,dtp3,82,213931,175423,38508,amr,mic_nongavi
dom,Dominican Republic,2009,dtp1,85,213931,181841,32090,amr,mic_nongavi
dom,Dominican Republic,2009,mcv1,84,213931,179702,34229,amr,mic_nongavi
dom,Dominican Republic,2010,dtp1,96,213835,205282,8553,amr,mic_nongavi
dom,Dominican Republic,2010,mcv1,85,213835,181760,32075,amr,mic_nongavi
dom,Dominican Republic,2010,dtp3,88,213835,188175,25660,amr,mic_nongavi
dom,Dominican Republic,2011,dtp1,91,213576,194354,19222,amr,mic_nongavi
dom,Dominican Republic,2011,mcv1,87,213576,185811,27765,amr,mic_nongavi
dom,Dominican Republic,2011,dtp3,84,213576,179404,34172,amr,mic_nongavi
dom,Dominican Republic,2012,mcv1,88,213142,187565,25577,amr,mic_nongavi
dom,Dominican Republic,2012,dtp3,85,213142,181171,31971,amr,mic_nongavi
dom,Dominican Republic,2012,dtp1,92,213142,196091,17051,amr,mic_nongavi
dom,Dominican Republic,2013,dtp1,91,212533,193405,19128,amr,mic_nongavi
dom,Dominican Republic,2013,mcv1,83,212533,176402,36131,amr,mic_nongavi
dom,Dominican Republic,2013,dtp3,83,212533,176402,36131,amr,mic_nongavi
dom,Dominican Republic,2014,dtp3,91,211762,192703,19059,amr,mic_nongavi
dom,Dominican Republic,2014,dtp1,95,211762,201174,10588,amr,mic_nongavi
dom,Dominican Republic,2014,mcv1,88,211762,186351,25411,amr,mic_nongavi
dom,Dominican Republic,2015,dtp3,85,210852,179224,31628,amr,mic_nongavi
dom,Dominican Republic,2015,mcv1,90,210852,189767,21085,amr,mic_nongavi
dom,Dominican Republic,2015,dtp1,99,210852,208743,2109,amr,mic_nongavi
dom,Dominican Republic,2016,dtp1,98,209826,205629,4197,amr,mic_nongavi
dom,Dominican Republic,2016,dtp3,87,209826,182549,27277,amr,mic_nongavi
dom,Dominican Republic,2016,mcv1,85,209826,178352,31474,amr,mic_nongavi
dza,Algeria,2000,dtp3,86,585861,503840,82021,afr,mic_nongavi
dza,Algeria,2000,dtp1,95,585861,556568,29293,afr,mic_nongavi
dza,Algeria,2000,mcv1,80,585861,468689,117172,afr,mic_nongavi
dza,Algeria,2000,mcv2,78,722262,563364,158898,afr,mic_nongavi
dza,Algeria,2001,dtp1,92,585916,539043,46873,afr,mic_nongavi
dza,Algeria,2001,mcv1,83,585916,486310,99606,afr,mic_nongavi
dza,Algeria,2001,dtp3,89,585916,521465,64451,afr,mic_nongavi
dza,Algeria,2001,mcv2,73,698753,510090,188663,afr,mic_nongavi
dza,Algeria,2002,dtp1,93,595261,553593,41668,afr,mic_nongavi
dza,Algeria,2002,mcv1,81,595261,482161,113100,afr,mic_nongavi
dza,Algeria,2002,dtp3,86,595261,511924,83337,afr,mic_nongavi
dza,Algeria,2002,mcv2,93,669444,622583,46861,afr,mic_nongavi
dza,Algeria,2003,dtp1,93,613281,570351,42930,afr,mic_nongavi
dza,Algeria,2003,mcv1,84,613281,515156,98125,afr,mic_nongavi
dza,Algeria,2003,dtp3,87,613281,533554,79727,afr,mic_nongavi
dza,Algeria,2003,mcv2,96,638275,612744,25531,afr,mic_nongavi
dza,Algeria,2004,dtp3,86,639202,549714,89488,afr,mic_nongavi
dza,Algeria,2004,dtp1,93,639202,594458,44744,afr,mic_nongavi
dza,Algeria,2004,mcv1,81,639202,517754,121448,afr,mic_nongavi
dza,Algeria,2004,mcv2,94,609060,572516,36544,afr,mic_nongavi
dza,Algeria,2005,dtp1,94,672188,631857,40331,afr,mic_nongavi
dza,Algeria,2005,dtp3,88,672188,591525,80663,afr,mic_nongavi
dza,Algeria,2005,mcv1,83,672188,557916,114272,afr,mic_nongavi
dza,Algeria,2005,mcv2,94,586760,551554,35206,afr,mic_nongavi
dza,Algeria,2006,dtp1,98,711091,696869,14222,afr,mic_nongavi
dza,Algeria,2006,mcv1,91,711091,647093,63998,afr,mic_nongavi
dza,Algeria,2006,dtp3,95,711091,675536,35555,afr,mic_nongavi
dza,Algeria,2006,mcv2,98,573544,562073,11471,afr,mic_nongavi
dza,Algeria,2007,dtp1,98,753430,738361,15069,afr,mic_nongavi
dza,Algeria,2007,dtp3,95,753430,715759,37671,afr,mic_nongavi
dza,Algeria,2007,mcv1,92,753430,693156,60274,afr,mic_nongavi
dza,Algeria,2007,mcv2,95,567717,539331,28386,afr,mic_nongavi
dza,Algeria,2008,mcv1,88,796303,700747,95556,afr,mic_nongavi
dza,Algeria,2008,dtp1,97,796303,772414,23889,afr,mic_nongavi
dza,Algeria,2008,dtp3,93,796303,740562,55741,afr,mic_nongavi
dza,Algeria,2008,mcv2,96,569389,546613,22776,afr,mic_nongavi
dza,Algeria,2009,dtp1,98,837087,820345,16742,afr,mic_nongavi
dza,Algeria,2009,mcv1,92,837087,770120,66967,afr,mic_nongavi
dza,Algeria,2009,dtp3,95,837087,795233,41854,afr,mic_nongavi
dza,Algeria,2009,mcv2,98,578714,567140,11574,afr,mic_nongavi
dza,Algeria,2010,mcv1,95,872676,829042,43634,afr,mic_nongavi
dza,Algeria,2010,dtp3,95,872676,829042,43634,afr,mic_nongavi
dza,Algeria,2010,dtp1,99,872676,863949,8727,afr,mic_nongavi
dza,Algeria,2010,mcv2,95,595060,565307,29753,afr,mic_nongavi
dza,Algeria,2011,dtp3,95,900408,855388,45020,afr,mic_nongavi
dza,Algeria,2011,dtp1,99,900408,891404,9004,afr,mic_nongavi
dza,Algeria,2011,mcv1,95,900408,855388,45020,afr,mic_nongavi
dza,Algeria,2011,mcv2,96,623155,598229,24926,afr,mic_nongavi
dza,Algeria,2012,mcv1,95,919510,873534,45976,afr,mic_nongavi
dza,Algeria,2012,dtp3,95,919510,873534,45976,afr,mic_nongavi
dza,Algeria,2012,dtp1,99,919510,910315,9195,afr,mic_nongavi
dza,Algeria,2012,mcv2,95,665042,631790,33252,afr,mic_nongavi
dza,Algeria,2013,dtp3,95,929828,883337,46491,afr,mic_nongavi
dza,Algeria,2013,mcv1,95,929828,883337,46491,afr,mic_nongavi
dza,Algeria,2013,dtp1,99,929828,920530,9298,afr,mic_nongavi
dza,Algeria,2013,mcv2,93,714752,664719,50033,afr,mic_nongavi
dza,Algeria,2014,mcv1,95,931366,884798,46568,afr,mic_nongavi
dza,Algeria,2014,dtp3,95,931366,884798,46568,afr,mic_nongavi
dza,Algeria,2014,dtp1,99,931366,922052,9314,afr,mic_nongavi
dza,Algeria,2014,mcv2,99,766284,758621,7663,afr,mic_nongavi
dza,Algeria,2015,dtp3,95,924929,878683,46246,afr,mic_nongavi
dza,Algeria,2015,mcv1,95,924929,878683,46246,afr,mic_nongavi
dza,Algeria,2015,dtp1,99,924929,915680,9249,afr,mic_nongavi
dza,Algeria,2015,mcv2,99,811372,803258,8114,afr,mic_nongavi
dza,Algeria,2016,dtp1,96,912135,875650,36485,afr,mic_nongavi
dza,Algeria,2016,mcv1,94,912135,857407,54728,afr,mic_nongavi
dza,Algeria,2016,dtp3,91,912135,830043,82092,afr,mic_nongavi
dza,Algeria,2016,mcv2,96,851206,817158,34048,afr,mic_nongavi
ecu,Ecuador,2000,dtp1,94,304911,286616,18295,amr,mic_nongavi
ecu,Ecuador,2000,dtp3,87,304911,265273,39638,amr,mic_nongavi
ecu,Ecuador,2000,mcv1,99,304911,301862,3049,amr,mic_nongavi
ecu,Ecuador,2001,mcv1,99,305047,301997,3050,amr,mic_nongavi
ecu,Ecuador,2001,dtp1,95,305047,289795,15252,amr,mic_nongavi
ecu,Ecuador,2001,dtp3,89,305047,271492,33555,amr,mic_nongavi
ecu,Ecuador,2002,mcv1,99,305521,302466,3055,amr,mic_nongavi
ecu,Ecuador,2002,dtp3,88,305521,268858,36663,amr,mic_nongavi
ecu,Ecuador,2002,dtp1,95,305521,290245,15276,amr,mic_nongavi
ecu,Ecuador,2003,dtp3,87,306451,266612,39839,amr,mic_nongavi
ecu,Ecuador,2003,dtp1,95,306451,291128,15323,amr,mic_nongavi
ecu,Ecuador,2003,mcv1,99,306451,303386,3065,amr,mic_nongavi
ecu,Ecuador,2004,dtp1,95,307866,292473,15393,amr,mic_nongavi
ecu,Ecuador,2004,mcv1,99,307866,304787,3079,amr,mic_nongavi
ecu,Ecuador,2004,dtp3,88,307866,270922,36944,amr,mic_nongavi
ecu,Ecuador,2005,mcv1,93,309721,288041,21680,amr,mic_nongavi
ecu,Ecuador,2005,dtp1,96,309721,297332,12389,amr,mic_nongavi
ecu,Ecuador,2005,dtp3,92,309721,284943,24778,amr,mic_nongavi
ecu,Ecuador,2006,dtp1,96,311891,299415,12476,amr,mic_nongavi
ecu,Ecuador,2006,dtp3,96,311891,299415,12476,amr,mic_nongavi
ecu,Ecuador,2006,mcv1,97,311891,302534,9357,amr,mic_nongavi
ecu,Ecuador,2007,dtp1,98,314155,307872,6283,amr,mic_nongavi
ecu,Ecuador,2007,mcv1,98,314155,307872,6283,amr,mic_nongavi
ecu,Ecuador,2007,dtp3,96,314155,301589,12566,amr,mic_nongavi
ecu,Ecuador,2008,dtp3,96,316314,303661,12653,amr,mic_nongavi
ecu,Ecuador,2008,mcv1,98,316314,309988,6326,amr,mic_nongavi
ecu,Ecuador,2008,dtp1,98,316314,309988,6326,amr,mic_nongavi
ecu,Ecuador,2009,dtp1,98,318260,311895,6365,amr,mic_nongavi
ecu,Ecuador,2009,dtp3,94,318260,299164,19096,amr,mic_nongavi
ecu,Ecuador,2009,mcv1,97,318260,308712,9548,amr,mic_nongavi
ecu,Ecuador,2009,mcv2,99,302023,299003,3020,amr,mic_nongavi
ecu,Ecuador,2010,dtp1,91,319913,291121,28792,amr,mic_nongavi
ecu,Ecuador,2010,dtp3,91,319913,291121,28792,amr,mic_nongavi
ecu,Ecuador,2010,mcv1,95,319913,303917,15996,amr,mic_nongavi
ecu,Ecuador,2010,mcv2,91,302385,275170,27215,amr,mic_nongavi
ecu,Ecuador,2011,dtp3,88,321241,282692,38549,amr,mic_nongavi
ecu,Ecuador,2011,mcv1,94,321241,301967,19274,amr,mic_nongavi
ecu,Ecuador,2011,dtp1,89,321241,285904,35337,amr,mic_nongavi
ecu,Ecuador,2011,mcv2,92,304036,279713,24323,amr,mic_nongavi
ecu,Ecuador,2012,dtp3,87,322293,280395,41898,amr,mic_nongavi
ecu,Ecuador,2012,dtp1,88,322293,283618,38675,amr,mic_nongavi
ecu,Ecuador,2012,mcv1,96,322293,309401,12892,amr,mic_nongavi
ecu,Ecuador,2012,mcv2,81,306885,248577,58308,amr,mic_nongavi
ecu,Ecuador,2013,dtp3,87,323110,281106,42004,amr,mic_nongavi
ecu,Ecuador,2013,mcv1,97,323110,313417,9693,amr,mic_nongavi
ecu,Ecuador,2013,dtp1,87,323110,281106,42004,amr,mic_nongavi
ecu,Ecuador,2013,mcv2,70,310332,217232,93100,amr,mic_nongavi
ecu,Ecuador,2014,dtp1,84,323691,271900,51791,amr,mic_nongavi
ecu,Ecuador,2014,dtp3,83,323691,268664,55027,amr,mic_nongavi
ecu,Ecuador,2014,mcv1,85,323691,275137,48554,amr,mic_nongavi
ecu,Ecuador,2014,mcv2,59,313760,185118,128642,amr,mic_nongavi
ecu,Ecuador,2015,dtp3,78,324043,252754,71289,amr,mic_nongavi
ecu,Ecuador,2015,dtp1,80,324043,259234,64809,amr,mic_nongavi
ecu,Ecuador,2015,mcv1,84,324043,272196,51847,amr,mic_nongavi
ecu,Ecuador,2015,mcv2,76,316326,240408,75918,amr,mic_nongavi
ecu,Ecuador,2016,dtp1,94,324178,304727,19451,amr,mic_nongavi
ecu,Ecuador,2016,mcv1,86,324178,278793,45385,amr,mic_nongavi
ecu,Ecuador,2016,dtp3,83,324178,269068,55110,amr,mic_nongavi
ecu,Ecuador,2016,mcv2,76,318406,241989,76417,amr,mic_nongavi
egy,Egypt,2000,dtp3,98,1716703,1682369,34334,emr,mic_nongavi
egy,Egypt,2000,mcv1,98,1716703,1682369,34334,emr,mic_nongavi
egy,Egypt,2000,dtp1,98,1716703,1682369,34334,emr,mic_nongavi
egy,Egypt,2000,mcv2,97,1638062,1588920,49142,emr,mic_nongavi
egy,Egypt,2001,dtp3,99,1743711,1726274,17437,emr,mic_nongavi
egy,Egypt,2001,dtp1,99,1743711,1726274,17437,emr,mic_nongavi
egy,Egypt,2001,mcv1,97,1743711,1691400,52311,emr,mic_nongavi
egy,Egypt,2001,mcv2,99,1662062,1645441,16621,emr,mic_nongavi
egy,Egypt,2002,dtp3,97,1772020,1718859,53161,emr,mic_nongavi
egy,Egypt,2002,mcv1,97,1772020,1718859,53161,emr,mic_nongavi
egy,Egypt,2002,dtp1,98,1772020,1736580,35440,emr,mic_nongavi
egy,Egypt,2002,mcv2,96,1694148,1626382,67766,emr,mic_nongavi
egy,Egypt,2003,dtp1,98,1800918,1764900,36018,emr,mic_nongavi
egy,Egypt,2003,mcv1,98,1800918,1764900,36018,emr,mic_nongavi
egy,Egypt,2003,dtp3,98,1800918,1764900,36018,emr,mic_nongavi
egy,Egypt,2003,mcv2,97,1713185,1661789,51396,emr,mic_nongavi
egy,Egypt,2004,dtp3,97,1831232,1776295,54937,emr,mic_nongavi
egy,Egypt,2004,dtp1,98,1831232,1794607,36625,emr,mic_nongavi
egy,Egypt,2004,mcv1,97,1831232,1776295,54937,emr,mic_nongavi
egy,Egypt,2004,mcv2,96,1751073,1681030,70043,emr,mic_nongavi
egy,Egypt,2005,dtp3,98,1867722,1830368,37354,emr,mic_nongavi
egy,Egypt,2005,mcv1,98,1867722,1830368,37354,emr,mic_nongavi
egy,Egypt,2005,dtp1,98,1867722,1830368,37354,emr,mic_nongavi
egy,Egypt,2005,mcv2,97,1786479,1732885,53594,emr,mic_nongavi
egy,Egypt,2006,mcv1,98,1916859,1878522,38337,emr,mic_nongavi
egy,Egypt,2006,dtp1,98,1916859,1878522,38337,emr,mic_nongavi
egy,Egypt,2006,dtp3,98,1916859,1878522,38337,emr,mic_nongavi
egy,Egypt,2006,mcv2,97,1846933,1791525,55408,emr,mic_nongavi
egy,Egypt,2007,dtp3,98,1981839,1942202,39637,emr,mic_nongavi
egy,Egypt,2007,dtp1,98,1981839,1942202,39637,emr,mic_nongavi
egy,Egypt,2007,mcv1,97,1981839,1922384,59455,emr,mic_nongavi
egy,Egypt,2007,mcv2,97,1907369,1850148,57221,emr,mic_nongavi
egy,Egypt,2008,dtp3,97,2062332,2000462,61870,emr,mic_nongavi
egy,Egypt,2008,dtp1,98,2062332,2021085,41247,emr,mic_nongavi
egy,Egypt,2008,mcv1,92,2062332,1897345,164987,emr,mic_nongavi
egy,Egypt,2008,mcv2,96,1872139,1797253,74886,emr,mic_nongavi
egy,Egypt,2009,dtp3,97,2154622,2089983,64639,emr,mic_nongavi
egy,Egypt,2009,dtp1,97,2154622,2089983,64639,emr,mic_nongavi
egy,Egypt,2009,mcv1,95,2154622,2046891,107731,emr,mic_nongavi
egy,Egypt,2009,mcv2,96,1915947,1839309,76638,emr,mic_nongavi
egy,Egypt,2010,dtp3,97,2250668,2183148,67520,emr,mic_nongavi
egy,Egypt,2010,dtp1,97,2250668,2183148,67520,emr,mic_nongavi
egy,Egypt,2010,mcv1,96,2250668,2160641,90027,emr,mic_nongavi
egy,Egypt,2010,mcv2,97,1978544,1919188,59356,emr,mic_nongavi
egy,Egypt,2011,mcv1,96,2340160,2246554,93606,emr,mic_nongavi
egy,Egypt,2011,dtp3,96,2340160,2246554,93606,emr,mic_nongavi
egy,Egypt,2011,dtp1,97,2340160,2269955,70205,emr,mic_nongavi
egy,Egypt,2011,mcv2,97,2011451,1951107,60344,emr,mic_nongavi
egy,Egypt,2012,dtp3,93,2413901,2244928,168973,emr,mic_nongavi
egy,Egypt,2012,dtp1,94,2413901,2269067,144834,emr,mic_nongavi
egy,Egypt,2012,mcv1,93,2413901,2244928,168973,emr,mic_nongavi
egy,Egypt,2012,mcv2,92,2057108,1892539,164569,emr,mic_nongavi
egy,Egypt,2013,dtp3,97,2465578,2391611,73967,emr,mic_nongavi
egy,Egypt,2013,dtp1,97,2465578,2391611,73967,emr,mic_nongavi
egy,Egypt,2013,mcv1,96,2465578,2366955,98623,emr,mic_nongavi
egy,Egypt,2013,mcv2,96,2279755,2188565,91190,emr,mic_nongavi
egy,Egypt,2014,mcv1,93,2493016,2318505,174511,emr,mic_nongavi
egy,Egypt,2014,dtp3,94,2493016,2343435,149581,emr,mic_nongavi
egy,Egypt,2014,dtp1,96,2493016,2393295,99721,emr,mic_nongavi
egy,Egypt,2014,mcv2,93,2375429,2209149,166280,emr,mic_nongavi
egy,Egypt,2015,dtp3,93,2497061,2322267,174794,emr,mic_nongavi
egy,Egypt,2015,mcv1,92,2497061,2297296,199765,emr,mic_nongavi
egy,Egypt,2015,dtp1,94,2497061,2347237,149824,emr,mic_nongavi
egy,Egypt,2015,mcv2,92,2448981,2253063,195918,emr,mic_nongavi
egy,Egypt,2016,mcv1,95,2482003,2357903,124100,emr,mic_nongavi
egy,Egypt,2016,dtp1,96,2482003,2382723,99280,emr,mic_nongavi
egy,Egypt,2016,dtp3,95,2482003,2357903,124100,emr,mic_nongavi
egy,Egypt,2016,mcv2,96,2597270,2493379,103891,emr,mic_nongavi
eri,Eritrea,2000,dtp1,88,113166,99586,13580,afr,gavi
eri,Eritrea,2000,dtp3,81,113166,91664,21502,afr,gavi
eri,Eritrea,2000,mcv1,76,113166,86006,27160,afr,gavi
eri,Eritrea,2001,dtp3,86,117123,100726,16397,afr,gavi
eri,Eritrea,2001,dtp1,91,117123,106582,10541,afr,gavi
eri,Eritrea,2001,mcv1,84,117123,98383,18740,afr,gavi
eri,Eritrea,2002,dtp1,94,121662,114362,7300,afr,gavi
eri,Eritrea,2002,dtp3,90,121662,109496,12166,afr,gavi
eri,Eritrea,2002,mcv1,83,121662,100979,20683,afr,gavi
eri,Eritrea,2003,dtp3,93,126474,117621,8853,afr,gavi
eri,Eritrea,2003,dtp1,97,126474,122680,3794,afr,gavi
eri,Eritrea,2003,mcv1,92,126474,116356,10118,afr,gavi
eri,Eritrea,2004,mcv1,96,131318,126065,5253,afr,gavi
eri,Eritrea,2004,dtp3,98,131318,128692,2626,afr,gavi
eri,Eritrea,2004,dtp1,99,131318,130005,1313,afr,gavi
eri,Eritrea,2005,mcv1,95,135912,129116,6796,afr,gavi
eri,Eritrea,2005,dtp3,96,135912,130476,5436,afr,gavi
eri,Eritrea,2005,dtp1,99,135912,134553,1359,afr,gavi
eri,Eritrea,2006,mcv1,95,140011,133010,7001,afr,gavi
eri,Eritrea,2006,dtp1,97,140011,135811,4200,afr,gavi
eri,Eritrea,2006,dtp3,94,140011,131610,8401,afr,gavi
eri,Eritrea,2007,dtp1,95,143517,136341,7176,afr,gavi
eri,Eritrea,2007,dtp3,91,143517,130600,12917,afr,gavi
eri,Eritrea,2007,mcv1,97,143517,139211,4306,afr,gavi
eri,Eritrea,2008,dtp1,98,146379,143451,2928,afr,gavi
eri,Eritrea,2008,mcv1,97,146379,141988,4391,afr,gavi
eri,Eritrea,2008,dtp3,94,146379,137596,8783,afr,gavi
eri,Eritrea,2009,dtp3,92,148563,136678,11885,afr,gavi
eri,Eritrea,2009,dtp1,96,148563,142620,5943,afr,gavi
eri,Eritrea,2009,mcv1,99,148563,147077,1486,afr,gavi
eri,Eritrea,2010,dtp1,96,150096,144092,6004,afr,gavi
eri,Eritrea,2010,dtp3,90,150096,135086,15010,afr,gavi
eri,Eritrea,2010,mcv1,99,150096,148595,1501,afr,gavi
eri,Eritrea,2011,mcv1,99,151086,149575,1511,afr,gavi
eri,Eritrea,2011,dtp3,96,151086,145043,6043,afr,gavi
eri,Eritrea,2011,dtp1,99,151086,149575,1511,afr,gavi
eri,Eritrea,2012,dtp1,97,151748,147196,4552,afr,gavi
eri,Eritrea,2012,mcv1,98,151748,148713,3035,afr,gavi
eri,Eritrea,2012,dtp3,94,151748,142643,9105,afr,gavi
eri,Eritrea,2013,dtp3,94,152280,143143,9137,afr,gavi
eri,Eritrea,2013,dtp1,97,152280,147712,4568,afr,gavi
eri,Eritrea,2013,mcv1,94,152280,143143,9137,afr,gavi
eri,Eritrea,2014,dtp1,97,152794,148210,4584,afr,gavi
eri,Eritrea,2014,mcv1,90,152794,137515,15279,afr,gavi
eri,Eritrea,2014,dtp3,94,152794,143626,9168,afr,gavi
eri,Eritrea,2015,dtp3,95,153375,145706,7669,afr,gavi
eri,Eritrea,2015,dtp1,98,153375,150308,3067,afr,gavi
eri,Eritrea,2015,mcv1,85,153375,130369,23006,afr,gavi
eri,Eritrea,2015,mcv2,75,149718,112288,37430,afr,gavi
eri,Eritrea,2016,dtp3,95,154056,146353,7703,afr,gavi
eri,Eritrea,2016,mcv1,93,154056,143272,10784,afr,gavi
eri,Eritrea,2016,dtp1,97,154056,149434,4622,afr,gavi
eri,Eritrea,2016,mcv2,85,148908,126572,22336,afr,gavi
esp,Spain,2000,mcv1,94,400933,376877,24056,eur,hic
esp,Spain,2000,dtp1,98,400933,392914,8019,eur,hic
esp,Spain,2000,dtp3,95,400933,380886,20047,eur,hic
esp,Spain,2001,dtp1,98,413237,404972,8265,eur,hic
esp,Spain,2001,dtp3,96,413237,396708,16529,eur,hic
esp,Spain,2001,mcv1,96,413237,396708,16529,eur,hic
esp,Spain,2002,dtp1,99,426998,422728,4270,eur,hic
esp,Spain,2002,dtp3,98,426998,418458,8540,eur,hic
esp,Spain,2002,mcv1,97,426998,414188,12810,eur,hic
esp,Spain,2003,dtp3,98,441122,432300,8822,eur,hic
esp,Spain,2003,mcv1,98,441122,432300,8822,eur,hic
esp,Spain,2003,dtp1,99,441122,436711,4411,eur,hic
esp,Spain,2004,dtp3,97,454565,440928,13637,eur,hic
esp,Spain,2004,dtp1,99,454565,450019,4546,eur,hic
esp,Spain,2004,mcv1,97,454565,440928,13637,eur,hic
esp,Spain,2004,mcv2,91,406327,369758,36569,eur,hic
esp,Spain,2005,dtp3,96,465918,447281,18637,eur,hic
esp,Spain,2005,dtp1,98,465918,456600,9318,eur,hic
esp,Spain,2005,mcv1,97,465918,451940,13978,eur,hic
esp,Spain,2005,mcv2,92,419122,385592,33530,eur,hic
esp,Spain,2006,dtp3,98,473840,464363,9477,eur,hic
esp,Spain,2006,dtp1,99,473840,469102,4738,eur,hic
esp,Spain,2006,mcv1,97,473840,459625,14215,eur,hic
esp,Spain,2006,mcv2,94,440491,414062,26429,eur,hic
esp,Spain,2007,dtp3,96,477803,458691,19112,eur,hic
esp,Spain,2007,mcv1,97,477803,463469,14334,eur,hic
esp,Spain,2007,dtp1,98,477803,468247,9556,eur,hic
esp,Spain,2007,mcv2,95,462732,439595,23137,eur,hic
esp,Spain,2008,dtp1,99,477660,472883,4777,eur,hic
esp,Spain,2008,mcv1,98,477660,468107,9553,eur,hic
esp,Spain,2008,dtp3,97,477660,463330,14330,eur,hic
esp,Spain,2008,mcv2,94,482166,453236,28930,eur,hic
esp,Spain,2009,dtp3,96,473502,454562,18940,eur,hic
esp,Spain,2009,dtp1,98,473502,464032,9470,eur,hic
esp,Spain,2009,mcv1,98,473502,464032,9470,eur,hic
esp,Spain,2009,mcv2,90,487273,438546,48727,eur,hic
esp,Spain,2010,dtp3,97,465880,451904,13976,eur,hic
esp,Spain,2010,mcv1,95,465880,442586,23294,eur,hic
esp,Spain,2010,dtp1,99,465880,461221,4659,eur,hic
esp,Spain,2010,mcv2,92,493749,454249,39500,eur,hic
esp,Spain,2011,dtp3,97,455766,442093,13673,eur,hic
esp,Spain,2011,dtp1,99,455766,451208,4558,eur,hic
esp,Spain,2011,mcv1,97,455766,442093,13673,eur,hic
esp,Spain,2011,mcv2,91,498211,453372,44839,eur,hic
esp,Spain,2012,dtp3,97,444548,431212,13336,eur,hic
esp,Spain,2012,mcv1,97,444548,431212,13336,eur,hic
esp,Spain,2012,dtp1,99,444548,440103,4445,eur,hic
esp,Spain,2012,mcv2,90,497536,447782,49754,eur,hic
esp,Spain,2013,dtp3,96,433431,416094,17337,eur,hic
esp,Spain,2013,mcv1,95,433431,411759,21672,eur,hic
esp,Spain,2013,dtp1,98,433431,424762,8669,eur,hic
esp,Spain,2013,mcv2,91,491524,447287,44237,eur,hic
esp,Spain,2014,dtp3,97,423085,410392,12693,eur,hic
esp,Spain,2014,mcv1,96,423085,406162,16923,eur,hic
esp,Spain,2014,dtp1,99,423085,418854,4231,eur,hic
esp,Spain,2014,mcv2,93,475782,442477,33305,eur,hic
esp,Spain,2015,dtp3,97,413862,401446,12416,eur,hic
esp,Spain,2015,mcv1,96,413862,397308,16554,eur,hic
esp,Spain,2015,dtp1,99,413862,409723,4139,eur,hic
esp,Spain,2015,mcv2,94,463210,435417,27793,eur,hic
esp,Spain,2016,dtp1,99,405719,401662,4057,eur,hic
esp,Spain,2016,mcv1,97,405719,393547,12172,eur,hic
esp,Spain,2016,dtp3,97,405719,393547,12172,eur,hic
esp,Spain,2016,mcv2,95,439428,417457,21971,eur,hic
est,Estonia,2000,dtp3,93,12569,11689,880,eur,hic
est,Estonia,2000,mcv1,93,12569,11689,880,eur,hic
est,Estonia,2000,dtp1,96,12569,12066,503,eur,hic
est,Estonia,2000,mcv2,89,11945,10631,1314,eur,hic
est,Estonia,2001,mcv1,95,12764,12126,638,eur,hic
est,Estonia,2001,dtp3,94,12764,11998,766,eur,hic
est,Estonia,2001,dtp1,99,12764,12636,128,eur,hic
est,Estonia,2001,mcv2,84,21482,18045,3437,eur,hic
est,Estonia,2002,dtp3,94,13095,12309,786,eur,hic
est,Estonia,2002,dtp1,99,13095,12964,131,eur,hic
est,Estonia,2002,mcv1,95,13095,12440,655,eur,hic
est,Estonia,2002,mcv2,94,20598,19362,1236,eur,hic
est,Estonia,2003,dtp3,94,13521,12710,811,eur,hic
est,Estonia,2003,mcv1,95,13521,12845,676,eur,hic
est,Estonia,2003,dtp1,99,13521,13386,135,eur,hic
est,Estonia,2003,mcv2,96,20513,19692,821,eur,hic
est,Estonia,2004,dtp1,98,13995,13715,280,eur,hic
est,Estonia,2004,mcv1,96,13995,13435,560,eur,hic
est,Estonia,2004,dtp3,94,13995,13155,840,eur,hic
est,Estonia,2004,mcv2,97,19197,18621,576,eur,hic
est,Estonia,2005,dtp1,99,14449,14305,144,eur,hic
est,Estonia,2005,dtp3,96,14449,13871,578,eur,hic
est,Estonia,2005,mcv1,96,14449,13871,578,eur,hic
est,Estonia,2005,mcv2,98,17964,17605,359,eur,hic
est,Estonia,2006,dtp1,98,14820,14524,296,eur,hic
est,Estonia,2006,dtp3,95,14820,14079,741,eur,hic
est,Estonia,2006,mcv1,96,14820,14227,593,eur,hic
est,Estonia,2006,mcv2,98,16698,16364,334,eur,hic
est,Estonia,2007,dtp1,98,15070,14769,301,eur,hic
est,Estonia,2007,dtp3,95,15070,14316,754,eur,hic
est,Estonia,2007,mcv1,96,15070,14467,603,eur,hic
est,Estonia,2007,mcv2,96,15511,14891,620,eur,hic
est,Estonia,2008,dtp3,95,15182,14423,759,eur,hic
est,Estonia,2008,mcv1,95,15182,14423,759,eur,hic
est,Estonia,2008,dtp1,97,15182,14727,455,eur,hic
est,Estonia,2008,mcv2,97,14489,14054,435,eur,hic
est,Estonia,2009,dtp3,95,15150,14392,758,eur,hic
est,Estonia,2009,dtp1,97,15150,14695,455,eur,hic
est,Estonia,2009,mcv1,95,15150,14392,758,eur,hic
est,Estonia,2009,mcv2,96,13611,13067,544,eur,hic
est,Estonia,2010,mcv1,95,14997,14247,750,eur,hic
est,Estonia,2010,dtp3,94,14997,14097,900,eur,hic
est,Estonia,2010,dtp1,96,14997,14397,600,eur,hic
est,Estonia,2010,mcv2,95,12737,12100,637,eur,hic
est,Estonia,2011,mcv1,94,14769,13883,886,eur,hic
est,Estonia,2011,dtp1,96,14769,14178,591,eur,hic
est,Estonia,2011,dtp3,93,14769,13735,1034,eur,hic
est,Estonia,2011,mcv2,95,11844,11252,592,eur,hic
est,Estonia,2012,dtp1,96,14526,13945,581,eur,hic
est,Estonia,2012,mcv1,94,14526,13654,872,eur,hic
est,Estonia,2012,dtp3,94,14526,13654,872,eur,hic
est,Estonia,2012,mcv2,94,11288,10611,677,eur,hic
est,Estonia,2013,dtp1,96,14317,13744,573,eur,hic
est,Estonia,2013,mcv1,94,14317,13458,859,eur,hic
est,Estonia,2013,dtp3,94,14317,13458,859,eur,hic
est,Estonia,2013,mcv2,92,11587,10660,927,eur,hic
est,Estonia,2014,dtp3,93,14156,13165,991,eur,hic
est,Estonia,2014,dtp1,95,14156,13448,708,eur,hic
est,Estonia,2014,mcv1,93,14156,13165,991,eur,hic
est,Estonia,2014,mcv2,93,11897,11064,833,eur,hic
est,Estonia,2015,mcv1,93,14047,13064,983,eur,hic
est,Estonia,2015,dtp3,93,14047,13064,983,eur,hic
est,Estonia,2015,dtp1,94,14047,13204,843,eur,hic
est,Estonia,2015,mcv2,92,12222,11244,978,eur,hic
est,Estonia,2016,dtp3,93,13972,12994,978,eur,hic
est,Estonia,2016,dtp1,94,13972,13134,838,eur,hic
est,Estonia,2016,mcv1,93,13972,12994,978,eur,hic
est,Estonia,2016,mcv2,92,12699,11683,1016,eur,hic
eth,Ethiopia,2000,dtp1,47,2659911,1250158,1409753,afr,gavi
eth,Ethiopia,2000,dtp3,30,2659911,797973,1861938,afr,gavi
eth,Ethiopia,2000,mcv1,36,2659911,957568,1702343,afr,gavi
eth,Ethiopia,2001,dtp1,50,2693010,1346505,1346505,afr,gavi
eth,Ethiopia,2001,mcv1,35,2693010,942553,1750457,afr,gavi
eth,Ethiopia,2001,dtp3,32,2693010,861763,1831247,afr,gavi
eth,Ethiopia,2002,dtp3,35,2718589,951506,1767083,afr,gavi
eth,Ethiopia,2002,mcv1,36,2718589,978692,1739897,afr,gavi
eth,Ethiopia,2002,dtp1,52,2718589,1413666,1304923,afr,gavi
eth,Ethiopia,2003,dtp1,55,2738854,1506370,1232484,afr,gavi
eth,Ethiopia,2003,dtp3,37,2738854,1013376,1725478,afr,gavi
eth,Ethiopia,2003,mcv1,35,2738854,958599,1780255,afr,gavi
eth,Ethiopia,2004,dtp3,40,2755667,1102267,1653400,afr,gavi
eth,Ethiopia,2004,dtp1,58,2755667,1598287,1157380,afr,gavi
eth,Ethiopia,2004,mcv1,35,2755667,964483,1791184,afr,gavi
eth,Ethiopia,2005,dtp3,44,2771678,1219538,1552140,afr,gavi
eth,Ethiopia,2005,dtp1,61,2771678,1690724,1080954,afr,gavi
eth,Ethiopia,2005,mcv1,40,2771678,1108671,1663007,afr,gavi
eth,Ethiopia,2006,dtp1,64,2789620,1785357,1004263,afr,gavi
eth,Ethiopia,2006,mcv1,44,2789620,1227433,1562187,afr,gavi
eth,Ethiopia,2006,dtp3,46,2789620,1283225,1506395,afr,gavi
eth,Ethiopia,2007,mcv1,49,2811209,1377492,1433717,afr,gavi
eth,Ethiopia,2007,dtp1,67,2811209,1883510,927699,afr,gavi
eth,Ethiopia,2007,dtp3,50,2811209,1405605,1405604,afr,gavi
eth,Ethiopia,2008,dtp1,71,2837513,2014634,822879,afr,gavi
eth,Ethiopia,2008,mcv1,54,2837513,1532257,1305256,afr,gavi
eth,Ethiopia,2008,dtp3,54,2837513,1532257,1305256,afr,gavi
eth,Ethiopia,2009,dtp1,74,2868978,2123044,745934,afr,gavi
eth,Ethiopia,2009,mcv1,59,2868978,1692697,1176281,afr,gavi
eth,Ethiopia,2009,dtp3,58,2868978,1664007,1204971,afr,gavi
eth,Ethiopia,2010,dtp1,77,2905179,2236988,668191,afr,gavi
eth,Ethiopia,2010,mcv1,64,2905179,1859315,1045864,afr,gavi
eth,Ethiopia,2010,dtp3,61,2905179,1772159,1133020,afr,gavi
eth,Ethiopia,2011,dtp1,80,2944774,2355819,588955,afr,gavi
eth,Ethiopia,2011,mcv1,68,2944774,2002446,942328,afr,gavi
eth,Ethiopia,2011,dtp3,65,2944774,1914103,1030671,afr,gavi
eth,Ethiopia,2012,dtp1,82,2985386,2448017,537369,afr,gavi
eth,Ethiopia,2012,dtp3,69,2985386,2059916,925470,afr,gavi
eth,Ethiopia,2012,mcv1,65,2985386,1940501,1044885,afr,gavi
eth,Ethiopia,2013,dtp3,72,3024977,2177983,846994,afr,gavi
eth,Ethiopia,2013,dtp1,84,3024977,2540981,483996,afr,gavi
eth,Ethiopia,2013,mcv1,62,3024977,1875486,1149491,afr,gavi
eth,Ethiopia,2014,mcv1,70,3062556,2143789,918767,afr,gavi
eth,Ethiopia,2014,dtp1,86,3062556,2633798,428758,afr,gavi
eth,Ethiopia,2014,dtp3,77,3062556,2358168,704388,afr,gavi
eth,Ethiopia,2015,dtp3,77,3097581,2385137,712444,afr,gavi
eth,Ethiopia,2015,mcv1,70,3097581,2168307,929274,afr,gavi
eth,Ethiopia,2015,dtp1,86,3097581,2663920,433661,afr,gavi
eth,Ethiopia,2016,dtp1,86,3130076,2691865,438211,afr,gavi
eth,Ethiopia,2016,mcv1,70,3130076,2191053,939023,afr,gavi
eth,Ethiopia,2016,dtp3,77,3130076,2410159,719917,afr,gavi
fin,Finland,2000,dtp3,99,57339,56766,573,eur,hic
fin,Finland,2000,dtp1,99,57339,56766,573,eur,hic
fin,Finland,2000,mcv1,96,57339,55045,2294,eur,hic
fin,Finland,2001,dtp1,99,57084,56513,571,eur,hic
fin,Finland,2001,mcv1,96,57084,54801,2283,eur,hic
fin,Finland,2001,dtp3,98,57084,55942,1142,eur,hic
fin,Finland,2002,dtp1,99,57096,56525,571,eur,hic
fin,Finland,2002,mcv1,96,57096,54812,2284,eur,hic
fin,Finland,2002,dtp3,98,57096,55954,1142,eur,hic
fin,Finland,2003,mcv1,97,57311,55592,1719,eur,hic
fin,Finland,2003,dtp1,98,57311,56165,1146,eur,hic
fin,Finland,2003,dtp3,98,57311,56165,1146,eur,hic
fin,Finland,2004,dtp1,98,57680,56526,1154,eur,hic
fin,Finland,2004,dtp3,98,57680,56526,1154,eur,hic
fin,Finland,2004,mcv1,97,57680,55950,1730,eur,hic
fin,Finland,2005,dtp3,97,58122,56378,1744,eur,hic
fin,Finland,2005,dtp1,99,58122,57541,581,eur,hic
fin,Finland,2005,mcv1,97,58122,56378,1744,eur,hic
fin,Finland,2006,dtp1,99,58540,57955,585,eur,hic
fin,Finland,2006,dtp3,97,58540,56784,1756,eur,hic
fin,Finland,2006,mcv1,97,58540,56784,1756,eur,hic
fin,Finland,2007,dtp3,99,58862,58273,589,eur,hic
fin,Finland,2007,dtp1,99,58862,58273,589,eur,hic
fin,Finland,2007,mcv1,98,58862,57685,1177,eur,hic
fin,Finland,2008,dtp3,99,59048,58458,590,eur,hic
fin,Finland,2008,dtp1,99,59048,58458,590,eur,hic
fin,Finland,2008,mcv1,97,59048,57277,1771,eur,hic
fin,Finland,2009,dtp3,99,59082,58491,591,eur,hic
fin,Finland,2009,mcv1,98,59082,57900,1182,eur,hic
fin,Finland,2009,dtp1,99,59082,58491,591,eur,hic
fin,Finland,2010,dtp3,99,58999,58409,590,eur,hic
fin,Finland,2010,dtp1,99,58999,58409,590,eur,hic
fin,Finland,2010,mcv1,98,58999,57819,1180,eur,hic
fin,Finland,2011,dtp3,99,58867,58278,589,eur,hic
fin,Finland,2011,dtp1,99,58867,58278,589,eur,hic
fin,Finland,2011,mcv1,97,58867,57101,1766,eur,hic
fin,Finland,2012,mcv1,97,58773,57010,1763,eur,hic
fin,Finland,2012,dtp1,99,58773,58185,588,eur,hic
fin,Finland,2012,dtp3,99,58773,58185,588,eur,hic
fin,Finland,2013,mcv1,97,58774,57011,1763,eur,hic
fin,Finland,2013,dtp3,98,58774,57599,1175,eur,hic
fin,Finland,2013,dtp1,99,58774,58186,588,eur,hic
fin,Finland,2014,mcv1,96,58887,56532,2355,eur,hic
fin,Finland,2014,dtp3,98,58887,57709,1178,eur,hic
fin,Finland,2014,dtp1,99,58887,58298,589,eur,hic
fin,Finland,2015,mcv1,95,59098,56143,2955,eur,hic
fin,Finland,2015,dtp3,97,59098,57325,1773,eur,hic
fin,Finland,2015,dtp1,99,59098,58507,591,eur,hic
fin,Finland,2016,dtp1,99,59372,58778,594,eur,hic
fin,Finland,2016,mcv1,94,59372,55810,3562,eur,hic
fin,Finland,2016,dtp3,92,59372,54622,4750,eur,hic
fin,Finland,2016,mcv2,85,62223,52890,9333,eur,hic
fji,Fiji,2000,dtp3,90,19549,17594,1955,wpr,mic_nongavi
fji,Fiji,2000,dtp1,97,19549,18963,586,wpr,mic_nongavi
fji,Fiji,2000,mcv1,81,19549,15835,3714,wpr,mic_nongavi
fji,Fiji,2001,dtp3,91,19408,17661,1747,wpr,mic_nongavi
fji,Fiji,2001,dtp1,97,19408,18826,582,wpr,mic_nongavi
fji,Fiji,2001,mcv1,83,19408,16109,3299,wpr,mic_nongavi
fji,Fiji,2002,dtp1,98,19271,18886,385,wpr,mic_nongavi
fji,Fiji,2002,mcv1,85,19271,16380,2891,wpr,mic_nongavi
fji,Fiji,2002,dtp3,93,19271,17922,1349,wpr,mic_nongavi
fji,Fiji,2003,mcv1,86,19135,16456,2679,wpr,mic_nongavi
fji,Fiji,2003,dtp1,98,19135,18752,383,wpr,mic_nongavi
fji,Fiji,2003,dtp3,94,19135,17987,1148,wpr,mic_nongavi
fji,Fiji,2004,dtp1,99,19000,18810,190,wpr,mic_nongavi
fji,Fiji,2004,mcv1,88,19000,16720,2280,wpr,mic_nongavi
fji,Fiji,2004,dtp3,95,19000,18050,950,wpr,mic_nongavi
fji,Fiji,2005,dtp3,96,18865,18110,755,wpr,mic_nongavi
fji,Fiji,2005,dtp1,99,18865,18676,189,wpr,mic_nongavi
fji,Fiji,2005,mcv1,90,18865,16978,1887,wpr,mic_nongavi
fji,Fiji,2005,mcv2,74,16406,12140,4266,wpr,mic_nongavi
fji,Fiji,2006,dtp3,98,18733,18358,375,wpr,mic_nongavi
fji,Fiji,2006,dtp1,99,18733,18546,187,wpr,mic_nongavi
fji,Fiji,2006,mcv1,92,18733,17234,1499,wpr,mic_nongavi
fji,Fiji,2006,mcv2,94,16373,15391,982,wpr,mic_nongavi
fji,Fiji,2007,dtp3,99,18600,18414,186,wpr,mic_nongavi
fji,Fiji,2007,dtp1,99,18600,18414,186,wpr,mic_nongavi
fji,Fiji,2007,mcv1,94,18600,17484,1116,wpr,mic_nongavi
fji,Fiji,2007,mcv2,94,16403,15419,984,wpr,mic_nongavi
fji,Fiji,2008,dtp3,99,18466,18281,185,wpr,mic_nongavi
fji,Fiji,2008,dtp1,99,18466,18281,185,wpr,mic_nongavi
fji,Fiji,2008,mcv1,94,18466,17358,1108,wpr,mic_nongavi
fji,Fiji,2008,mcv2,94,16452,15465,987,wpr,mic_nongavi
fji,Fiji,2009,dtp1,99,18331,18148,183,wpr,mic_nongavi
fji,Fiji,2009,mcv1,94,18331,17231,1100,wpr,mic_nongavi
fji,Fiji,2009,dtp3,99,18331,18148,183,wpr,mic_nongavi
fji,Fiji,2009,mcv2,94,16479,15490,989,wpr,mic_nongavi
fji,Fiji,2010,dtp1,99,18192,18010,182,wpr,mic_nongavi
fji,Fiji,2010,mcv1,94,18192,17100,1092,wpr,mic_nongavi
fji,Fiji,2010,dtp3,99,18192,18010,182,wpr,mic_nongavi
fji,Fiji,2010,mcv2,94,16437,15451,986,wpr,mic_nongavi
fji,Fiji,2011,dtp3,99,18044,17864,180,wpr,mic_nongavi
fji,Fiji,2011,mcv1,94,18044,16961,1083,wpr,mic_nongavi
fji,Fiji,2011,dtp1,99,18044,17864,180,wpr,mic_nongavi
fji,Fiji,2011,mcv2,94,16716,15713,1003,wpr,mic_nongavi
fji,Fiji,2012,dtp3,99,17887,17708,179,wpr,mic_nongavi
fji,Fiji,2012,mcv1,94,17887,16814,1073,wpr,mic_nongavi
fji,Fiji,2012,dtp1,99,17887,17708,179,wpr,mic_nongavi
fji,Fiji,2012,mcv2,94,17060,16036,1024,wpr,mic_nongavi
fji,Fiji,2013,dtp3,99,17720,17543,177,wpr,mic_nongavi
fji,Fiji,2013,mcv1,94,17720,16657,1063,wpr,mic_nongavi
fji,Fiji,2013,dtp1,99,17720,17543,177,wpr,mic_nongavi
fji,Fiji,2013,mcv2,94,17408,16364,1044,wpr,mic_nongavi
fji,Fiji,2014,dtp3,99,17547,17372,175,wpr,mic_nongavi
fji,Fiji,2014,dtp1,99,17547,17372,175,wpr,mic_nongavi
fji,Fiji,2014,mcv1,94,17547,16494,1053,wpr,mic_nongavi
fji,Fiji,2014,mcv2,94,17706,16644,1062,wpr,mic_nongavi
fji,Fiji,2015,dtp3,99,17367,17193,174,wpr,mic_nongavi
fji,Fiji,2015,mcv1,94,17367,16325,1042,wpr,mic_nongavi
fji,Fiji,2015,dtp1,99,17367,17193,174,wpr,mic_nongavi
fji,Fiji,2015,mcv2,94,17882,16809,1073,wpr,mic_nongavi
fji,Fiji,2016,mcv1,94,17186,16155,1031,wpr,mic_nongavi
fji,Fiji,2016,dtp1,99,17186,17014,172,wpr,mic_nongavi
fji,Fiji,2016,dtp3,99,17186,17014,172,wpr,mic_nongavi
fji,Fiji,2016,mcv2,94,17951,16874,1077,wpr,mic_nongavi
fra,France,2000,mcv1,84,749321,629430,119891,eur,hic
fra,France,2000,dtp1,99,749321,741828,7493,eur,hic
fra,France,2000,dtp3,97,749321,726841,22480,eur,hic
fra,France,2001,dtp1,99,755382,747828,7554,eur,hic
fra,France,2001,dtp3,97,755382,732721,22661,eur,hic
fra,France,2001,mcv1,85,755382,642075,113307,eur,hic
fra,France,2002,dtp3,97,761460,738616,22844,eur,hic
fra,France,2002,dtp1,99,761460,753845,7615,eur,hic
fra,France,2002,mcv1,86,761460,654856,106604,eur,hic
fra,France,2003,dtp1,99,767338,759665,7673,eur,hic
fra,France,2003,dtp3,97,767338,744318,23020,eur,hic
fra,France,2003,mcv1,87,767338,667584,99754,eur,hic
fra,France,2004,dtp1,99,772705,764978,7727,eur,hic
fra,France,2004,dtp3,98,772705,757251,15454,eur,hic
fra,France,2004,mcv1,88,772705,679980,92725,eur,hic
fra,France,2005,dtp1,99,777158,769386,7772,eur,hic
fra,France,2005,dtp3,98,777158,761615,15543,eur,hic
fra,France,2005,mcv1,87,777158,676127,101031,eur,hic
fra,France,2006,dtp3,99,780336,772533,7803,eur,hic
fra,France,2006,mcv1,89,780336,694499,85837,eur,hic
fra,France,2006,dtp1,99,780336,772533,7803,eur,hic
fra,France,2007,dtp3,98,782139,766496,15643,eur,hic
fra,France,2007,dtp1,99,782139,774318,7821,eur,hic
fra,France,2007,mcv1,90,782139,703925,78214,eur,hic
fra,France,2008,dtp1,99,782580,774754,7826,eur,hic
fra,France,2008,dtp3,98,782580,766928,15652,eur,hic
fra,France,2008,mcv1,89,782580,696496,86084,eur,hic
fra,France,2009,dtp3,98,781716,766082,15634,eur,hic
fra,France,2009,mcv1,89,781716,695727,85989,eur,hic
fra,France,2009,dtp1,99,781716,773899,7817,eur,hic
fra,France,2010,dtp3,99,779707,771910,7797,eur,hic
fra,France,2010,mcv1,89,779707,693939,85768,eur,hic
fra,France,2010,dtp1,99,779707,771910,7797,eur,hic
fra,France,2010,mcv2,67,789424,528914,260510,eur,hic
fra,France,2011,dtp3,99,776815,769047,7768,eur,hic
fra,France,2011,dtp1,99,776815,769047,7768,eur,hic
fra,France,2011,mcv1,89,776815,691365,85450,eur,hic
fra,France,2011,mcv2,67,790226,529451,260775,eur,hic
fra,France,2012,dtp3,99,773442,765708,7734,eur,hic
fra,France,2012,mcv1,90,773442,696098,77344,eur,hic
fra,France,2012,dtp1,99,773442,765708,7734,eur,hic
fra,France,2012,mcv2,72,789374,568349,221025,eur,hic
fra,France,2013,mcv1,89,769968,685272,84696,eur,hic
fra,France,2013,dtp3,99,769968,762268,7700,eur,hic
fra,France,2013,dtp1,99,769968,762268,7700,eur,hic
fra,France,2013,mcv2,67,784904,525886,259018,eur,hic
fra,France,2014,mcv1,91,766649,697651,68998,eur,hic
fra,France,2014,dtp3,98,766649,751316,15333,eur,hic
fra,France,2014,dtp1,99,766649,758983,7666,eur,hic
fra,France,2014,mcv2,77,780995,601366,179629,eur,hic
fra,France,2015,mcv1,91,763665,694935,68730,eur,hic
fra,France,2015,dtp1,99,763665,756028,7637,eur,hic
fra,France,2015,dtp3,98,763665,748392,15273,eur,hic
fra,France,2015,mcv2,78,776753,605867,170886,eur,hic
fra,France,2016,mcv1,90,761078,684970,76108,eur,hic
fra,France,2016,dtp1,99,761078,753467,7611,eur,hic
fra,France,2016,dtp3,97,761078,738246,22832,eur,hic
fra,France,2016,mcv2,79,768566,607167,161399,eur,hic
fsm,Micronesia (Federated States of ),2000,dtp3,85,3097,2632,465,wpr,mic_nongavi
fsm,Micronesia (Federated States of ),2000,mcv1,85,3097,2632,465,wpr,mic_nongavi
fsm,Micronesia (Federated States of ),2000,dtp1,92,3097,2849,248,wpr,mic_nongavi
fsm,Micronesia (Federated States of ),2000,mcv2,50,2979,1490,1489,wpr,mic_nongavi
fsm,Micronesia (Federated States of ),2001,dtp3,75,3021,2266,755,wpr,mic_nongavi
fsm,Micronesia (Federated States of ),2001,dtp1,90,3021,2719,302,wpr,mic_nongavi
fsm,Micronesia (Federated States of ),2001,mcv1,84,3021,2538,483,wpr,mic_nongavi
fsm,Micronesia (Federated States of ),2001,mcv2,64,2991,1914,1077,wpr,mic_nongavi
fsm,Micronesia (Federated States of ),2002,dtp3,84,2935,2465,470,wpr,mic_nongavi
fsm,Micronesia (Federated States of ),2002,dtp1,87,2935,2553,382,wpr,mic_nongavi
fsm,Micronesia (Federated States of ),2002,mcv1,88,2935,2583,352,wpr,mic_nongavi
fsm,Micronesia (Federated States of ),2002,mcv2,65,2985,1940,1045,wpr,mic_nongavi
fsm,Micronesia (Federated States of ),2003,dtp1,97,2845,2760,85,wpr,mic_nongavi
fsm,Micronesia (Federated States of ),2003,dtp3,92,2845,2617,228,wpr,mic_nongavi
fsm,Micronesia (Federated States of ),2003,mcv1,91,2845,2589,256,wpr,mic_nongavi
fsm,Micronesia (Federated States of ),2003,mcv2,66,2784,1837,947,wpr,mic_nongavi
fsm,Micronesia (Federated States of ),2004,dtp3,78,2754,2148,606,wpr,mic_nongavi
fsm,Micronesia (Federated States of ),2004,dtp1,81,2754,2231,523,wpr,mic_nongavi
fsm,Micronesia (Federated States of ),2004,mcv1,85,2754,2341,413,wpr,mic_nongavi
fsm,Micronesia (Federated States of ),2004,mcv2,74,2726,2017,709,wpr,mic_nongavi
fsm,Micronesia (Federated States of ),2005,dtp3,94,2668,2508,160,wpr,mic_nongavi
fsm,Micronesia (Federated States of ),2005,dtp1,98,2668,2615,53,wpr,mic_nongavi
fsm,Micronesia (Federated States of ),2005,mcv1,96,2668,2561,107,wpr,mic_nongavi
fsm,Micronesia (Federated States of ),2005,mcv2,84,2666,2239,427,wpr,mic_nongavi
fsm,Micronesia (Federated States of ),2006,dtp3,67,2590,1735,855,wpr,mic_nongavi
fsm,Micronesia (Federated States of ),2006,mcv1,83,2590,2150,440,wpr,mic_nongavi
fsm,Micronesia (Federated States of ),2006,dtp1,83,2590,2150,440,wpr,mic_nongavi
fsm,Micronesia (Federated States of ),2006,mcv2,85,2608,2217,391,wpr,mic_nongavi
fsm,Micronesia (Federated States of ),2007,dtp3,79,2522,1992,530,wpr,mic_nongavi
fsm,Micronesia (Federated States of ),2007,mcv1,92,2522,2320,202,wpr,mic_nongavi
fsm,Micronesia (Federated States of ),2007,dtp1,86,2522,2169,353,wpr,mic_nongavi
fsm,Micronesia (Federated States of ),2007,mcv2,86,2545,2189,356,wpr,mic_nongavi
fsm,Micronesia (Federated States of ),2008,dtp1,87,2464,2144,320,wpr,mic_nongavi
fsm,Micronesia (Federated States of ),2008,dtp3,85,2464,2094,370,wpr,mic_nongavi
fsm,Micronesia (Federated States of ),2008,mcv1,86,2464,2119,345,wpr,mic_nongavi
fsm,Micronesia (Federated States of ),2008,mcv2,84,2475,2079,396,wpr,mic_nongavi
fsm,Micronesia (Federated States of ),2009,dtp3,91,2419,2201,218,wpr,mic_nongavi
fsm,Micronesia (Federated States of ),2009,mcv1,86,2419,2080,339,wpr,mic_nongavi
fsm,Micronesia (Federated States of ),2009,dtp1,97,2419,2346,73,wpr,mic_nongavi
fsm,Micronesia (Federated States of ),2009,mcv2,82,2424,1988,436,wpr,mic_nongavi
fsm,Micronesia (Federated States of ),2010,dtp1,90,2389,2150,239,wpr,mic_nongavi
fsm,Micronesia (Federated States of ),2010,dtp3,85,2389,2031,358,wpr,mic_nongavi
fsm,Micronesia (Federated States of ),2010,mcv1,80,2389,1911,478,wpr,mic_nongavi
fsm,Micronesia (Federated States of ),2010,mcv2,75,2387,1790,597,wpr,mic_nongavi
fsm,Micronesia (Federated States of ),2011,dtp3,84,2372,1992,380,wpr,mic_nongavi
fsm,Micronesia (Federated States of ),2011,dtp1,96,2372,2277,95,wpr,mic_nongavi
fsm,Micronesia (Federated States of ),2011,mcv1,92,2372,2182,190,wpr,mic_nongavi
fsm,Micronesia (Federated States of ),2011,mcv2,75,2355,1766,589,wpr,mic_nongavi
fsm,Micronesia (Federated States of ),2012,mcv1,91,2367,2154,213,wpr,mic_nongavi
fsm,Micronesia (Federated States of ),2012,dtp3,81,2367,1917,450,wpr,mic_nongavi
fsm,Micronesia (Federated States of ),2012,dtp1,97,2367,2296,71,wpr,mic_nongavi
fsm,Micronesia (Federated States of ),2012,mcv2,70,2332,1632,700,wpr,mic_nongavi
fsm,Micronesia (Federated States of ),2013,dtp3,81,2370,1920,450,wpr,mic_nongavi
fsm,Micronesia (Federated States of ),2013,mcv1,91,2370,2157,213,wpr,mic_nongavi
fsm,Micronesia (Federated States of ),2013,dtp1,98,2370,2323,47,wpr,mic_nongavi
fsm,Micronesia (Federated States of ),2013,mcv2,75,2294,1720,574,wpr,mic_nongavi
fsm,Micronesia (Federated States of ),2014,dtp3,77,2380,1833,547,wpr,mic_nongavi
fsm,Micronesia (Federated States of ),2014,mcv1,83,2380,1975,405,wpr,mic_nongavi
fsm,Micronesia (Federated States of ),2014,dtp1,97,2380,2309,71,wpr,mic_nongavi
fsm,Micronesia (Federated States of ),2014,mcv2,75,2289,1717,572,wpr,mic_nongavi
fsm,Micronesia (Federated States of ),2015,dtp3,72,2395,1724,671,wpr,mic_nongavi
fsm,Micronesia (Federated States of ),2015,mcv1,74,2395,1772,623,wpr,mic_nongavi
fsm,Micronesia (Federated States of ),2015,dtp1,95,2395,2275,120,wpr,mic_nongavi
fsm,Micronesia (Federated States of ),2015,mcv2,74,2295,1698,597,wpr,mic_nongavi
fsm,Micronesia (Federated States of ),2016,dtp3,69,2414,1666,748,wpr,mic_nongavi
fsm,Micronesia (Federated States of ),2016,dtp1,95,2414,2293,121,wpr,mic_nongavi
fsm,Micronesia (Federated States of ),2016,mcv1,70,2414,1690,724,wpr,mic_nongavi
fsm,Micronesia (Federated States of ),2016,mcv2,74,2317,1715,602,wpr,mic_nongavi
gab,Gabon,2000,dtp1,69,38773,26753,12020,afr,mic_nongavi
gab,Gabon,2000,dtp3,45,38773,17448,21325,afr,mic_nongavi
gab,Gabon,2000,mcv1,55,38773,21325,17448,afr,mic_nongavi
gab,Gabon,2001,mcv1,55,39411,21676,17735,afr,mic_nongavi
gab,Gabon,2001,dtp1,69,39411,27194,12217,afr,mic_nongavi
gab,Gabon,2001,dtp3,45,39411,17735,21676,afr,mic_nongavi
gab,Gabon,2002,dtp1,69,40150,27704,12446,afr,mic_nongavi
gab,Gabon,2002,dtp3,45,40150,18068,22082,afr,mic_nongavi
gab,Gabon,2002,mcv1,55,40150,22083,18067,afr,mic_nongavi
gab,Gabon,2003,dtp3,45,41006,18453,22553,afr,mic_nongavi
gab,Gabon,2003,dtp1,69,41006,28294,12712,afr,mic_nongavi
gab,Gabon,2003,mcv1,55,41006,22553,18453,afr,mic_nongavi
gab,Gabon,2004,dtp1,69,41985,28970,13015,afr,mic_nongavi
gab,Gabon,2004,dtp3,45,41985,18893,23092,afr,mic_nongavi
gab,Gabon,2004,mcv1,55,41985,23092,18893,afr,mic_nongavi
gab,Gabon,2005,dtp1,69,43104,29742,13362,afr,mic_nongavi
gab,Gabon,2005,dtp3,45,43104,19397,23707,afr,mic_nongavi
gab,Gabon,2005,mcv1,55,43104,23707,19397,afr,mic_nongavi
gab,Gabon,2006,dtp3,45,44379,19971,24408,afr,mic_nongavi
gab,Gabon,2006,dtp1,69,44379,30622,13757,afr,mic_nongavi
gab,Gabon,2006,mcv1,55,44379,24408,19971,afr,mic_nongavi
gab,Gabon,2007,mcv1,62,45779,28383,17396,afr,mic_nongavi
gab,Gabon,2007,dtp3,81,45779,37081,8698,afr,mic_nongavi
gab,Gabon,2007,dtp1,86,45779,39370,6409,afr,mic_nongavi
gab,Gabon,2008,dtp3,82,47261,38754,8507,afr,mic_nongavi
gab,Gabon,2008,dtp1,85,47261,40172,7089,afr,mic_nongavi
gab,Gabon,2008,mcv1,67,47261,31665,15596,afr,mic_nongavi
gab,Gabon,2009,dtp1,81,48777,39509,9268,afr,mic_nongavi
gab,Gabon,2009,mcv1,63,48777,30730,18047,afr,mic_nongavi
gab,Gabon,2009,dtp3,76,48777,37071,11706,afr,mic_nongavi
gab,Gabon,2010,mcv1,62,50263,31163,19100,afr,mic_nongavi
gab,Gabon,2010,dtp1,82,50263,41216,9047,afr,mic_nongavi
gab,Gabon,2010,dtp3,67,50263,33676,16587,afr,mic_nongavi
gab,Gabon,2011,dtp1,82,51652,42355,9297,afr,mic_nongavi
gab,Gabon,2011,mcv1,72,51652,37189,14463,afr,mic_nongavi
gab,Gabon,2011,dtp3,75,51652,38739,12913,afr,mic_nongavi
gab,Gabon,2012,dtp1,86,52895,45490,7405,afr,mic_nongavi
gab,Gabon,2012,dtp3,82,52895,43374,9521,afr,mic_nongavi
gab,Gabon,2012,mcv1,71,52895,37555,15340,afr,mic_nongavi
gab,Gabon,2013,mcv1,70,53957,37770,16187,afr,mic_nongavi
gab,Gabon,2013,dtp1,80,53957,43166,10791,afr,mic_nongavi
gab,Gabon,2013,dtp3,79,53957,42626,11331,afr,mic_nongavi
gab,Gabon,2014,dtp1,77,54815,42208,12607,afr,mic_nongavi
gab,Gabon,2014,mcv1,61,54815,33437,21378,afr,mic_nongavi
gab,Gabon,2014,dtp3,70,54815,38370,16445,afr,mic_nongavi
gab,Gabon,2015,mcv1,68,55457,37711,17746,afr,mic_nongavi
gab,Gabon,2015,dtp3,80,55457,44366,11091,afr,mic_nongavi
gab,Gabon,2015,dtp1,87,55457,48248,7209,afr,mic_nongavi
gab,Gabon,2016,mcv1,64,55888,35768,20120,afr,mic_nongavi
gab,Gabon,2016,dtp1,83,55888,46387,9501,afr,mic_nongavi
gab,Gabon,2016,dtp3,75,55888,41916,13972,afr,mic_nongavi
gbr,United Kingdom of Great Britain and Northern Ireland,2000,mcv1,88,691949,608915,83034,eur,hic
gbr,United Kingdom of Great Britain and Northern Ireland,2000,dtp1,97,691949,671191,20758,eur,hic
gbr,United Kingdom of Great Britain and Northern Ireland,2000,dtp3,91,691949,629674,62275,eur,hic
gbr,United Kingdom of Great Britain and Northern Ireland,2000,mcv2,76,711913,541054,170859,eur,hic
gbr,United Kingdom of Great Britain and Northern Ireland,2001,dtp1,97,686338,665748,20590,eur,hic
gbr,United Kingdom of Great Britain and Northern Ireland,2001,dtp3,91,686338,624568,61770,eur,hic
gbr,United Kingdom of Great Britain and Northern Ireland,2001,mcv1,85,686338,583387,102951,eur,hic
gbr,United Kingdom of Great Britain and Northern Ireland,2001,mcv2,74,735601,544345,191256,eur,hic
gbr,United Kingdom of Great Britain and Northern Ireland,2002,dtp3,91,686327,624558,61769,eur,hic
gbr,United Kingdom of Great Britain and Northern Ireland,2002,dtp1,97,686327,665737,20590,eur,hic
gbr,United Kingdom of Great Britain and Northern Ireland,2002,mcv1,85,686327,583378,102949,eur,hic
gbr,United Kingdom of Great Britain and Northern Ireland,2002,mcv2,74,697774,516353,181421,eur,hic
gbr,United Kingdom of Great Britain and Northern Ireland,2003,mcv1,82,692424,567788,124636,eur,hic
gbr,United Kingdom of Great Britain and Northern Ireland,2003,dtp3,91,692424,630106,62318,eur,hic
gbr,United Kingdom of Great Britain and Northern Ireland,2003,dtp1,97,692424,671651,20773,eur,hic
gbr,United Kingdom of Great Britain and Northern Ireland,2003,mcv2,77,709532,546340,163192,eur,hic
gbr,United Kingdom of Great Britain and Northern Ireland,2004,dtp3,92,704266,647925,56341,eur,hic
gbr,United Kingdom of Great Britain and Northern Ireland,2004,mcv1,81,704266,570455,133811,eur,hic
gbr,United Kingdom of Great Britain and Northern Ireland,2004,dtp1,97,704266,683138,21128,eur,hic
gbr,United Kingdom of Great Britain and Northern Ireland,2004,mcv2,76,699350,531506,167844,eur,hic
gbr,United Kingdom of Great Britain and Northern Ireland,2005,dtp3,91,720466,655624,64842,eur,hic
gbr,United Kingdom of Great Britain and Northern Ireland,2005,dtp1,97,720466,698852,21614,eur,hic
gbr,United Kingdom of Great Britain and Northern Ireland,2005,mcv1,82,720466,590782,129684,eur,hic
gbr,United Kingdom of Great Britain and Northern Ireland,2005,mcv2,75,693891,520418,173473,eur,hic
gbr,United Kingdom of Great Britain and Northern Ireland,2006,dtp1,97,738851,716685,22166,eur,hic
gbr,United Kingdom of Great Britain and Northern Ireland,2006,dtp3,92,738851,679743,59108,eur,hic
gbr,United Kingdom of Great Britain and Northern Ireland,2006,mcv1,85,738851,628023,110828,eur,hic
gbr,United Kingdom of Great Britain and Northern Ireland,2006,mcv2,75,691346,518510,172836,eur,hic
gbr,United Kingdom of Great Britain and Northern Ireland,2007,dtp3,92,756786,696243,60543,eur,hic
gbr,United Kingdom of Great Britain and Northern Ireland,2007,dtp1,97,756786,734082,22704,eur,hic
gbr,United Kingdom of Great Britain and Northern Ireland,2007,mcv1,86,756786,650836,105950,eur,hic
gbr,United Kingdom of Great Britain and Northern Ireland,2007,mcv2,74,695147,514409,180738,eur,hic
gbr,United Kingdom of Great Britain and Northern Ireland,2008,dtp3,92,772164,710391,61773,eur,hic
gbr,United Kingdom of Great Britain and Northern Ireland,2008,dtp1,97,772164,748999,23165,eur,hic
gbr,United Kingdom of Great Britain and Northern Ireland,2008,mcv1,86,772164,664061,108103,eur,hic
gbr,United Kingdom of Great Britain and Northern Ireland,2008,mcv2,75,706037,529528,176509,eur,hic
gbr,United Kingdom of Great Britain and Northern Ireland,2009,dtp1,97,783978,760459,23519,eur,hic
gbr,United Kingdom of Great Britain and Northern Ireland,2009,dtp3,93,783978,729100,54878,eur,hic
gbr,United Kingdom of Great Britain and Northern Ireland,2009,mcv1,86,783978,674221,109757,eur,hic
gbr,United Kingdom of Great Britain and Northern Ireland,2009,mcv2,79,728525,575535,152990,eur,hic
gbr,United Kingdom of Great Britain and Northern Ireland,2010,dtp3,94,791876,744363,47513,eur,hic
gbr,United Kingdom of Great Britain and Northern Ireland,2010,dtp1,98,791876,776038,15838,eur,hic
gbr,United Kingdom of Great Britain and Northern Ireland,2010,mcv1,89,791876,704770,87106,eur,hic
gbr,United Kingdom of Great Britain and Northern Ireland,2010,mcv2,84,744865,625687,119178,eur,hic
gbr,United Kingdom of Great Britain and Northern Ireland,2011,dtp3,95,796319,756503,39816,eur,hic
gbr,United Kingdom of Great Britain and Northern Ireland,2011,dtp1,98,796319,780393,15926,eur,hic
gbr,United Kingdom of Great Britain and Northern Ireland,2011,mcv1,90,796319,716687,79632,eur,hic
gbr,United Kingdom of Great Britain and Northern Ireland,2011,mcv2,85,729622,620179,109443,eur,hic
gbr,United Kingdom of Great Britain and Northern Ireland,2012,dtp3,95,798752,758814,39938,eur,hic
gbr,United Kingdom of Great Britain and Northern Ireland,2012,dtp1,98,798752,782777,15975,eur,hic
gbr,United Kingdom of Great Britain and Northern Ireland,2012,mcv1,92,798752,734852,63900,eur,hic
gbr,United Kingdom of Great Britain and Northern Ireland,2012,mcv2,87,808126,703070,105056,eur,hic
gbr,United Kingdom of Great Britain and Northern Ireland,2013,dtp3,95,800366,760348,40018,eur,hic
gbr,United Kingdom of Great Britain and Northern Ireland,2013,mcv1,93,800366,744340,56026,eur,hic
gbr,United Kingdom of Great Britain and Northern Ireland,2013,dtp1,98,800366,784359,16007,eur,hic
gbr,United Kingdom of Great Britain and Northern Ireland,2013,mcv2,88,832794,732859,99935,eur,hic
gbr,United Kingdom of Great Britain and Northern Ireland,2014,mcv1,93,801529,745422,56107,eur,hic
gbr,United Kingdom of Great Britain and Northern Ireland,2014,dtp1,98,801529,785498,16031,eur,hic
gbr,United Kingdom of Great Britain and Northern Ireland,2014,dtp3,95,801529,761453,40076,eur,hic
gbr,United Kingdom of Great Britain and Northern Ireland,2014,mcv2,89,816345,726547,89798,eur,hic
gbr,United Kingdom of Great Britain and Northern Ireland,2015,dtp3,96,802468,770369,32099,eur,hic
gbr,United Kingdom of Great Britain and Northern Ireland,2015,dtp1,98,802468,786419,16049,eur,hic
gbr,United Kingdom of Great Britain and Northern Ireland,2015,mcv1,95,802468,762345,40123,eur,hic
gbr,United Kingdom of Great Britain and Northern Ireland,2015,mcv2,91,825697,751384,74313,eur,hic
gbr,United Kingdom of Great Britain and Northern Ireland,2016,dtp1,98,803206,787142,16064,eur,hic
gbr,United Kingdom of Great Britain and Northern Ireland,2016,dtp3,94,803206,755014,48192,eur,hic
gbr,United Kingdom of Great Britain and Northern Ireland,2016,mcv1,92,803206,738950,64256,eur,hic
gbr,United Kingdom of Great Britain and Northern Ireland,2016,mcv2,89,818048,728063,89985,eur,hic
geo,Georgia,2000,dtp3,80,54705,43764,10941,eur,gavi
geo,Georgia,2000,mcv1,73,54705,39935,14770,eur,gavi
geo,Georgia,2000,dtp1,89,54705,48687,6018,eur,gavi
geo,Georgia,2001,mcv1,74,53744,39771,13973,eur,gavi
geo,Georgia,2001,dtp1,97,53744,52132,1612,eur,gavi
geo,Georgia,2001,dtp3,87,53744,46757,6987,eur,gavi
geo,Georgia,2001,mcv2,8,62764,5021,57743,eur,gavi
geo,Georgia,2002,dtp3,84,53417,44870,8547,eur,gavi
geo,Georgia,2002,mcv1,75,53417,40063,13354,eur,gavi
geo,Georgia,2002,dtp1,96,53417,51280,2137,eur,gavi
geo,Georgia,2002,mcv2,40,58534,23414,35120,eur,gavi
geo,Georgia,2003,mcv1,76,53621,40752,12869,eur,gavi
geo,Georgia,2003,dtp3,75,53621,40216,13405,eur,gavi
geo,Georgia,2003,dtp1,95,53621,50940,2681,eur,gavi
geo,Georgia,2003,mcv2,57,54430,31025,23405,eur,gavi
geo,Georgia,2004,dtp1,88,54251,47741,6510,eur,gavi
geo,Georgia,2004,mcv1,86,54251,46656,7595,eur,gavi
geo,Georgia,2004,dtp3,78,54251,42316,11935,eur,gavi
geo,Georgia,2004,mcv2,75,50754,38066,12688,eur,gavi
geo,Georgia,2005,dtp1,91,55176,50210,4966,eur,gavi
geo,Georgia,2005,dtp3,82,55176,45244,9932,eur,gavi
geo,Georgia,2005,mcv1,90,55176,49658,5518,eur,gavi
geo,Georgia,2005,mcv2,87,47877,41653,6224,eur,gavi
geo,Georgia,2006,mcv1,96,56251,54001,2250,eur,gavi
geo,Georgia,2006,dtp1,99,56251,55688,563,eur,gavi
geo,Georgia,2006,dtp3,88,56251,49501,6750,eur,gavi
geo,Georgia,2006,mcv2,88,46655,41056,5599,eur,gavi
geo,Georgia,2007,dtp1,99,57321,56748,573,eur,gavi
geo,Georgia,2007,mcv1,97,57321,55601,1720,eur,gavi
geo,Georgia,2007,dtp3,98,57321,56175,1146,eur,gavi
geo,Georgia,2007,mcv2,92,46339,42632,3707,eur,gavi
geo,Georgia,2008,dtp1,99,58234,57652,582,eur,gavi
geo,Georgia,2008,dtp3,92,58234,53575,4659,eur,gavi
geo,Georgia,2008,mcv1,97,58234,56487,1747,eur,gavi
geo,Georgia,2008,mcv2,87,46619,40559,6060,eur,gavi
geo,Georgia,2009,mcv1,83,58868,48860,10008,eur,gavi
geo,Georgia,2009,dtp1,99,58868,58279,589,eur,gavi
geo,Georgia,2009,dtp3,88,58868,51804,7064,eur,gavi
geo,Georgia,2009,mcv2,71,47063,33415,13648,eur,gavi
geo,Georgia,2010,dtp1,99,59108,58517,591,eur,gavi
geo,Georgia,2010,dtp3,92,59108,54379,4729,eur,gavi
geo,Georgia,2010,mcv1,94,59108,55562,3546,eur,gavi
geo,Georgia,2010,mcv2,84,47130,39589,7541,eur,gavi
geo,Georgia,2011,dtp1,98,58886,57708,1178,eur,gavi
geo,Georgia,2011,dtp3,94,58886,55353,3533,eur,gavi
geo,Georgia,2011,mcv1,91,58886,53586,5300,eur,gavi
geo,Georgia,2011,mcv2,77,48336,37219,11117,eur,gavi
geo,Georgia,2012,mcv1,93,58256,54178,4078,eur,gavi
geo,Georgia,2012,dtp3,92,58256,53596,4660,eur,gavi
geo,Georgia,2012,dtp1,94,58256,54761,3495,eur,gavi
geo,Georgia,2012,mcv2,79,49952,39462,10490,eur,gavi
geo,Georgia,2013,dtp3,93,57294,53283,4011,eur,gavi
geo,Georgia,2013,dtp1,99,57294,56721,573,eur,gavi
geo,Georgia,2013,mcv1,97,57294,55575,1719,eur,gavi
geo,Georgia,2013,mcv2,89,51632,45952,5680,eur,gavi
geo,Georgia,2014,dtp3,91,56048,51004,5044,eur,gavi
geo,Georgia,2014,dtp1,99,56048,55488,560,eur,gavi
geo,Georgia,2014,mcv1,92,56048,51564,4484,eur,gavi
geo,Georgia,2014,mcv2,87,52946,46063,6883,eur,gavi
geo,Georgia,2015,dtp1,97,54595,52957,1638,eur,gavi
geo,Georgia,2015,mcv1,96,54595,52411,2184,eur,gavi
geo,Georgia,2015,dtp3,94,54595,51319,3276,eur,gavi
geo,Georgia,2015,mcv2,91,53332,48532,4800,eur,gavi
geo,Georgia,2016,dtp1,97,53027,51436,1591,eur,gavi
geo,Georgia,2016,dtp3,92,53027,48785,4242,eur,gavi
geo,Georgia,2016,mcv1,93,53027,49315,3712,eur,gavi
geo,Georgia,2016,mcv2,85,54143,46022,8121,eur,gavi
gha,Ghana,2000,dtp3,88,630201,554577,75624,afr,gavi
gha,Ghana,2000,dtp1,96,630201,604993,25208,afr,gavi
gha,Ghana,2000,mcv1,90,630201,567181,63020,afr,gavi
gha,Ghana,2001,dtp1,81,641146,519328,121818,afr,gavi
gha,Ghana,2001,dtp3,79,641146,506505,134641,afr,gavi
gha,Ghana,2001,mcv1,78,641146,500094,141052,afr,gavi
gha,Ghana,2002,dtp3,78,652804,509187,143617,afr,gavi
gha,Ghana,2002,dtp1,84,652804,548355,104449,afr,gavi
gha,Ghana,2002,mcv1,78,652804,509187,143617,afr,gavi
gha,Ghana,2003,dtp1,87,665381,578881,86500,afr,gavi
gha,Ghana,2003,mcv1,80,665381,532305,133076,afr,gavi
gha,Ghana,2003,dtp3,80,665381,532305,133076,afr,gavi
gha,Ghana,2004,dtp1,88,678931,597459,81472,afr,gavi
gha,Ghana,2004,dtp3,80,678931,543145,135786,afr,gavi
gha,Ghana,2004,mcv1,83,678931,563513,115418,afr,gavi
gha,Ghana,2005,dtp1,88,693565,610337,83228,afr,gavi
gha,Ghana,2005,dtp3,84,693565,582595,110970,afr,gavi
gha,Ghana,2005,mcv1,83,693565,575659,117906,afr,gavi
gha,Ghana,2006,dtp1,87,709334,617121,92213,afr,gavi
gha,Ghana,2006,dtp3,84,709334,595841,113493,afr,gavi
gha,Ghana,2006,mcv1,85,709334,602934,106400,afr,gavi
gha,Ghana,2007,dtp1,96,725936,696899,29037,afr,gavi
gha,Ghana,2007,mcv1,95,725936,689639,36297,afr,gavi
gha,Ghana,2007,dtp3,94,725936,682380,43556,afr,gavi
gha,Ghana,2008,dtp1,96,742931,713214,29717,afr,gavi
gha,Ghana,2008,dtp3,93,742931,690926,52005,afr,gavi
gha,Ghana,2008,mcv1,86,742931,638921,104010,afr,gavi
gha,Ghana,2009,dtp1,96,759880,729485,30395,afr,gavi
gha,Ghana,2009,mcv1,93,759880,706688,53192,afr,gavi
gha,Ghana,2009,dtp3,94,759880,714287,45593,afr,gavi
gha,Ghana,2010,mcv1,93,776157,721826,54331,afr,gavi
gha,Ghana,2010,dtp1,96,776157,745111,31046,afr,gavi
gha,Ghana,2010,dtp3,94,776157,729588,46569,afr,gavi
gha,Ghana,2011,dtp1,94,791121,743654,47467,afr,gavi
gha,Ghana,2011,mcv1,91,791121,719920,71201,afr,gavi
gha,Ghana,2011,dtp3,91,791121,719920,71201,afr,gavi
gha,Ghana,2012,dtp3,92,804406,740054,64352,afr,gavi
gha,Ghana,2012,dtp1,92,804406,740054,64352,afr,gavi
gha,Ghana,2012,mcv1,88,804406,707877,96529,afr,gavi
gha,Ghana,2012,mcv2,52,766480,398570,367910,afr,gavi
gha,Ghana,2013,dtp3,90,815807,734226,81581,afr,gavi
gha,Ghana,2013,mcv1,89,815807,726068,89739,afr,gavi
gha,Ghana,2013,dtp1,94,815807,766859,48948,afr,gavi
gha,Ghana,2013,mcv2,54,774760,418370,356390,afr,gavi
gha,Ghana,2014,dtp3,98,825261,808756,16505,afr,gavi
gha,Ghana,2014,mcv1,92,825261,759240,66021,afr,gavi
gha,Ghana,2014,dtp1,99,825261,817008,8253,afr,gavi
gha,Ghana,2014,mcv2,67,791151,530071,261080,afr,gavi
gha,Ghana,2015,dtp1,97,832878,807892,24986,afr,gavi
gha,Ghana,2015,dtp3,88,832878,732933,99945,afr,gavi
gha,Ghana,2015,mcv1,89,832878,741261,91617,afr,gavi
gha,Ghana,2015,mcv2,63,804995,507147,297848,afr,gavi
gha,Ghana,2016,dtp1,94,838964,788626,50338,afr,gavi
gha,Ghana,2016,dtp3,93,838964,780237,58727,afr,gavi
gha,Ghana,2016,mcv1,89,838964,746678,92286,afr,gavi
gha,Ghana,2016,mcv2,75,819741,614806,204935,afr,gavi
gin,Guinea,2000,mcv1,42,338482,142162,196320,afr,gavi
gin,Guinea,2000,dtp1,61,338482,206474,132008,afr,gavi
gin,Guinea,2000,dtp3,46,338482,155702,182780,afr,gavi
gin,Guinea,2001,dtp1,64,343380,219763,123617,afr,gavi
gin,Guinea,2001,mcv1,44,343380,151087,192293,afr,gavi
gin,Guinea,2001,dtp3,50,343380,171690,171690,afr,gavi
gin,Guinea,2002,dtp1,68,347986,236630,111356,afr,gavi
gin,Guinea,2002,mcv1,46,347986,160074,187912,afr,gavi
gin,Guinea,2002,dtp3,53,347986,184433,163553,afr,gavi
gin,Guinea,2003,mcv1,48,352535,169217,183318,afr,gavi
gin,Guinea,2003,dtp1,71,352535,250300,102235,afr,gavi
gin,Guinea,2003,dtp3,57,352535,200945,151590,afr,gavi
gin,Guinea,2004,dtp1,75,357166,267874,89292,afr,gavi
gin,Guinea,2004,dtp3,60,357166,214300,142866,afr,gavi
gin,Guinea,2004,mcv1,50,357166,178583,178583,afr,gavi
gin,Guinea,2005,dtp1,75,361953,271465,90488,afr,gavi
gin,Guinea,2005,dtp3,59,361953,213552,148401,afr,gavi
gin,Guinea,2005,mcv1,51,361953,184596,177357,afr,gavi
gin,Guinea,2006,dtp1,75,366891,275168,91723,afr,gavi
gin,Guinea,2006,mcv1,51,366891,187114,179777,afr,gavi
gin,Guinea,2006,dtp3,57,366891,209128,157763,afr,gavi
gin,Guinea,2007,dtp1,76,371897,282642,89255,afr,gavi
gin,Guinea,2007,mcv1,57,371897,211981,159916,afr,gavi
gin,Guinea,2007,dtp3,63,371897,234295,137602,afr,gavi
gin,Guinea,2008,dtp1,64,376921,241229,135692,afr,gavi
gin,Guinea,2008,mcv1,55,376921,207307,169614,afr,gavi
gin,Guinea,2008,dtp3,60,376921,226153,150768,afr,gavi
gin,Guinea,2009,mcv1,53,381995,202457,179538,afr,gavi
gin,Guinea,2009,dtp1,76,381995,290316,91679,afr,gavi
gin,Guinea,2009,dtp3,57,381995,217737,164258,afr,gavi
gin,Guinea,2010,dtp1,86,387161,332958,54203,afr,gavi
gin,Guinea,2010,mcv1,58,387161,224553,162608,afr,gavi
gin,Guinea,2010,dtp3,64,387161,247783,139378,afr,gavi
gin,Guinea,2011,dtp1,76,392466,298274,94192,afr,gavi
gin,Guinea,2011,dtp3,63,392466,247254,145212,afr,gavi
gin,Guinea,2011,mcv1,62,392466,243329,149137,afr,gavi
gin,Guinea,2012,dtp1,76,397940,302434,95506,afr,gavi
gin,Guinea,2012,dtp3,62,397940,246723,151217,afr,gavi
gin,Guinea,2012,mcv1,61,397940,242743,155197,afr,gavi
gin,Guinea,2013,dtp1,76,403614,306747,96867,afr,gavi
gin,Guinea,2013,dtp3,63,403614,254277,149337,afr,gavi
gin,Guinea,2013,mcv1,62,403614,250241,153373,afr,gavi
gin,Guinea,2014,mcv1,52,409501,212941,196560,afr,gavi
gin,Guinea,2014,dtp3,51,409501,208846,200655,afr,gavi
gin,Guinea,2014,dtp1,60,409501,245701,163800,afr,gavi
gin,Guinea,2015,mcv1,53,415617,220277,195340,afr,gavi
gin,Guinea,2015,dtp3,54,415617,224433,191184,afr,gavi
gin,Guinea,2015,dtp1,63,415617,261839,153778,afr,gavi
gin,Guinea,2016,dtp1,65,421965,274277,147688,afr,gavi
gin,Guinea,2016,dtp3,57,421965,240520,181445,afr,gavi
gin,Guinea,2016,mcv1,54,421965,227861,194104,afr,gavi
gmb,Gambia,2000,dtp3,80,52503,42002,10501,afr,gavi
gmb,Gambia,2000,dtp1,97,52503,50928,1575,afr,gavi
gmb,Gambia,2000,mcv1,89,52503,46728,5775,afr,gavi
gmb,Gambia,2001,dtp1,97,53957,52338,1619,afr,gavi
gmb,Gambia,2001,mcv1,89,53957,48022,5935,afr,gavi
gmb,Gambia,2001,dtp3,87,53957,46943,7014,afr,gavi
gmb,Gambia,2002,dtp3,87,55439,48232,7207,afr,gavi
gmb,Gambia,2002,mcv1,90,55439,49895,5544,afr,gavi
gmb,Gambia,2002,dtp1,96,55439,53221,2218,afr,gavi
gmb,Gambia,2003,dtp1,97,56934,55226,1708,afr,gavi
gmb,Gambia,2003,mcv1,90,56934,51241,5693,afr,gavi
gmb,Gambia,2003,dtp3,87,56934,49533,7401,afr,gavi
gmb,Gambia,2004,dtp3,87,58441,50844,7597,afr,gavi
gmb,Gambia,2004,dtp1,96,58441,56103,2338,afr,gavi
gmb,Gambia,2004,mcv1,92,58441,53766,4675,afr,gavi
gmb,Gambia,2005,dtp1,95,59958,56960,2998,afr,gavi
gmb,Gambia,2005,dtp3,95,59958,56960,2998,afr,gavi
gmb,Gambia,2005,mcv1,91,59958,54562,5396,afr,gavi
gmb,Gambia,2006,dtp1,98,61495,60265,1230,afr,gavi
gmb,Gambia,2006,dtp3,95,61495,58420,3075,afr,gavi
gmb,Gambia,2006,mcv1,89,61495,54731,6764,afr,gavi
gmb,Gambia,2007,dtp1,98,63055,61794,1261,afr,gavi
gmb,Gambia,2007,mcv1,88,63055,55488,7567,afr,gavi
gmb,Gambia,2007,dtp3,95,63055,59902,3153,afr,gavi
gmb,Gambia,2008,dtp1,96,64637,62052,2585,afr,gavi
gmb,Gambia,2008,mcv1,92,64637,59466,5171,afr,gavi
gmb,Gambia,2008,dtp3,96,64637,62052,2585,afr,gavi
gmb,Gambia,2009,dtp3,98,66233,64908,1325,afr,gavi
gmb,Gambia,2009,dtp1,98,66233,64908,1325,afr,gavi
gmb,Gambia,2009,mcv1,96,66233,63584,2649,afr,gavi
gmb,Gambia,2010,dtp1,99,67832,67154,678,afr,gavi
gmb,Gambia,2010,mcv1,92,67832,62405,5427,afr,gavi
gmb,Gambia,2010,dtp3,97,67832,65797,2035,afr,gavi
gmb,Gambia,2011,dtp3,96,69420,66643,2777,afr,gavi
gmb,Gambia,2011,dtp1,99,69420,68726,694,afr,gavi
gmb,Gambia,2011,mcv1,91,69420,63172,6248,afr,gavi
gmb,Gambia,2012,dtp3,98,70983,69563,1420,afr,gavi
gmb,Gambia,2012,dtp1,99,70983,70273,710,afr,gavi
gmb,Gambia,2012,mcv1,95,70983,67434,3549,afr,gavi
gmb,Gambia,2012,mcv2,56,65367,36606,28761,afr,gavi
gmb,Gambia,2013,dtp1,99,72513,71788,725,afr,gavi
gmb,Gambia,2013,dtp3,97,72513,70338,2175,afr,gavi
gmb,Gambia,2013,mcv1,96,72513,69612,2901,afr,gavi
gmb,Gambia,2013,mcv2,53,66981,35500,31481,afr,gavi
gmb,Gambia,2014,mcv1,96,74004,71044,2960,afr,gavi
gmb,Gambia,2014,dtp1,98,74004,72524,1480,afr,gavi
gmb,Gambia,2014,dtp3,96,74004,71044,2960,afr,gavi
gmb,Gambia,2014,mcv2,73,68655,50118,18537,afr,gavi
gmb,Gambia,2015,dtp3,97,75451,73187,2264,afr,gavi
gmb,Gambia,2015,mcv1,97,75451,73187,2264,afr,gavi
gmb,Gambia,2015,dtp1,99,75451,74696,755,afr,gavi
gmb,Gambia,2015,mcv2,81,70294,56938,13356,afr,gavi
gmb,Gambia,2016,mcv1,97,76862,74556,2306,afr,gavi
gmb,Gambia,2016,dtp3,95,76862,73019,3843,afr,gavi
gmb,Gambia,2016,dtp1,99,76862,76093,769,afr,gavi
gmb,Gambia,2016,mcv2,79,72103,56961,15142,afr,gavi
gnb,Guinea-Bissau,2000,dtp3,49,46181,22629,23552,afr,gavi
gnb,Guinea-Bissau,2000,dtp1,73,46181,33712,12469,afr,gavi
gnb,Guinea-Bissau,2000,mcv1,71,46181,32789,13392,afr,gavi
gnb,Guinea-Bissau,2001,dtp1,76,46863,35616,11247,afr,gavi
gnb,Guinea-Bissau,2001,mcv1,72,46863,33741,13122,afr,gavi
gnb,Guinea-Bissau,2001,dtp3,53,46863,24837,22026,afr,gavi
gnb,Guinea-Bissau,2002,dtp3,57,47627,27147,20480,afr,gavi
gnb,Guinea-Bissau,2002,mcv1,73,47627,34768,12859,afr,gavi
gnb,Guinea-Bissau,2002,dtp1,79,47627,37625,10002,afr,gavi
gnb,Guinea-Bissau,2003,dtp1,81,48470,39261,9209,afr,gavi
gnb,Guinea-Bissau,2003,mcv1,74,48470,35868,12602,afr,gavi
gnb,Guinea-Bissau,2003,dtp3,60,48470,29082,19388,afr,gavi
gnb,Guinea-Bissau,2004,dtp1,84,49388,41486,7902,afr,gavi
gnb,Guinea-Bissau,2004,dtp3,64,49388,31608,17780,afr,gavi
gnb,Guinea-Bissau,2004,mcv1,75,49388,37041,12347,afr,gavi
gnb,Guinea-Bissau,2005,dtp1,86,50382,43329,7053,afr,gavi
gnb,Guinea-Bissau,2005,dtp3,68,50382,34260,16122,afr,gavi
gnb,Guinea-Bissau,2005,mcv1,76,50382,38290,12092,afr,gavi
gnb,Guinea-Bissau,2006,dtp3,71,51449,36529,14920,afr,gavi
gnb,Guinea-Bissau,2006,mcv1,74,51449,38072,13377,afr,gavi
gnb,Guinea-Bissau,2006,dtp1,88,51449,45275,6174,afr,gavi
gnb,Guinea-Bissau,2007,dtp3,74,52573,38904,13669,afr,gavi
gnb,Guinea-Bissau,2007,mcv1,73,52573,38378,14195,afr,gavi
gnb,Guinea-Bissau,2007,dtp1,89,52573,46790,5783,afr,gavi
gnb,Guinea-Bissau,2008,dtp3,77,53729,41371,12358,afr,gavi
gnb,Guinea-Bissau,2008,dtp1,91,53729,48893,4836,afr,gavi
gnb,Guinea-Bissau,2008,mcv1,71,53729,38148,15581,afr,gavi
gnb,Guinea-Bissau,2009,dtp1,92,54895,50503,4392,afr,gavi
gnb,Guinea-Bissau,2009,mcv1,69,54895,37878,17017,afr,gavi
gnb,Guinea-Bissau,2009,dtp3,80,54895,43916,10979,afr,gavi
gnb,Guinea-Bissau,2010,dtp1,94,56042,52679,3363,afr,gavi
gnb,Guinea-Bissau,2010,mcv1,76,56042,42592,13450,afr,gavi
gnb,Guinea-Bissau,2010,dtp3,83,56042,46515,9527,afr,gavi
gnb,Guinea-Bissau,2011,mcv1,83,57145,47430,9715,afr,gavi
gnb,Guinea-Bissau,2011,dtp1,95,57145,54288,2857,afr,gavi
gnb,Guinea-Bissau,2011,dtp3,86,57145,49145,8000,afr,gavi
gnb,Guinea-Bissau,2012,dtp1,95,58187,55278,2909,afr,gavi
gnb,Guinea-Bissau,2012,mcv1,81,58187,47131,11056,afr,gavi
gnb,Guinea-Bissau,2012,dtp3,87,58187,50623,7564,afr,gavi
gnb,Guinea-Bissau,2013,dtp3,87,59159,51468,7691,afr,gavi
gnb,Guinea-Bissau,2013,dtp1,95,59159,56201,2958,afr,gavi
gnb,Guinea-Bissau,2013,mcv1,81,59159,47919,11240,afr,gavi
gnb,Guinea-Bissau,2014,mcv1,81,60050,48641,11409,afr,gavi
gnb,Guinea-Bissau,2014,dtp3,87,60050,52244,7806,afr,gavi
gnb,Guinea-Bissau,2014,dtp1,95,60050,57048,3002,afr,gavi
gnb,Guinea-Bissau,2015,dtp3,87,60856,52945,7911,afr,gavi
gnb,Guinea-Bissau,2015,mcv1,81,60856,49293,11563,afr,gavi
gnb,Guinea-Bissau,2015,dtp1,95,60856,57813,3043,afr,gavi
gnb,Guinea-Bissau,2016,mcv1,81,61584,49883,11701,afr,gavi
gnb,Guinea-Bissau,2016,dtp3,87,61584,53578,8006,afr,gavi
gnb,Guinea-Bissau,2016,dtp1,95,61584,58505,3079,afr,gavi
gnq,Equatorial Guinea,2000,dtp1,64,22922,14670,8252,afr,mic_nongavi
gnq,Equatorial Guinea,2000,dtp3,34,22922,7793,15129,afr,mic_nongavi
gnq,Equatorial Guinea,2000,mcv1,51,22922,11690,11232,afr,mic_nongavi
gnq,Equatorial Guinea,2001,dtp1,64,23821,15245,8576,afr,mic_nongavi
gnq,Equatorial Guinea,2001,dtp3,35,23821,8337,15484,afr,mic_nongavi
gnq,Equatorial Guinea,2001,mcv1,51,23821,12149,11672,afr,mic_nongavi
gnq,Equatorial Guinea,2002,mcv1,51,24754,12625,12129,afr,mic_nongavi
gnq,Equatorial Guinea,2002,dtp1,63,24754,15595,9159,afr,mic_nongavi
gnq,Equatorial Guinea,2002,dtp3,36,24754,8911,15843,afr,mic_nongavi
gnq,Equatorial Guinea,2003,mcv1,51,25722,13118,12604,afr,mic_nongavi
gnq,Equatorial Guinea,2003,dtp1,63,25722,16205,9517,afr,mic_nongavi
gnq,Equatorial Guinea,2003,dtp3,37,25722,9517,16205,afr,mic_nongavi
gnq,Equatorial Guinea,2004,dtp1,62,26720,16566,10154,afr,mic_nongavi
gnq,Equatorial Guinea,2004,mcv1,51,26720,13627,13093,afr,mic_nongavi
gnq,Equatorial Guinea,2004,dtp3,38,26720,10154,16566,afr,mic_nongavi
gnq,Equatorial Guinea,2005,dtp1,62,27744,17201,10543,afr,mic_nongavi
gnq,Equatorial Guinea,2005,dtp3,39,27744,10820,16924,afr,mic_nongavi
gnq,Equatorial Guinea,2005,mcv1,51,27744,14149,13595,afr,mic_nongavi
gnq,Equatorial Guinea,2006,dtp3,40,28788,11515,17273,afr,mic_nongavi
gnq,Equatorial Guinea,2006,dtp1,61,28788,17561,11227,afr,mic_nongavi
gnq,Equatorial Guinea,2006,mcv1,51,28788,14682,14106,afr,mic_nongavi
gnq,Equatorial Guinea,2007,dtp3,41,29845,12236,17609,afr,mic_nongavi
gnq,Equatorial Guinea,2007,dtp1,61,29845,18205,11640,afr,mic_nongavi
gnq,Equatorial Guinea,2007,mcv1,51,29845,15221,14624,afr,mic_nongavi
gnq,Equatorial Guinea,2008,dtp1,60,30908,18545,12363,afr,mic_nongavi
gnq,Equatorial Guinea,2008,dtp3,42,30908,12981,17927,afr,mic_nongavi
gnq,Equatorial Guinea,2008,mcv1,51,30908,15763,15145,afr,mic_nongavi
gnq,Equatorial Guinea,2009,dtp1,60,31969,19181,12788,afr,mic_nongavi
gnq,Equatorial Guinea,2009,dtp3,43,31969,13747,18222,afr,mic_nongavi
gnq,Equatorial Guinea,2009,mcv1,51,31969,16304,15665,afr,mic_nongavi
gnq,Equatorial Guinea,2010,dtp1,59,33020,19482,13538,afr,mic_nongavi
gnq,Equatorial Guinea,2010,dtp3,44,33020,14529,18491,afr,mic_nongavi
gnq,Equatorial Guinea,2010,mcv1,51,33020,16840,16180,afr,mic_nongavi
gnq,Equatorial Guinea,2011,dtp3,41,34059,13964,20095,afr,mic_nongavi
gnq,Equatorial Guinea,2011,mcv1,51,34059,17370,16689,afr,mic_nongavi
gnq,Equatorial Guinea,2011,dtp1,59,34059,20095,13964,afr,mic_nongavi
gnq,Equatorial Guinea,2012,dtp1,56,35084,19647,15437,afr,mic_nongavi
gnq,Equatorial Guinea,2012,mcv1,35,35084,12279,22805,afr,mic_nongavi
gnq,Equatorial Guinea,2012,dtp3,24,35084,8420,26664,afr,mic_nongavi
gnq,Equatorial Guinea,2013,dtp3,3,36095,1083,35012,afr,mic_nongavi
gnq,Equatorial Guinea,2013,dtp1,49,36095,17687,18408,afr,mic_nongavi
gnq,Equatorial Guinea,2013,mcv1,42,36095,15160,20935,afr,mic_nongavi
gnq,Equatorial Guinea,2014,dtp3,20,37090,7418,29672,afr,mic_nongavi
gnq,Equatorial Guinea,2014,dtp1,59,37090,21883,15207,afr,mic_nongavi
gnq,Equatorial Guinea,2014,mcv1,44,37090,16320,20770,afr,mic_nongavi
gnq,Equatorial Guinea,2015,dtp3,16,38068,6091,31977,afr,mic_nongavi
gnq,Equatorial Guinea,2015,dtp1,28,38068,10659,27409,afr,mic_nongavi
gnq,Equatorial Guinea,2015,mcv1,27,38068,10278,27790,afr,mic_nongavi
gnq,Equatorial Guinea,2016,dtp1,40,39032,15613,23419,afr,mic_nongavi
gnq,Equatorial Guinea,2016,dtp3,19,39032,7416,31616,afr,mic_nongavi
gnq,Equatorial Guinea,2016,mcv1,30,39032,11710,27322,afr,mic_nongavi
grc,Greece,2000,mcv1,89,109694,97628,12066,eur,hic
grc,Greece,2000,dtp3,89,109694,97628,12066,eur,hic
grc,Greece,2000,dtp1,96,109694,105306,4388,eur,hic
grc,Greece,2001,mcv1,91,110312,100384,9928,eur,hic
grc,Greece,2001,dtp3,91,110312,100384,9928,eur,hic
grc,Greece,2001,dtp1,96,110312,105900,4412,eur,hic
grc,Greece,2002,dtp3,92,111378,102468,8910,eur,hic
grc,Greece,2002,dtp1,96,111378,106923,4455,eur,hic
grc,Greece,2002,mcv1,92,111378,102468,8910,eur,hic
grc,Greece,2003,mcv1,94,112841,106071,6770,eur,hic
grc,Greece,2003,dtp1,96,112841,108327,4514,eur,hic
grc,Greece,2003,dtp3,94,112841,106071,6770,eur,hic
grc,Greece,2004,dtp3,95,114538,108811,5727,eur,hic
grc,Greece,2004,dtp1,96,114538,109956,4582,eur,hic
grc,Greece,2004,mcv1,95,114538,108811,5727,eur,hic
grc,Greece,2005,dtp3,96,116126,111481,4645,eur,hic
grc,Greece,2005,dtp1,96,116126,111481,4645,eur,hic
grc,Greece,2005,mcv1,96,116126,111481,4645,eur,hic
grc,Greece,2006,dtp3,98,117185,114841,2344,eur,hic
grc,Greece,2006,dtp1,99,117185,116013,1172,eur,hic
grc,Greece,2006,mcv1,98,117185,114841,2344,eur,hic
grc,Greece,2007,dtp1,99,117393,116219,1174,eur,hic
grc,Greece,2007,dtp3,99,117393,116219,1174,eur,hic
grc,Greece,2007,mcv1,99,117393,116219,1174,eur,hic
grc,Greece,2007,mcv2,77,111212,85633,25579,eur,hic
grc,Greece,2008,dtp1,99,116563,115397,1166,eur,hic
grc,Greece,2008,dtp3,99,116563,115397,1166,eur,hic
grc,Greece,2008,mcv1,99,116563,115397,1166,eur,hic
grc,Greece,2008,mcv2,77,110998,85468,25530,eur,hic
grc,Greece,2009,dtp3,99,114672,113525,1147,eur,hic
grc,Greece,2009,dtp1,99,114672,113525,1147,eur,hic
grc,Greece,2009,mcv1,99,114672,113525,1147,eur,hic
grc,Greece,2009,mcv2,77,111154,85589,25565,eur,hic
grc,Greece,2010,dtp1,99,111829,110711,1118,eur,hic
grc,Greece,2010,mcv1,99,111829,110711,1118,eur,hic
grc,Greece,2010,dtp3,99,111829,110711,1118,eur,hic
grc,Greece,2010,mcv2,77,112024,86258,25766,eur,hic
grc,Greece,2011,dtp1,99,108276,107193,1083,eur,hic
grc,Greece,2011,dtp3,99,108276,107193,1083,eur,hic
grc,Greece,2011,mcv1,99,108276,107193,1083,eur,hic
grc,Greece,2011,mcv2,77,114281,87996,26285,eur,hic
grc,Greece,2012,mcv1,99,104421,103377,1044,eur,hic
grc,Greece,2012,dtp3,99,104421,103377,1044,eur,hic
grc,Greece,2012,dtp1,99,104421,103377,1044,eur,hic
grc,Greece,2012,mcv2,83,116447,96651,19796,eur,hic
grc,Greece,2013,dtp3,99,100623,99617,1006,eur,hic
grc,Greece,2013,mcv1,99,100623,99617,1006,eur,hic
grc,Greece,2013,dtp1,99,100623,99617,1006,eur,hic
grc,Greece,2013,mcv2,83,117662,97659,20003,eur,hic
grc,Greece,2014,dtp3,99,97082,96111,971,eur,hic
grc,Greece,2014,dtp1,99,97082,96111,971,eur,hic
grc,Greece,2014,mcv1,97,97082,94170,2912,eur,hic
grc,Greece,2014,mcv2,83,116839,96976,19863,eur,hic
grc,Greece,2015,dtp1,99,93931,92992,939,eur,hic
grc,Greece,2015,dtp3,99,93931,92992,939,eur,hic
grc,Greece,2015,mcv1,97,93931,91113,2818,eur,hic
grc,Greece,2015,mcv2,83,112663,93510,19153,eur,hic
grc,Greece,2016,dtp3,99,91204,90292,912,eur,hic
grc,Greece,2016,dtp1,99,91204,90292,912,eur,hic
grc,Greece,2016,mcv1,97,91204,88468,2736,eur,hic
grc,Greece,2016,mcv2,83,107760,89441,18319,eur,hic
grd,Grenada,2000,dtp3,97,1948,1890,58,amr,mic_nongavi
grd,Grenada,2000,mcv1,92,1948,1792,156,amr,mic_nongavi
grd,Grenada,2000,dtp1,99,1948,1929,19,amr,mic_nongavi
grd,Grenada,2001,mcv1,99,1923,1904,19,amr,mic_nongavi
grd,Grenada,2001,dtp1,98,1923,1885,38,amr,mic_nongavi
grd,Grenada,2001,dtp3,96,1923,1846,77,amr,mic_nongavi
grd,Grenada,2002,dtp1,99,1908,1889,19,amr,mic_nongavi
grd,Grenada,2002,mcv1,96,1908,1832,76,amr,mic_nongavi
grd,Grenada,2002,dtp3,98,1908,1870,38,amr,mic_nongavi
grd,Grenada,2002,mcv2,74,2089,1546,543,amr,mic_nongavi
grd,Grenada,2003,dtp1,99,1904,1885,19,amr,mic_nongavi
grd,Grenada,2003,mcv1,99,1904,1885,19,amr,mic_nongavi
grd,Grenada,2003,dtp3,97,1904,1847,57,amr,mic_nongavi
grd,Grenada,2003,mcv2,68,1898,1291,607,amr,mic_nongavi
grd,Grenada,2004,dtp1,87,1909,1661,248,amr,mic_nongavi
grd,Grenada,2004,dtp3,83,1909,1584,325,amr,mic_nongavi
grd,Grenada,2004,mcv1,74,1909,1413,496,amr,mic_nongavi
grd,Grenada,2004,mcv2,61,1870,1141,729,amr,mic_nongavi
grd,Grenada,2005,dtp1,99,1923,1904,19,amr,mic_nongavi
grd,Grenada,2005,dtp3,99,1923,1904,19,amr,mic_nongavi
grd,Grenada,2005,mcv1,99,1923,1904,19,amr,mic_nongavi
grd,Grenada,2005,mcv2,81,1853,1501,352,amr,mic_nongavi
grd,Grenada,2006,dtp3,91,1941,1766,175,amr,mic_nongavi
grd,Grenada,2006,dtp1,97,1941,1883,58,amr,mic_nongavi
grd,Grenada,2006,mcv1,98,1941,1902,39,amr,mic_nongavi
grd,Grenada,2006,mcv2,87,1813,1577,236,amr,mic_nongavi
grd,Grenada,2007,dtp1,98,1963,1924,39,amr,mic_nongavi
grd,Grenada,2007,dtp3,96,1963,1884,79,amr,mic_nongavi
grd,Grenada,2007,mcv1,98,1963,1924,39,amr,mic_nongavi
grd,Grenada,2007,mcv2,86,1785,1535,250,amr,mic_nongavi
grd,Grenada,2008,dtp1,99,1985,1965,20,amr,mic_nongavi
grd,Grenada,2008,dtp3,99,1985,1965,20,amr,mic_nongavi
grd,Grenada,2008,mcv1,99,1985,1965,20,amr,mic_nongavi
grd,Grenada,2008,mcv2,86,1870,1608,262,amr,mic_nongavi
grd,Grenada,2009,dtp1,99,2003,1983,20,amr,mic_nongavi
grd,Grenada,2009,mcv1,98,2003,1963,40,amr,mic_nongavi
grd,Grenada,2009,dtp3,99,2003,1983,20,amr,mic_nongavi
grd,Grenada,2009,mcv2,78,1889,1473,416,amr,mic_nongavi
grd,Grenada,2010,dtp1,99,2017,1997,20,amr,mic_nongavi
grd,Grenada,2010,dtp3,97,2017,1956,61,amr,mic_nongavi
grd,Grenada,2010,mcv1,95,2017,1916,101,amr,mic_nongavi
grd,Grenada,2010,mcv2,86,1912,1644,268,amr,mic_nongavi
grd,Grenada,2011,dtp1,98,2025,1984,41,amr,mic_nongavi
grd,Grenada,2011,mcv1,95,2025,1924,101,amr,mic_nongavi
grd,Grenada,2011,dtp3,95,2025,1924,101,amr,mic_nongavi
grd,Grenada,2011,mcv2,85,1987,1689,298,amr,mic_nongavi
grd,Grenada,2012,mcv1,94,2028,1906,122,amr,mic_nongavi
grd,Grenada,2012,dtp3,97,2028,1967,61,amr,mic_nongavi
grd,Grenada,2012,dtp1,99,2028,2008,20,amr,mic_nongavi
grd,Grenada,2012,mcv2,75,2057,1543,514,amr,mic_nongavi
grd,Grenada,2013,dtp3,97,2028,1967,61,amr,mic_nongavi
grd,Grenada,2013,dtp1,99,2028,2008,20,amr,mic_nongavi
grd,Grenada,2013,mcv1,94,2028,1906,122,amr,mic_nongavi
grd,Grenada,2013,mcv2,85,1974,1678,296,amr,mic_nongavi
grd,Grenada,2014,dtp3,97,2020,1959,61,amr,mic_nongavi
grd,Grenada,2014,dtp1,97,2020,1959,61,amr,mic_nongavi
grd,Grenada,2014,mcv1,94,2020,1899,121,amr,mic_nongavi
grd,Grenada,2014,mcv2,92,1991,1832,159,amr,mic_nongavi
grd,Grenada,2015,dtp3,92,2008,1847,161,amr,mic_nongavi
grd,Grenada,2015,mcv1,99,2008,1988,20,amr,mic_nongavi
grd,Grenada,2015,dtp1,94,2008,1888,120,amr,mic_nongavi
grd,Grenada,2015,mcv2,89,2000,1780,220,amr,mic_nongavi
grd,Grenada,2016,mcv1,95,1988,1889,99,amr,mic_nongavi
grd,Grenada,2016,dtp3,96,1988,1908,80,amr,mic_nongavi
grd,Grenada,2016,dtp1,98,1988,1948,40,amr,mic_nongavi
grd,Grenada,2016,mcv2,85,1985,1687,298,amr,mic_nongavi
gtm,Guatemala,2000,dtp1,94,396339,372559,23780,amr,mic_nongavi
gtm,Guatemala,2000,dtp3,81,396339,321035,75304,amr,mic_nongavi
gtm,Guatemala,2000,mcv1,86,396339,340852,55487,amr,mic_nongavi
gtm,Guatemala,2001,dtp1,93,398904,370981,27923,amr,mic_nongavi
gtm,Guatemala,2001,dtp3,77,398904,307156,91748,amr,mic_nongavi
gtm,Guatemala,2001,mcv1,91,398904,363003,35901,amr,mic_nongavi
gtm,Guatemala,2002,dtp1,93,400242,372225,28017,amr,mic_nongavi
gtm,Guatemala,2002,dtp3,82,400242,328198,72044,amr,mic_nongavi
gtm,Guatemala,2002,mcv1,92,400242,368223,32019,amr,mic_nongavi
gtm,Guatemala,2003,dtp1,96,400351,384337,16014,amr,mic_nongavi
gtm,Guatemala,2003,dtp3,84,400351,336295,64056,amr,mic_nongavi
gtm,Guatemala,2003,mcv1,94,400351,376330,24021,amr,mic_nongavi
gtm,Guatemala,2004,dtp1,98,399396,391408,7988,amr,mic_nongavi
gtm,Guatemala,2004,dtp3,87,399396,347475,51921,amr,mic_nongavi
gtm,Guatemala,2004,mcv1,95,399396,379426,19970,amr,mic_nongavi
gtm,Guatemala,2005,dtp3,87,397732,346027,51705,amr,mic_nongavi
gtm,Guatemala,2005,dtp1,97,397732,385800,11932,amr,mic_nongavi
gtm,Guatemala,2005,mcv1,93,397732,369891,27841,amr,mic_nongavi
gtm,Guatemala,2006,dtp3,89,395834,352292,43542,amr,mic_nongavi
gtm,Guatemala,2006,mcv1,95,395834,376042,19792,amr,mic_nongavi
gtm,Guatemala,2006,dtp1,95,395834,376042,19792,amr,mic_nongavi
gtm,Guatemala,2007,dtp3,85,394206,335075,59131,amr,mic_nongavi
gtm,Guatemala,2007,dtp1,88,394206,346901,47305,amr,mic_nongavi
gtm,Guatemala,2007,mcv1,86,394206,339017,55189,amr,mic_nongavi
gtm,Guatemala,2008,dtp1,99,393248,389316,3932,amr,mic_nongavi
gtm,Guatemala,2008,mcv1,96,393248,377518,15730,amr,mic_nongavi
gtm,Guatemala,2008,dtp3,95,393248,373586,19662,amr,mic_nongavi
gtm,Guatemala,2009,dtp1,94,393173,369583,23590,amr,mic_nongavi
gtm,Guatemala,2009,mcv1,92,393173,361719,31454,amr,mic_nongavi
gtm,Guatemala,2009,dtp3,92,393173,361719,31454,amr,mic_nongavi
gtm,Guatemala,2010,dtp1,96,394080,378317,15763,amr,mic_nongavi
gtm,Guatemala,2010,mcv1,93,394080,366494,27586,amr,mic_nongavi
gtm,Guatemala,2010,dtp3,94,394080,370435,23645,amr,mic_nongavi
gtm,Guatemala,2011,mcv1,89,395912,352362,43550,amr,mic_nongavi
gtm,Guatemala,2011,dtp1,94,395912,372157,23755,amr,mic_nongavi
gtm,Guatemala,2011,dtp3,88,395912,348403,47509,amr,mic_nongavi
gtm,Guatemala,2012,mcv1,93,398345,370461,27884,amr,mic_nongavi
gtm,Guatemala,2012,dtp3,96,398345,382411,15934,amr,mic_nongavi
gtm,Guatemala,2012,dtp1,96,398345,382411,15934,amr,mic_nongavi
gtm,Guatemala,2013,dtp3,85,401074,340913,60161,amr,mic_nongavi
gtm,Guatemala,2013,dtp1,97,401074,389042,12032,amr,mic_nongavi
gtm,Guatemala,2013,mcv1,85,401074,340913,60161,amr,mic_nongavi
gtm,Guatemala,2014,dtp3,73,403943,294878,109065,amr,mic_nongavi
gtm,Guatemala,2014,dtp1,89,403943,359509,44434,amr,mic_nongavi
gtm,Guatemala,2014,mcv1,67,403943,270642,133301,amr,mic_nongavi
gtm,Guatemala,2015,dtp3,74,406813,301042,105771,amr,mic_nongavi
gtm,Guatemala,2015,mcv1,77,406813,313246,93567,amr,mic_nongavi
gtm,Guatemala,2015,dtp1,99,406813,402745,4068,amr,mic_nongavi
gtm,Guatemala,2016,dtp1,96,409579,393196,16383,amr,mic_nongavi
gtm,Guatemala,2016,mcv1,86,409579,352238,57341,amr,mic_nongavi
gtm,Guatemala,2016,dtp3,80,409579,327663,81916,amr,mic_nongavi
gtm,Guatemala,2016,mcv2,65,403340,262171,141169,amr,mic_nongavi
guy,Guyana,2000,dtp3,88,18658,16419,2239,amr,gavi
guy,Guyana,2000,mcv1,86,18658,16046,2612,amr,gavi
guy,Guyana,2000,dtp1,97,18658,18098,560,amr,gavi
guy,Guyana,2001,dtp1,98,18208,17844,364,amr,gavi
guy,Guyana,2001,mcv1,92,18208,16751,1457,amr,gavi
guy,Guyana,2001,dtp3,85,18208,15477,2731,amr,gavi
guy,Guyana,2001,mcv2,88,19375,17050,2325,amr,gavi
guy,Guyana,2002,dtp1,96,17727,17018,709,amr,gavi
guy,Guyana,2002,mcv1,93,17727,16486,1241,amr,gavi
guy,Guyana,2002,dtp3,91,17727,16132,1595,amr,gavi
guy,Guyana,2002,mcv2,80,18470,14776,3694,amr,gavi
guy,Guyana,2003,dtp1,93,17238,16031,1207,amr,gavi
guy,Guyana,2003,mcv1,89,17238,15342,1896,amr,gavi
guy,Guyana,2003,dtp3,90,17238,15514,1724,amr,gavi
guy,Guyana,2003,mcv2,71,17597,12494,5103,amr,gavi
guy,Guyana,2004,dtp1,97,16761,16258,503,amr,gavi
guy,Guyana,2004,dtp3,91,16761,15253,1508,amr,gavi
guy,Guyana,2004,mcv1,88,16761,14750,2011,amr,gavi
guy,Guyana,2004,mcv2,63,17625,11104,6521,amr,gavi
guy,Guyana,2005,dtp1,93,16324,15181,1143,amr,gavi
guy,Guyana,2005,mcv1,92,16324,15018,1306,amr,gavi
guy,Guyana,2005,dtp3,93,16324,15181,1143,amr,gavi
guy,Guyana,2005,mcv2,72,16968,12217,4751,amr,gavi
guy,Guyana,2006,dtp1,95,15956,15158,798,amr,gavi
guy,Guyana,2006,dtp3,93,15956,14839,1117,amr,gavi
guy,Guyana,2006,mcv1,90,15956,14360,1596,amr,gavi
guy,Guyana,2006,mcv2,74,16497,12208,4289,amr,gavi
guy,Guyana,2007,mcv1,96,15666,15039,627,amr,gavi
guy,Guyana,2007,dtp3,94,15666,14726,940,amr,gavi
guy,Guyana,2007,dtp1,96,15666,15039,627,amr,gavi
guy,Guyana,2007,mcv2,90,16101,14491,1610,amr,gavi
guy,Guyana,2008,mcv1,95,15459,14686,773,amr,gavi
guy,Guyana,2008,dtp1,94,15459,14531,928,amr,gavi
guy,Guyana,2008,dtp3,93,15459,14377,1082,amr,gavi
guy,Guyana,2008,mcv2,84,15758,13237,2521,amr,gavi
guy,Guyana,2009,dtp3,98,15335,15028,307,amr,gavi
guy,Guyana,2009,dtp1,99,15335,15182,153,amr,gavi
guy,Guyana,2009,mcv1,97,15335,14875,460,amr,gavi
guy,Guyana,2009,mcv2,84,15304,12855,2449,amr,gavi
guy,Guyana,2010,mcv1,95,15284,14520,764,amr,gavi
guy,Guyana,2010,dtp1,99,15284,15131,153,amr,gavi
guy,Guyana,2010,dtp3,95,15284,14520,764,amr,gavi
guy,Guyana,2010,mcv2,82,15092,12375,2717,amr,gavi
guy,Guyana,2011,dtp1,97,15291,14832,459,amr,gavi
guy,Guyana,2011,mcv1,98,15291,14985,306,amr,gavi
guy,Guyana,2011,dtp3,93,15291,14221,1070,amr,gavi
guy,Guyana,2011,mcv2,84,14793,12426,2367,amr,gavi
guy,Guyana,2012,dtp1,99,15326,15173,153,amr,gavi
guy,Guyana,2012,mcv1,99,15326,15173,153,amr,gavi
guy,Guyana,2012,dtp3,97,15326,14866,460,amr,gavi
guy,Guyana,2012,mcv2,90,14572,13115,1457,amr,gavi
guy,Guyana,2013,dtp3,98,15367,15060,307,amr,gavi
guy,Guyana,2013,dtp1,98,15367,15060,307,amr,gavi
guy,Guyana,2013,mcv1,99,15367,15213,154,amr,gavi
guy,Guyana,2013,mcv2,95,14444,13722,722,amr,gavi
guy,Guyana,2014,dtp3,98,15398,15090,308,amr,gavi
guy,Guyana,2014,dtp1,99,15398,15244,154,amr,gavi
guy,Guyana,2014,mcv1,99,15398,15244,154,amr,gavi
guy,Guyana,2014,mcv2,91,14518,13211,1307,amr,gavi
guy,Guyana,2015,mcv1,99,15406,15252,154,amr,gavi
guy,Guyana,2015,dtp1,96,15406,14790,616,amr,gavi
guy,Guyana,2015,dtp3,95,15406,14636,770,amr,gavi
guy,Guyana,2015,mcv2,95,14544,13817,727,amr,gavi
guy,Guyana,2016,dtp1,97,15387,14925,462,amr,gavi
guy,Guyana,2016,mcv1,99,15387,15233,154,amr,gavi
guy,Guyana,2016,dtp3,97,15387,14925,462,amr,gavi
guy,Guyana,2016,mcv2,94,14834,13944,890,amr,gavi
hnd,Honduras,2000,dtp3,94,206136,193768,12368,amr,gavi
hnd,Honduras,2000,mcv1,98,206136,202013,4123,amr,gavi
hnd,Honduras,2000,dtp1,98,206136,202013,4123,amr,gavi
hnd,Honduras,2001,dtp3,96,206870,198595,8275,amr,gavi
hnd,Honduras,2001,dtp1,98,206870,202733,4137,amr,gavi
hnd,Honduras,2001,mcv1,98,206870,202733,4137,amr,gavi
hnd,Honduras,2002,dtp1,98,207165,203022,4143,amr,gavi
hnd,Honduras,2002,dtp3,95,207165,196807,10358,amr,gavi
hnd,Honduras,2002,mcv1,95,207165,196807,10358,amr,gavi
hnd,Honduras,2003,dtp3,92,207007,190446,16561,amr,gavi
hnd,Honduras,2003,mcv1,91,207007,188376,18631,amr,gavi
hnd,Honduras,2003,dtp1,97,207007,200797,6210,amr,gavi
hnd,Honduras,2004,dtp3,94,206412,194027,12385,amr,gavi
hnd,Honduras,2004,dtp1,98,206412,202284,4128,amr,gavi
hnd,Honduras,2004,mcv1,87,206412,179578,26834,amr,gavi
hnd,Honduras,2005,dtp3,98,205378,201270,4108,amr,gavi
hnd,Honduras,2005,dtp1,99,205378,203324,2054,amr,gavi
hnd,Honduras,2005,mcv1,90,205378,184840,20538,amr,gavi
hnd,Honduras,2006,dtp1,95,203914,193718,10196,amr,gavi
hnd,Honduras,2006,dtp3,95,203914,193718,10196,amr,gavi
hnd,Honduras,2006,mcv1,91,203914,185562,18352,amr,gavi
hnd,Honduras,2007,dtp1,94,202111,189984,12127,amr,gavi
hnd,Honduras,2007,dtp3,94,202111,189984,12127,amr,gavi
hnd,Honduras,2007,mcv1,89,202111,179879,22232,amr,gavi
hnd,Honduras,2008,dtp1,96,200106,192102,8004,amr,gavi
hnd,Honduras,2008,mcv1,87,200106,174092,26014,amr,gavi
hnd,Honduras,2008,dtp3,93,200106,186099,14007,amr,gavi
hnd,Honduras,2009,dtp1,99,198043,196063,1980,amr,gavi
hnd,Honduras,2009,mcv1,90,198043,178239,19804,amr,gavi
hnd,Honduras,2009,dtp3,97,198043,192102,5941,amr,gavi
hnd,Honduras,2010,dtp1,99,196117,194156,1961,amr,gavi
hnd,Honduras,2010,dtp3,97,196117,190233,5884,amr,gavi
hnd,Honduras,2010,mcv1,89,196117,174544,21573,amr,gavi
hnd,Honduras,2011,mcv1,88,194521,171178,23343,amr,gavi
hnd,Honduras,2011,dtp3,97,194521,188685,5836,amr,gavi
hnd,Honduras,2011,dtp1,99,194521,192576,1945,amr,gavi
hnd,Honduras,2012,dtp3,97,193353,187552,5801,amr,gavi
hnd,Honduras,2012,dtp1,99,193353,191419,1934,amr,gavi
hnd,Honduras,2012,mcv1,88,193353,170151,23202,amr,gavi
hnd,Honduras,2013,dtp3,97,192658,186878,5780,amr,gavi
hnd,Honduras,2013,mcv1,88,192658,169539,23119,amr,gavi
hnd,Honduras,2013,dtp1,99,192658,190731,1927,amr,gavi
hnd,Honduras,2014,dtp3,97,192441,186668,5773,amr,gavi
hnd,Honduras,2014,mcv1,88,192441,169348,23093,amr,gavi
hnd,Honduras,2014,dtp1,99,192441,190517,1924,amr,gavi
hnd,Honduras,2015,dtp3,97,192648,186869,5779,amr,gavi
hnd,Honduras,2015,dtp1,99,192648,190722,1926,amr,gavi
hnd,Honduras,2015,mcv1,88,192648,169530,23118,amr,gavi
hnd,Honduras,2016,dtp3,97,193163,187368,5795,amr,gavi
hnd,Honduras,2016,dtp1,99,193163,191231,1932,amr,gavi
hnd,Honduras,2016,mcv1,88,193163,169983,23180,amr,gavi
hrv,Croatia,2000,dtp3,93,44761,41628,3133,eur,hic
hrv,Croatia,2000,mcv1,93,44761,41628,3133,eur,hic
hrv,Croatia,2000,dtp1,95,44761,42523,2238,eur,hic
hrv,Croatia,2001,mcv1,94,43548,40935,2613,eur,hic
hrv,Croatia,2001,dtp3,94,43548,40935,2613,eur,hic
hrv,Croatia,2001,dtp1,94,43548,40935,2613,eur,hic
hrv,Croatia,2001,mcv2,98,46027,45106,921,eur,hic
hrv,Croatia,2002,dtp3,95,42588,40459,2129,eur,hic
hrv,Croatia,2002,mcv1,95,42588,40459,2129,eur,hic
hrv,Croatia,2002,dtp1,99,42588,42162,426,eur,hic
hrv,Croatia,2002,mcv2,98,46524,45594,930,eur,hic
hrv,Croatia,2003,mcv1,95,42020,39919,2101,eur,hic
hrv,Croatia,2003,dtp1,98,42020,41180,840,eur,hic
hrv,Croatia,2003,dtp3,94,42020,39499,2521,eur,hic
hrv,Croatia,2003,mcv2,98,47531,46580,951,eur,hic
hrv,Croatia,2004,mcv1,96,41857,40183,1674,eur,hic
hrv,Croatia,2004,dtp1,96,41857,40183,1674,eur,hic
hrv,Croatia,2004,dtp3,96,41857,40183,1674,eur,hic
hrv,Croatia,2004,mcv2,98,48467,47498,969,eur,hic
hrv,Croatia,2005,mcv1,96,42033,40352,1681,eur,hic
hrv,Croatia,2005,dtp3,96,42033,40352,1681,eur,hic
hrv,Croatia,2005,dtp1,96,42033,40352,1681,eur,hic
hrv,Croatia,2005,mcv2,98,48547,47576,971,eur,hic
hrv,Croatia,2006,dtp1,96,42409,40713,1696,eur,hic
hrv,Croatia,2006,dtp3,96,42409,40713,1696,eur,hic
hrv,Croatia,2006,mcv1,95,42409,40289,2120,eur,hic
hrv,Croatia,2006,mcv2,98,47647,46694,953,eur,hic
hrv,Croatia,2007,dtp1,96,42782,41071,1711,eur,hic
hrv,Croatia,2007,dtp3,96,42782,41071,1711,eur,hic
hrv,Croatia,2007,mcv1,96,42782,41071,1711,eur,hic
hrv,Croatia,2007,mcv2,98,45778,44862,916,eur,hic
hrv,Croatia,2008,mcv1,98,42993,42133,860,eur,hic
hrv,Croatia,2008,dtp3,96,42993,41273,1720,eur,hic
hrv,Croatia,2008,dtp1,97,42993,41703,1290,eur,hic
hrv,Croatia,2008,mcv2,98,43486,42616,870,eur,hic
hrv,Croatia,2009,dtp1,97,42976,41687,1289,eur,hic
hrv,Croatia,2009,dtp3,96,42976,41257,1719,eur,hic
hrv,Croatia,2009,mcv1,95,42976,40827,2149,eur,hic
hrv,Croatia,2009,mcv2,98,41355,40528,827,eur,hic
hrv,Croatia,2010,dtp3,97,42699,41418,1281,eur,hic
hrv,Croatia,2010,dtp1,97,42699,41418,1281,eur,hic
hrv,Croatia,2010,mcv1,96,42699,40991,1708,eur,hic
hrv,Croatia,2010,mcv2,98,41121,40299,822,eur,hic
hrv,Croatia,2011,dtp3,96,42184,40497,1687,eur,hic
hrv,Croatia,2011,dtp1,97,42184,40918,1266,eur,hic
hrv,Croatia,2011,mcv1,96,42184,40497,1687,eur,hic
hrv,Croatia,2011,mcv2,98,40025,39224,801,eur,hic
hrv,Croatia,2012,dtp3,96,41527,39866,1661,eur,hic
hrv,Croatia,2012,mcv1,95,41527,39451,2076,eur,hic
hrv,Croatia,2012,dtp1,98,41527,40696,831,eur,hic
hrv,Croatia,2012,mcv2,97,40850,39624,1226,eur,hic
hrv,Croatia,2013,dtp3,96,40810,39178,1632,eur,hic
hrv,Croatia,2013,mcv1,94,40810,38361,2449,eur,hic
hrv,Croatia,2013,dtp1,98,40810,39994,816,eur,hic
hrv,Croatia,2013,mcv2,97,42180,40915,1265,eur,hic
hrv,Croatia,2014,mcv1,94,40065,37661,2404,eur,hic
hrv,Croatia,2014,dtp1,98,40065,39264,801,eur,hic
hrv,Croatia,2014,dtp3,95,40065,38062,2003,eur,hic
hrv,Croatia,2014,mcv2,97,43522,42216,1306,eur,hic
hrv,Croatia,2015,mcv1,93,39323,36570,2753,eur,hic
hrv,Croatia,2015,dtp3,94,39323,36964,2359,eur,hic
hrv,Croatia,2015,dtp1,98,39323,38537,786,eur,hic
hrv,Croatia,2015,mcv2,96,44159,42393,1766,eur,hic
hrv,Croatia,2016,dtp1,98,38597,37825,772,eur,hic
hrv,Croatia,2016,mcv1,90,38597,34737,3860,eur,hic
hrv,Croatia,2016,dtp3,93,38597,35895,2702,eur,hic
hrv,Croatia,2016,mcv2,96,44064,42301,1763,eur,hic
hti,Haiti,2000,dtp1,73,249453,182101,67352,amr,gavi
hti,Haiti,2000,dtp3,41,249453,102276,147177,amr,gavi
hti,Haiti,2000,mcv1,55,249453,137199,112254,amr,gavi
hti,Haiti,2001,dtp1,75,249878,187408,62470,amr,gavi
hti,Haiti,2001,dtp3,45,249878,112445,137433,amr,gavi
hti,Haiti,2001,mcv1,55,249878,137433,112445,amr,gavi
hti,Haiti,2002,mcv1,56,250366,140205,110161,amr,gavi
hti,Haiti,2002,dtp3,48,250366,120176,130190,amr,gavi
hti,Haiti,2002,dtp1,77,250366,192782,57584,amr,gavi
hti,Haiti,2003,dtp1,79,250965,198262,52703,amr,gavi
hti,Haiti,2003,mcv1,57,250965,143050,107915,amr,gavi
hti,Haiti,2003,dtp3,53,250965,133011,117954,amr,gavi
hti,Haiti,2004,dtp3,55,251660,138413,113247,amr,gavi
hti,Haiti,2004,mcv1,57,251660,143446,108214,amr,gavi
hti,Haiti,2004,dtp1,81,251660,203845,47815,amr,gavi
hti,Haiti,2005,dtp3,60,252386,151432,100954,amr,gavi
hti,Haiti,2005,dtp1,83,252386,209480,42906,amr,gavi
hti,Haiti,2005,mcv1,58,252386,146384,106002,amr,gavi
hti,Haiti,2006,mcv1,59,253029,149287,103742,amr,gavi
hti,Haiti,2006,dtp3,60,253029,151817,101212,amr,gavi
hti,Haiti,2006,dtp1,84,253029,212544,40485,amr,gavi
hti,Haiti,2007,dtp3,63,253483,159694,93789,amr,gavi
hti,Haiti,2007,mcv1,60,253483,152090,101393,amr,gavi
hti,Haiti,2007,dtp1,85,253483,215461,38022,amr,gavi
hti,Haiti,2008,dtp1,86,253676,218161,35515,amr,gavi
hti,Haiti,2008,dtp3,63,253676,159816,93860,amr,gavi
hti,Haiti,2008,mcv1,62,253676,157279,96397,amr,gavi
hti,Haiti,2009,dtp1,86,253602,218098,35504,amr,gavi
hti,Haiti,2009,dtp3,65,253602,164841,88761,amr,gavi
hti,Haiti,2009,mcv1,63,253602,159769,93833,amr,gavi
hti,Haiti,2010,dtp1,87,253303,220374,32929,amr,gavi
hti,Haiti,2010,mcv1,64,253303,162114,91189,amr,gavi
hti,Haiti,2010,dtp3,66,253303,167180,86123,amr,gavi
hti,Haiti,2011,dtp1,88,252864,222520,30344,amr,gavi
hti,Haiti,2011,mcv1,65,252864,164362,88502,amr,gavi
hti,Haiti,2011,dtp3,68,252864,171948,80916,amr,gavi
hti,Haiti,2012,mcv1,65,252389,164053,88336,amr,gavi
hti,Haiti,2012,dtp3,67,252389,169101,83288,amr,gavi
hti,Haiti,2012,dtp1,87,252389,219578,32811,amr,gavi
hti,Haiti,2013,dtp1,86,251952,216679,35273,amr,gavi
hti,Haiti,2013,dtp3,68,251952,171327,80625,amr,gavi
hti,Haiti,2013,mcv1,65,251952,163769,88183,amr,gavi
hti,Haiti,2014,dtp3,48,251571,120754,130817,amr,gavi
hti,Haiti,2014,dtp1,72,251571,181131,70440,amr,gavi
hti,Haiti,2014,mcv1,53,251571,133333,118238,amr,gavi
hti,Haiti,2015,mcv1,53,251233,133153,118080,amr,gavi
hti,Haiti,2015,dtp3,60,251233,150740,100493,amr,gavi
hti,Haiti,2015,dtp1,80,251233,200986,50247,amr,gavi
hti,Haiti,2016,mcv1,53,250891,132972,117919,amr,gavi
hti,Haiti,2016,dtp1,78,250891,195695,55196,amr,gavi
hti,Haiti,2016,dtp3,58,250891,145517,105374,amr,gavi
hti,Haiti,2016,mcv2,26,246719,64147,182572,amr,gavi
hun,Hungary,2000,mcv1,99,95187,94235,952,eur,hic
hun,Hungary,2000,dtp3,99,95187,94235,952,eur,hic
hun,Hungary,2000,dtp1,99,95187,94235,952,eur,hic
hun,Hungary,2000,mcv2,99,125650,124394,1256,eur,hic
hun,Hungary,2001,dtp3,99,94482,93537,945,eur,hic
hun,Hungary,2001,mcv1,99,94482,93537,945,eur,hic
hun,Hungary,2001,dtp1,99,94482,93537,945,eur,hic
hun,Hungary,2001,mcv2,99,124450,123206,1244,eur,hic
hun,Hungary,2002,mcv1,99,94284,93341,943,eur,hic
hun,Hungary,2002,dtp1,99,94284,93341,943,eur,hic
hun,Hungary,2002,dtp3,99,94284,93341,943,eur,hic
hun,Hungary,2002,mcv2,99,123304,122071,1233,eur,hic
hun,Hungary,2003,dtp3,99,94352,93408,944,eur,hic
hun,Hungary,2003,dtp1,99,94352,93408,944,eur,hic
hun,Hungary,2003,mcv1,99,94352,93408,944,eur,hic
hun,Hungary,2003,mcv2,99,122461,121236,1225,eur,hic
hun,Hungary,2004,dtp1,99,94549,93604,945,eur,hic
hun,Hungary,2004,mcv1,99,94549,93604,945,eur,hic
hun,Hungary,2004,dtp3,99,94549,93604,945,eur,hic
hun,Hungary,2004,mcv2,99,120770,119562,1208,eur,hic
hun,Hungary,2005,dtp1,99,94707,93760,947,eur,hic
hun,Hungary,2005,dtp3,99,94707,93760,947,eur,hic
hun,Hungary,2005,mcv1,99,94707,93760,947,eur,hic
hun,Hungary,2005,mcv2,99,116798,115630,1168,eur,hic
hun,Hungary,2006,mcv1,99,94680,93733,947,eur,hic
hun,Hungary,2006,dtp3,99,94680,93733,947,eur,hic
hun,Hungary,2006,dtp1,99,94680,93733,947,eur,hic
hun,Hungary,2006,mcv2,99,112438,111314,1124,eur,hic
hun,Hungary,2007,dtp3,99,94418,93474,944,eur,hic
hun,Hungary,2007,dtp1,99,94418,93474,944,eur,hic
hun,Hungary,2007,mcv1,99,94418,93474,944,eur,hic
hun,Hungary,2007,mcv2,99,108192,107110,1082,eur,hic
hun,Hungary,2008,dtp3,99,93902,92963,939,eur,hic
hun,Hungary,2008,dtp1,99,93902,92963,939,eur,hic
hun,Hungary,2008,mcv1,99,93902,92963,939,eur,hic
hun,Hungary,2008,mcv2,99,103444,102410,1034,eur,hic
hun,Hungary,2009,mcv1,99,93125,92194,931,eur,hic
hun,Hungary,2009,dtp3,99,93125,92194,931,eur,hic
hun,Hungary,2009,dtp1,99,93125,92194,931,eur,hic
hun,Hungary,2009,mcv2,99,99219,98227,992,eur,hic
hun,Hungary,2010,mcv1,99,92139,91218,921,eur,hic
hun,Hungary,2010,dtp1,99,92139,91218,921,eur,hic
hun,Hungary,2010,dtp3,99,92139,91218,921,eur,hic
hun,Hungary,2010,mcv2,96,97520,93619,3901,eur,hic
hun,Hungary,2011,dtp1,99,91048,90138,910,eur,hic
hun,Hungary,2011,dtp3,99,91048,90138,910,eur,hic
hun,Hungary,2011,mcv1,99,91048,90138,910,eur,hic
hun,Hungary,2011,mcv2,99,97489,96514,975,eur,hic
hun,Hungary,2012,mcv1,99,89988,89088,900,eur,hic
hun,Hungary,2012,dtp3,99,89988,89088,900,eur,hic
hun,Hungary,2012,dtp1,99,89988,89088,900,eur,hic
hun,Hungary,2012,mcv2,99,97057,96086,971,eur,hic
hun,Hungary,2013,dtp3,99,89063,88172,891,eur,hic
hun,Hungary,2013,dtp1,99,89063,88172,891,eur,hic
hun,Hungary,2013,mcv1,99,89063,88172,891,eur,hic
hun,Hungary,2013,mcv2,99,96541,95576,965,eur,hic
hun,Hungary,2014,dtp3,99,88309,87426,883,eur,hic
hun,Hungary,2014,mcv1,99,88309,87426,883,eur,hic
hun,Hungary,2014,dtp1,99,88309,87426,883,eur,hic
hun,Hungary,2014,mcv2,99,96319,95356,963,eur,hic
hun,Hungary,2015,mcv1,99,87732,86855,877,eur,hic
hun,Hungary,2015,dtp3,99,87732,86855,877,eur,hic
hun,Hungary,2015,dtp1,99,87732,86855,877,eur,hic
hun,Hungary,2015,mcv2,99,96351,95387,964,eur,hic
hun,Hungary,2016,mcv1,99,87299,86426,873,eur,hic
hun,Hungary,2016,dtp3,99,87299,86426,873,eur,hic
hun,Hungary,2016,dtp1,99,87299,86426,873,eur,hic
hun,Hungary,2016,mcv2,99,96708,95741,967,eur,hic
idn,Indonesia,2000,dtp3,75,4424731,3318548,1106183,sear,gavi
idn,Indonesia,2000,dtp1,84,4424731,3716774,707957,sear,gavi
idn,Indonesia,2000,mcv1,76,4424731,3362796,1061935,sear,gavi
idn,Indonesia,2001,dtp3,76,4501606,3421221,1080385,sear,gavi
idn,Indonesia,2001,dtp1,82,4501606,3691317,810289,sear,gavi
idn,Indonesia,2001,mcv1,76,4501606,3421221,1080385,sear,gavi
idn,Indonesia,2002,dtp3,70,4580090,3206063,1374027,sear,gavi
idn,Indonesia,2002,dtp1,83,4580090,3801475,778615,sear,gavi
idn,Indonesia,2002,mcv1,72,4580090,3297665,1282425,sear,gavi
idn,Indonesia,2003,dtp1,84,4653084,3908591,744493,sear,gavi
idn,Indonesia,2003,dtp3,71,4653084,3303690,1349394,sear,gavi
idn,Indonesia,2003,mcv1,74,4653084,3443282,1209802,sear,gavi
idn,Indonesia,2003,mcv2,21,4454635,935473,3519162,sear,gavi
idn,Indonesia,2004,mcv1,76,4716726,3584712,1132014,sear,gavi
idn,Indonesia,2004,dtp1,84,4716726,3962050,754676,sear,gavi
idn,Indonesia,2004,dtp3,71,4716726,3348875,1367851,sear,gavi
idn,Indonesia,2004,mcv2,29,4501327,1305385,3195942,sear,gavi
idn,Indonesia,2005,dtp1,85,4769365,4053960,715405,sear,gavi
idn,Indonesia,2005,mcv1,77,4769365,3672411,1096954,sear,gavi
idn,Indonesia,2005,dtp3,72,4769365,3433943,1335422,sear,gavi
idn,Indonesia,2005,mcv2,23,4552804,1047145,3505659,sear,gavi
idn,Indonesia,2006,mcv1,79,4811876,3801382,1010494,sear,gavi
idn,Indonesia,2006,dtp3,72,4811876,3464551,1347325,sear,gavi
idn,Indonesia,2006,dtp1,86,4811876,4138213,673663,sear,gavi
idn,Indonesia,2006,mcv2,50,4567698,2283849,2283849,sear,gavi
idn,Indonesia,2007,dtp3,73,4847605,3538752,1308853,sear,gavi
idn,Indonesia,2007,mcv1,76,4847605,3684180,1163425,sear,gavi
idn,Indonesia,2007,dtp1,87,4847605,4217416,630189,sear,gavi
idn,Indonesia,2007,mcv2,73,4603536,3360581,1242955,sear,gavi
idn,Indonesia,2008,dtp3,77,4878742,3756631,1122111,sear,gavi
idn,Indonesia,2008,dtp1,92,4878742,4488443,390299,sear,gavi
idn,Indonesia,2008,mcv1,76,4878742,3707844,1170898,sear,gavi
idn,Indonesia,2008,mcv2,66,4655939,3072920,1583019,sear,gavi
idn,Indonesia,2009,mcv1,74,4904852,3629590,1275262,sear,gavi
idn,Indonesia,2009,dtp1,94,4904852,4610561,294291,sear,gavi
idn,Indonesia,2009,dtp3,78,4904852,3825785,1079067,sear,gavi
idn,Indonesia,2009,mcv2,67,4720895,3163000,1557895,sear,gavi
idn,Indonesia,2010,dtp1,97,4924235,4776508,147727,sear,gavi
idn,Indonesia,2010,mcv1,78,4924235,3840903,1083332,sear,gavi
idn,Indonesia,2010,dtp3,81,4924235,3988630,935605,sear,gavi
idn,Indonesia,2010,mcv2,74,4761912,3523815,1238097,sear,gavi
idn,Indonesia,2011,dtp1,98,4934629,4835936,98693,sear,gavi
idn,Indonesia,2011,dtp3,81,4934629,3997049,937580,sear,gavi
idn,Indonesia,2011,mcv1,80,4934629,3947703,986926,sear,gavi
idn,Indonesia,2011,mcv2,76,4792476,3642282,1150194,sear,gavi
idn,Indonesia,2012,dtp3,83,4934726,4095823,838903,sear,gavi
idn,Indonesia,2012,mcv1,82,4934726,4046475,888251,sear,gavi
idn,Indonesia,2012,dtp1,97,4934726,4786684,148042,sear,gavi
idn,Indonesia,2012,mcv2,78,4787912,3734571,1053341,sear,gavi
idn,Indonesia,2013,dtp3,85,4924308,4185662,738646,sear,gavi
idn,Indonesia,2013,mcv1,81,4924308,3988689,935619,sear,gavi
idn,Indonesia,2013,dtp1,96,4924308,4727336,196972,sear,gavi
idn,Indonesia,2013,mcv2,76,4760043,3617633,1142410,sear,gavi
idn,Indonesia,2014,dtp3,78,4904271,3825331,1078940,sear,gavi
idn,Indonesia,2014,mcv1,75,4904271,3678203,1226068,sear,gavi
idn,Indonesia,2014,dtp1,95,4904271,4659057,245214,sear,gavi
idn,Indonesia,2014,mcv2,28,4733917,1325497,3408420,sear,gavi
idn,Indonesia,2015,dtp3,78,4876301,3803515,1072786,sear,gavi
idn,Indonesia,2015,dtp1,95,4876301,4632486,243815,sear,gavi
idn,Indonesia,2015,mcv1,75,4876301,3657226,1219075,sear,gavi
idn,Indonesia,2015,mcv2,31,4727466,1465514,3261952,sear,gavi
idn,Indonesia,2016,dtp1,95,4842706,4600571,242135,sear,gavi
idn,Indonesia,2016,mcv1,76,4842706,3680457,1162249,sear,gavi
idn,Indonesia,2016,dtp3,79,4842706,3825738,1016968,sear,gavi
idn,Indonesia,2016,mcv2,56,4749323,2659621,2089702,sear,gavi
ind,India,2000,dtp1,74,26056558,19281853,6774705,sear,gavi
ind,India,2000,mcv1,56,26056558,14591672,11464886,sear,gavi
ind,India,2000,dtp3,58,26056558,15112804,10943754,sear,gavi
ind,India,2001,dtp3,59,26121579,15411732,10709847,sear,gavi
ind,India,2001,dtp1,75,26121579,19591184,6530395,sear,gavi
ind,India,2001,mcv1,57,26121579,14889300,11232279,sear,gavi
ind,India,2002,dtp1,75,26169288,19626966,6542322,sear,gavi
ind,India,2002,dtp3,59,26169288,15439880,10729408,sear,gavi
ind,India,2002,mcv1,56,26169288,14654801,11514487,sear,gavi
ind,India,2003,mcv1,60,26195467,15717280,10478187,sear,gavi
ind,India,2003,dtp3,61,26195467,15979235,10216232,sear,gavi
ind,India,2003,dtp1,76,26195467,19908555,6286912,sear,gavi
ind,India,2004,mcv1,64,26194223,16764303,9429920,sear,gavi
ind,India,2004,dtp3,63,26194223,16502360,9691863,sear,gavi
ind,India,2004,dtp1,77,26194223,20169552,6024671,sear,gavi
ind,India,2005,mcv1,68,26151006,17782684,8368322,sear,gavi
ind,India,2005,dtp3,65,26151006,16998154,9152852,sear,gavi
ind,India,2005,dtp1,82,26151006,21443825,4707181,sear,gavi
ind,India,2006,mcv1,69,26049522,17974170,8075352,sear,gavi
ind,India,2006,dtp1,81,26049522,21100113,4949409,sear,gavi
ind,India,2006,dtp3,65,26049522,16932189,9117333,sear,gavi
ind,India,2007,mcv1,70,25886789,18120752,7766037,sear,gavi
ind,India,2007,dtp1,81,25886789,20968299,4918490,sear,gavi
ind,India,2007,dtp3,64,25886789,16567545,9319244,sear,gavi
ind,India,2008,dtp3,70,25668962,17968273,7700689,sear,gavi
ind,India,2008,dtp1,81,25668962,20791859,4877103,sear,gavi
ind,India,2008,mcv1,72,25668962,18481653,7187309,sear,gavi
ind,India,2009,dtp1,84,25408638,21343256,4065382,sear,gavi
ind,India,2009,mcv1,78,25408638,19818738,5589900,sear,gavi
ind,India,2009,dtp3,74,25408638,18802392,6606246,sear,gavi
ind,India,2010,dtp1,86,25130311,21612067,3518244,sear,gavi
ind,India,2010,mcv1,82,25130311,20606855,4523456,sear,gavi
ind,India,2010,dtp3,79,25130311,19852946,5277365,sear,gavi
ind,India,2011,dtp3,82,24864060,20388529,4475531,sear,gavi
ind,India,2011,dtp1,89,24864060,22129013,2735047,sear,gavi
ind,India,2011,mcv1,84,24864060,20885810,3978250,sear,gavi
ind,India,2011,mcv2,27,25606482,6913750,18692732,sear,gavi
ind,India,2012,dtp3,82,24635255,20200909,4434346,sear,gavi
ind,India,2012,dtp1,89,24635255,21925377,2709878,sear,gavi
ind,India,2012,mcv1,83,24635255,20447262,4187993,sear,gavi
ind,India,2012,mcv2,36,25428418,9154230,16274188,sear,gavi
ind,India,2013,dtp1,90,24461069,22014962,2446107,sear,gavi
ind,India,2013,dtp3,83,24461069,20302687,4158382,sear,gavi
ind,India,2013,mcv1,83,24461069,20302687,4158382,sear,gavi
ind,India,2013,mcv2,51,24881578,12689605,12191973,sear,gavi
ind,India,2014,dtp3,85,24347563,20695429,3652134,sear,gavi
ind,India,2014,dtp1,90,24347563,21912807,2434756,sear,gavi
ind,India,2014,mcv1,85,24347563,20695429,3652134,sear,gavi
ind,India,2014,mcv2,60,24586610,14751966,9834644,sear,gavi
ind,India,2015,dtp1,90,24290936,21861842,2429094,sear,gavi
ind,India,2015,dtp3,87,24290936,21133114,3157822,sear,gavi
ind,India,2015,mcv1,87,24290936,21133114,3157822,sear,gavi
ind,India,2015,mcv2,69,24350084,16801558,7548526,sear,gavi
ind,India,2016,dtp3,88,24277064,21363816,2913248,sear,gavi
ind,India,2016,mcv1,88,24277064,21363816,2913248,sear,gavi
ind,India,2016,dtp1,91,24277064,22092128,2184936,sear,gavi
ind,India,2016,mcv2,76,23935868,18191260,5744608,sear,gavi
irl,Ireland,2000,dtp3,86,57462,49417,8045,eur,hic
irl,Ireland,2000,dtp1,95,57462,54589,2873,eur,hic
irl,Ireland,2000,mcv1,79,57462,45395,12067,eur,hic
irl,Ireland,2001,dtp3,84,59232,49755,9477,eur,hic
irl,Ireland,2001,mcv1,73,59232,43239,15993,eur,hic
irl,Ireland,2001,dtp1,94,59232,55678,3554,eur,hic
irl,Ireland,2002,dtp3,83,61122,50731,10391,eur,hic
irl,Ireland,2002,dtp1,94,61122,57455,3667,eur,hic
irl,Ireland,2002,mcv1,73,61122,44619,16503,eur,hic
irl,Ireland,2003,dtp3,86,63102,54268,8834,eur,hic
irl,Ireland,2003,mcv1,78,63102,49220,13882,eur,hic
irl,Ireland,2003,dtp1,95,63102,59947,3155,eur,hic
irl,Ireland,2004,dtp3,89,65096,57935,7161,eur,hic
irl,Ireland,2004,dtp1,96,65096,62492,2604,eur,hic
irl,Ireland,2004,mcv1,81,65096,52728,12368,eur,hic
irl,Ireland,2005,dtp1,96,67010,64330,2680,eur,hic
irl,Ireland,2005,mcv1,84,67010,56288,10722,eur,hic
irl,Ireland,2005,dtp3,90,67010,60309,6701,eur,hic
irl,Ireland,2006,dtp3,91,68746,62559,6187,eur,hic
irl,Ireland,2006,mcv1,86,68746,59122,9624,eur,hic
irl,Ireland,2006,dtp1,97,68746,66684,2062,eur,hic
irl,Ireland,2007,dtp3,92,70227,64609,5618,eur,hic
irl,Ireland,2007,dtp1,97,70227,68120,2107,eur,hic
irl,Ireland,2007,mcv1,87,70227,61097,9130,eur,hic
irl,Ireland,2008,dtp3,93,71378,66382,4996,eur,hic
irl,Ireland,2008,mcv1,89,71378,63526,7852,eur,hic
irl,Ireland,2008,dtp1,97,71378,69237,2141,eur,hic
irl,Ireland,2009,mcv1,90,72147,64932,7215,eur,hic
irl,Ireland,2009,dtp3,94,72147,67818,4329,eur,hic
irl,Ireland,2009,dtp1,98,72147,70704,1443,eur,hic
irl,Ireland,2010,mcv1,90,72477,65229,7248,eur,hic
irl,Ireland,2010,dtp3,94,72477,68128,4349,eur,hic
irl,Ireland,2010,dtp1,98,72477,71027,1450,eur,hic
irl,Ireland,2011,mcv1,92,72336,66549,5787,eur,hic
irl,Ireland,2011,dtp3,95,72336,68719,3617,eur,hic
irl,Ireland,2011,dtp1,98,72336,70889,1447,eur,hic
irl,Ireland,2012,dtp3,95,71782,68193,3589,eur,hic
irl,Ireland,2012,mcv1,92,71782,66039,5743,eur,hic
irl,Ireland,2012,dtp1,98,71782,70346,1436,eur,hic
irl,Ireland,2013,mcv1,92,70893,65222,5671,eur,hic
irl,Ireland,2013,dtp3,96,70893,68057,2836,eur,hic
irl,Ireland,2013,dtp1,98,70893,69475,1418,eur,hic
irl,Ireland,2014,dtp3,96,69734,66945,2789,eur,hic
irl,Ireland,2014,mcv1,93,69734,64853,4881,eur,hic
irl,Ireland,2014,dtp1,98,69734,68339,1395,eur,hic
irl,Ireland,2015,mcv1,93,68378,63592,4786,eur,hic
irl,Ireland,2015,dtp3,95,68378,64959,3419,eur,hic
irl,Ireland,2015,dtp1,98,68378,67010,1368,eur,hic
irl,Ireland,2016,dtp3,95,66898,63553,3345,eur,hic
irl,Ireland,2016,mcv1,92,66898,61546,5352,eur,hic
irl,Ireland,2016,dtp1,98,66898,65560,1338,eur,hic
irn,Iran (Islamic Republic of),2000,dtp1,99,1204136,1192095,12041,emr,mic_nongavi
irn,Iran (Islamic Republic of),2000,dtp3,99,1204136,1192095,12041,emr,mic_nongavi
irn,Iran (Islamic Republic of),2000,mcv1,99,1204136,1192095,12041,emr,mic_nongavi
irn,Iran (Islamic Republic of),2000,mcv2,99,1265323,1252670,12653,emr,mic_nongavi
irn,Iran (Islamic Republic of),2001,dtp1,96,1191296,1143644,47652,emr,mic_nongavi
irn,Iran (Islamic Republic of),2001,mcv1,96,1191296,1143644,47652,emr,mic_nongavi
irn,Iran (Islamic Republic of),2001,dtp3,96,1191296,1143644,47652,emr,mic_nongavi
irn,Iran (Islamic Republic of),2001,mcv2,94,1213474,1140666,72808,emr,mic_nongavi
irn,Iran (Islamic Republic of),2002,dtp3,99,1188242,1176360,11882,emr,mic_nongavi
irn,Iran (Islamic Republic of),2002,dtp1,99,1188242,1176360,11882,emr,mic_nongavi
irn,Iran (Islamic Republic of),2002,mcv1,99,1188242,1176360,11882,emr,mic_nongavi
irn,Iran (Islamic Republic of),2002,mcv2,96,1170118,1123313,46805,emr,mic_nongavi
irn,Iran (Islamic Republic of),2003,mcv1,99,1193516,1181581,11935,emr,mic_nongavi
irn,Iran (Islamic Republic of),2003,dtp1,99,1193516,1181581,11935,emr,mic_nongavi
irn,Iran (Islamic Republic of),2003,dtp3,99,1193516,1181581,11935,emr,mic_nongavi
irn,Iran (Islamic Republic of),2003,mcv2,96,1116585,1071922,44663,emr,mic_nongavi
irn,Iran (Islamic Republic of),2004,dtp1,99,1205802,1193744,12058,emr,mic_nongavi
irn,Iran (Islamic Republic of),2004,mcv1,96,1205802,1157570,48232,emr,mic_nongavi
irn,Iran (Islamic Republic of),2004,dtp3,99,1205802,1193744,12058,emr,mic_nongavi
irn,Iran (Islamic Republic of),2004,mcv2,99,1088529,1077644,10885,emr,mic_nongavi
irn,Iran (Islamic Republic of),2005,dtp1,97,1224097,1187374,36723,emr,mic_nongavi
irn,Iran (Islamic Republic of),2005,mcv1,94,1224097,1150651,73446,emr,mic_nongavi
irn,Iran (Islamic Republic of),2005,dtp3,95,1224097,1162892,61205,emr,mic_nongavi
irn,Iran (Islamic Republic of),2005,mcv2,92,1037941,954906,83035,emr,mic_nongavi
irn,Iran (Islamic Republic of),2006,dtp1,98,1247502,1222552,24950,emr,mic_nongavi
irn,Iran (Islamic Republic of),2006,dtp3,98,1247502,1222552,24950,emr,mic_nongavi
irn,Iran (Islamic Republic of),2006,mcv1,99,1247502,1235027,12475,emr,mic_nongavi
irn,Iran (Islamic Republic of),2006,mcv2,98,1054907,1033809,21098,emr,mic_nongavi
irn,Iran (Islamic Republic of),2007,dtp3,99,1274236,1261494,12742,emr,mic_nongavi
irn,Iran (Islamic Republic of),2007,dtp1,99,1274236,1261494,12742,emr,mic_nongavi
irn,Iran (Islamic Republic of),2007,mcv1,97,1274236,1236009,38227,emr,mic_nongavi
irn,Iran (Islamic Republic of),2007,mcv2,97,1049713,1018222,31491,emr,mic_nongavi
irn,Iran (Islamic Republic of),2008,dtp3,99,1301922,1288903,13019,emr,mic_nongavi
irn,Iran (Islamic Republic of),2008,dtp1,99,1301922,1288903,13019,emr,mic_nongavi
irn,Iran (Islamic Republic of),2008,mcv1,98,1301922,1275884,26038,emr,mic_nongavi
irn,Iran (Islamic Republic of),2008,mcv2,96,1183234,1135905,47329,emr,mic_nongavi
irn,Iran (Islamic Republic of),2009,mcv1,99,1328016,1314736,13280,emr,mic_nongavi
irn,Iran (Islamic Republic of),2009,dtp1,99,1328016,1314736,13280,emr,mic_nongavi
irn,Iran (Islamic Republic of),2009,dtp3,99,1328016,1314736,13280,emr,mic_nongavi
irn,Iran (Islamic Republic of),2009,mcv2,99,1234492,1222147,12345,emr,mic_nongavi
irn,Iran (Islamic Republic of),2010,dtp1,99,1349595,1336099,13496,emr,mic_nongavi
irn,Iran (Islamic Republic of),2010,dtp3,99,1349595,1336099,13496,emr,mic_nongavi
irn,Iran (Islamic Republic of),2010,mcv1,99,1349595,1336099,13496,emr,mic_nongavi
irn,Iran (Islamic Republic of),2010,mcv2,99,1280834,1268026,12808,emr,mic_nongavi
irn,Iran (Islamic Republic of),2011,dtp3,99,1364131,1350490,13641,emr,mic_nongavi
irn,Iran (Islamic Republic of),2011,mcv1,99,1364131,1350490,13641,emr,mic_nongavi
irn,Iran (Islamic Republic of),2011,dtp1,99,1364131,1350490,13641,emr,mic_nongavi
irn,Iran (Islamic Republic of),2011,mcv2,99,1331403,1318089,13314,emr,mic_nongavi
irn,Iran (Islamic Republic of),2012,dtp1,99,1370622,1356916,13706,emr,mic_nongavi
irn,Iran (Islamic Republic of),2012,dtp3,99,1370622,1356916,13706,emr,mic_nongavi
irn,Iran (Islamic Republic of),2012,mcv1,98,1370622,1343210,27412,emr,mic_nongavi
irn,Iran (Islamic Republic of),2012,mcv2,97,1376874,1335568,41306,emr,mic_nongavi
irn,Iran (Islamic Republic of),2013,dtp3,98,1368517,1341147,27370,emr,mic_nongavi
irn,Iran (Islamic Republic of),2013,mcv1,98,1368517,1341147,27370,emr,mic_nongavi
irn,Iran (Islamic Republic of),2013,dtp1,98,1368517,1341147,27370,emr,mic_nongavi
irn,Iran (Islamic Republic of),2013,mcv2,97,1377289,1335970,41319,emr,mic_nongavi
irn,Iran (Islamic Republic of),2014,dtp3,99,1357392,1343818,13574,emr,mic_nongavi
irn,Iran (Islamic Republic of),2014,mcv1,99,1357392,1343818,13574,emr,mic_nongavi
irn,Iran (Islamic Republic of),2014,dtp1,99,1357392,1343818,13574,emr,mic_nongavi
irn,Iran (Islamic Republic of),2014,mcv2,98,1392296,1364450,27846,emr,mic_nongavi
irn,Iran (Islamic Republic of),2015,dtp3,98,1337210,1310466,26744,emr,mic_nongavi
irn,Iran (Islamic Republic of),2015,mcv1,99,1337210,1323838,13372,emr,mic_nongavi
irn,Iran (Islamic Republic of),2015,dtp1,99,1337210,1323838,13372,emr,mic_nongavi
irn,Iran (Islamic Republic of),2015,mcv2,98,1396166,1368243,27923,emr,mic_nongavi
irn,Iran (Islamic Republic of),2016,dtp3,99,1308642,1295556,13086,emr,mic_nongavi
irn,Iran (Islamic Republic of),2016,mcv1,99,1308642,1295556,13086,emr,mic_nongavi
irn,Iran (Islamic Republic of),2016,dtp1,99,1308642,1295556,13086,emr,mic_nongavi
irn,Iran (Islamic Republic of),2016,mcv2,98,1379611,1352019,27592,emr,mic_nongavi
irq,Iraq,2000,dtp3,80,809446,647557,161889,emr,mic_nongavi
irq,Iraq,2000,dtp1,92,809446,744690,64756,emr,mic_nongavi
irq,Iraq,2000,mcv1,86,809446,696124,113322,emr,mic_nongavi
irq,Iraq,2001,dtp3,78,826327,644535,181792,emr,mic_nongavi
irq,Iraq,2001,dtp1,90,826327,743694,82633,emr,mic_nongavi
irq,Iraq,2001,mcv1,82,826327,677588,148739,emr,mic_nongavi
irq,Iraq,2001,mcv2,52,790399,411007,379392,emr,mic_nongavi
irq,Iraq,2002,mcv1,77,844298,650109,194189,emr,mic_nongavi
irq,Iraq,2002,dtp3,77,844298,650109,194189,emr,mic_nongavi
irq,Iraq,2002,dtp1,89,844298,751425,92873,emr,mic_nongavi
irq,Iraq,2002,mcv2,48,813619,390537,423082,emr,mic_nongavi
irq,Iraq,2003,mcv1,73,863913,630656,233257,emr,mic_nongavi
irq,Iraq,2003,dtp3,75,863913,647935,215978,emr,mic_nongavi
irq,Iraq,2003,dtp1,87,863913,751604,112309,emr,mic_nongavi
irq,Iraq,2003,mcv2,45,742788,334255,408533,emr,mic_nongavi
irq,Iraq,2004,dtp1,86,885397,761441,123956,emr,mic_nongavi
irq,Iraq,2004,mcv1,69,885397,610924,274473,emr,mic_nongavi
irq,Iraq,2004,dtp3,74,885397,655194,230203,emr,mic_nongavi
irq,Iraq,2004,mcv2,41,833182,341605,491577,emr,mic_nongavi
irq,Iraq,2005,dtp1,84,908951,763519,145432,emr,mic_nongavi
irq,Iraq,2005,dtp3,65,908951,590818,318133,emr,mic_nongavi
irq,Iraq,2005,mcv1,69,908951,627176,281775,emr,mic_nongavi
irq,Iraq,2005,mcv2,58,850117,493068,357049,emr,mic_nongavi
irq,Iraq,2006,mcv1,62,934606,579456,355150,emr,mic_nongavi
irq,Iraq,2006,dtp1,76,934606,710301,224305,emr,mic_nongavi
irq,Iraq,2006,dtp3,59,934606,551418,383188,emr,mic_nongavi
irq,Iraq,2006,mcv2,52,862178,448333,413845,emr,mic_nongavi
irq,Iraq,2007,mcv1,64,961879,615603,346276,emr,mic_nongavi
irq,Iraq,2007,dtp1,68,961879,654078,307801,emr,mic_nongavi
irq,Iraq,2007,dtp3,57,961879,548271,413608,emr,mic_nongavi
irq,Iraq,2007,mcv2,64,875251,560161,315090,emr,mic_nongavi
irq,Iraq,2008,dtp1,81,990179,802045,188134,emr,mic_nongavi
irq,Iraq,2008,mcv1,76,990179,752536,237643,emr,mic_nongavi
irq,Iraq,2008,dtp3,69,990179,683224,306955,emr,mic_nongavi
irq,Iraq,2008,mcv2,76,911720,692907,218813,emr,mic_nongavi
irq,Iraq,2009,mcv1,81,1019016,825403,193613,emr,mic_nongavi
irq,Iraq,2009,dtp3,78,1019016,794832,224184,emr,mic_nongavi
irq,Iraq,2009,dtp1,88,1019016,896734,122282,emr,mic_nongavi
irq,Iraq,2009,mcv2,87,936703,814932,121771,emr,mic_nongavi
irq,Iraq,2010,dtp1,86,1047770,901082,146688,emr,mic_nongavi
irq,Iraq,2010,dtp3,74,1047770,775350,272420,emr,mic_nongavi
irq,Iraq,2010,mcv1,75,1047770,785828,261942,emr,mic_nongavi
irq,Iraq,2010,mcv2,77,966044,743854,222190,emr,mic_nongavi
irq,Iraq,2011,dtp3,79,1075839,849913,225926,emr,mic_nongavi
irq,Iraq,2011,mcv1,77,1075839,828396,247443,emr,mic_nongavi
irq,Iraq,2011,dtp1,90,1075839,968255,107584,emr,mic_nongavi
irq,Iraq,2011,mcv2,77,1001347,771037,230310,emr,mic_nongavi
irq,Iraq,2012,dtp3,69,1102841,760960,341881,emr,mic_nongavi
irq,Iraq,2012,dtp1,87,1102841,959472,143369,emr,mic_nongavi
irq,Iraq,2012,mcv1,69,1102841,760960,341881,emr,mic_nongavi
irq,Iraq,2012,mcv2,68,1038781,706371,332410,emr,mic_nongavi
irq,Iraq,2013,dtp3,68,1128507,767385,361122,emr,mic_nongavi
irq,Iraq,2013,mcv1,63,1128507,710959,417548,emr,mic_nongavi
irq,Iraq,2013,dtp1,82,1128507,925376,203131,emr,mic_nongavi
irq,Iraq,2013,mcv2,57,1060231,604332,455899,emr,mic_nongavi
irq,Iraq,2014,dtp3,64,1152667,737707,414960,emr,mic_nongavi
irq,Iraq,2014,dtp1,77,1152667,887554,265113,emr,mic_nongavi
irq,Iraq,2014,mcv1,57,1152667,657020,495647,emr,mic_nongavi
irq,Iraq,2014,mcv2,60,1092658,655595,437063,emr,mic_nongavi
irq,Iraq,2015,dtp1,73,1175284,857957,317327,emr,mic_nongavi
irq,Iraq,2015,dtp3,58,1175284,681665,493619,emr,mic_nongavi
irq,Iraq,2015,mcv1,57,1175284,669912,505372,emr,mic_nongavi
irq,Iraq,2015,mcv2,62,1121188,695137,426051,emr,mic_nongavi
irq,Iraq,2016,dtp3,63,1196518,753806,442712,emr,mic_nongavi
irq,Iraq,2016,dtp1,73,1196518,873458,323060,emr,mic_nongavi
irq,Iraq,2016,mcv1,66,1196518,789702,406816,emr,mic_nongavi
irq,Iraq,2016,mcv2,64,1150047,736030,414017,emr,mic_nongavi
isl,Iceland,2000,dtp1,99,4112,4071,41,eur,hic
isl,Iceland,2000,mcv1,91,4112,3742,370,eur,hic
isl,Iceland,2000,dtp3,98,4112,4030,82,eur,hic
isl,Iceland,2001,mcv1,88,4111,3618,493,eur,hic
isl,Iceland,2001,dtp1,95,4111,3905,206,eur,hic
isl,Iceland,2001,dtp3,92,4111,3782,329,eur,hic
isl,Iceland,2002,dtp1,96,4141,3975,166,eur,hic
isl,Iceland,2002,mcv1,91,4141,3768,373,eur,hic
isl,Iceland,2002,dtp3,95,4141,3934,207,eur,hic
isl,Iceland,2003,dtp1,97,4197,4071,126,eur,hic
isl,Iceland,2003,dtp3,97,4197,4071,126,eur,hic
isl,Iceland,2003,mcv1,93,4197,3903,294,eur,hic
isl,Iceland,2003,mcv2,92,4506,4146,360,eur,hic
isl,Iceland,2004,mcv1,93,4275,3976,299,eur,hic
isl,Iceland,2004,dtp3,99,4275,4232,43,eur,hic
isl,Iceland,2004,dtp1,99,4275,4232,43,eur,hic
isl,Iceland,2004,mcv2,89,4672,4158,514,eur,hic
isl,Iceland,2005,dtp1,95,4365,4147,218,eur,hic
isl,Iceland,2005,dtp3,95,4365,4147,218,eur,hic
isl,Iceland,2005,mcv1,90,4365,3928,437,eur,hic
isl,Iceland,2005,mcv2,90,4790,4311,479,eur,hic
isl,Iceland,2006,dtp3,97,4453,4319,134,eur,hic
isl,Iceland,2006,dtp1,97,4453,4319,134,eur,hic
isl,Iceland,2006,mcv1,95,4453,4230,223,eur,hic
isl,Iceland,2006,mcv2,93,4744,4412,332,eur,hic
isl,Iceland,2007,dtp3,97,4526,4390,136,eur,hic
isl,Iceland,2007,dtp1,97,4526,4390,136,eur,hic
isl,Iceland,2007,mcv1,95,4526,4300,226,eur,hic
isl,Iceland,2007,mcv2,95,4618,4387,231,eur,hic
isl,Iceland,2008,dtp3,98,4575,4483,92,eur,hic
isl,Iceland,2008,dtp1,99,4575,4529,46,eur,hic
isl,Iceland,2008,mcv1,96,4575,4392,183,eur,hic
isl,Iceland,2008,mcv2,94,4511,4240,271,eur,hic
isl,Iceland,2009,dtp3,96,4598,4414,184,eur,hic
isl,Iceland,2009,mcv1,92,4598,4230,368,eur,hic
isl,Iceland,2009,dtp1,99,4598,4552,46,eur,hic
isl,Iceland,2009,mcv2,93,4394,4086,308,eur,hic
isl,Iceland,2010,dtp3,96,4593,4409,184,eur,hic
isl,Iceland,2010,dtp1,98,4593,4501,92,eur,hic
isl,Iceland,2010,mcv1,93,4593,4271,322,eur,hic
isl,Iceland,2010,mcv2,92,4286,3943,343,eur,hic
isl,Iceland,2011,dtp1,99,4568,4522,46,eur,hic
isl,Iceland,2011,mcv1,94,4568,4294,274,eur,hic
isl,Iceland,2011,dtp3,95,4568,4340,228,eur,hic
isl,Iceland,2011,mcv2,90,4247,3822,425,eur,hic
isl,Iceland,2012,dtp3,89,4535,4036,499,eur,hic
isl,Iceland,2012,dtp1,97,4535,4399,136,eur,hic
isl,Iceland,2012,mcv1,90,4535,4082,453,eur,hic
isl,Iceland,2012,mcv2,97,4244,4117,127,eur,hic
isl,Iceland,2013,mcv1,91,4501,4096,405,eur,hic
isl,Iceland,2013,dtp3,91,4501,4096,405,eur,hic
isl,Iceland,2013,dtp1,97,4501,4366,135,eur,hic
isl,Iceland,2013,mcv2,94,4229,3975,254,eur,hic
isl,Iceland,2014,mcv1,90,4471,4024,447,eur,hic
isl,Iceland,2014,dtp3,90,4471,4024,447,eur,hic
isl,Iceland,2014,dtp1,96,4471,4292,179,eur,hic
isl,Iceland,2014,mcv2,93,4203,3909,294,eur,hic
isl,Iceland,2015,dtp3,92,4447,4091,356,eur,hic
isl,Iceland,2015,dtp1,96,4447,4269,178,eur,hic
isl,Iceland,2015,mcv1,93,4447,4136,311,eur,hic
isl,Iceland,2015,mcv2,94,4211,3958,253,eur,hic
isl,Iceland,2016,dtp1,96,4431,4254,177,eur,hic
isl,Iceland,2016,mcv1,91,4431,4032,399,eur,hic
isl,Iceland,2016,dtp3,91,4431,4032,399,eur,hic
isl,Iceland,2016,mcv2,95,4291,4076,215,eur,hic
isr,Israel,2000,dtp1,95,126708,120373,6335,eur,hic
isr,Israel,2000,dtp3,93,126708,117838,8870,eur,hic
isr,Israel,2000,mcv1,95,126708,120373,6335,eur,hic
isr,Israel,2001,dtp1,95,129232,122770,6462,eur,hic
isr,Israel,2001,dtp3,92,129232,118893,10339,eur,hic
isr,Israel,2001,mcv1,95,129232,122770,6462,eur,hic
isr,Israel,2001,mcv2,97,113422,110019,3403,eur,hic
isr,Israel,2002,dtp1,95,131759,125171,6588,eur,hic
isr,Israel,2002,mcv1,95,131759,125171,6588,eur,hic
isr,Israel,2002,dtp3,90,131759,118583,13176,eur,hic
isr,Israel,2002,mcv2,97,116527,113031,3496,eur,hic
isr,Israel,2003,dtp1,95,134378,127659,6719,eur,hic
isr,Israel,2003,mcv1,96,134378,129003,5375,eur,hic
isr,Israel,2003,dtp3,93,134378,124972,9406,eur,hic
isr,Israel,2003,mcv2,97,119950,116352,3598,eur,hic
isr,Israel,2004,dtp3,95,137125,130269,6856,eur,hic
isr,Israel,2004,mcv1,97,137125,133011,4114,eur,hic
isr,Israel,2004,dtp1,95,137125,130269,6856,eur,hic
isr,Israel,2004,mcv2,97,123476,119772,3704,eur,hic
isr,Israel,2005,dtp1,93,140087,130281,9806,eur,hic
isr,Israel,2005,dtp3,93,140087,130281,9806,eur,hic
isr,Israel,2005,mcv1,94,140087,131682,8405,eur,hic
isr,Israel,2005,mcv2,96,126732,121663,5069,eur,hic
isr,Israel,2006,dtp1,95,143352,136184,7168,eur,hic
isr,Israel,2006,dtp3,95,143352,136184,7168,eur,hic
isr,Israel,2006,mcv1,96,143352,137618,5734,eur,hic
isr,Israel,2006,mcv2,96,128844,123690,5154,eur,hic
isr,Israel,2007,dtp3,95,146883,139539,7344,eur,hic
isr,Israel,2007,dtp1,95,146883,139539,7344,eur,hic
isr,Israel,2007,mcv1,97,146883,142477,4406,eur,hic
isr,Israel,2007,mcv2,90,130549,117494,13055,eur,hic
isr,Israel,2008,dtp3,94,150579,141544,9035,eur,hic
isr,Israel,2008,mcv1,98,150579,147567,3012,eur,hic
isr,Israel,2008,dtp1,94,150579,141544,9035,eur,hic
isr,Israel,2008,mcv2,91,132044,120160,11884,eur,hic
isr,Israel,2009,mcv1,97,154307,149678,4629,eur,hic
isr,Israel,2009,dtp1,96,154307,148135,6172,eur,hic
isr,Israel,2009,dtp3,96,154307,148135,6172,eur,hic
isr,Israel,2009,mcv2,92,133495,122815,10680,eur,hic
isr,Israel,2010,dtp1,95,157830,149938,7892,eur,hic
isr,Israel,2010,dtp3,95,157830,149938,7892,eur,hic
isr,Israel,2010,mcv1,96,157830,151517,6313,eur,hic
isr,Israel,2010,mcv2,93,135260,125792,9468,eur,hic
isr,Israel,2011,dtp1,94,160875,151222,9653,eur,hic
isr,Israel,2011,dtp3,94,160875,151222,9653,eur,hic
isr,Israel,2011,mcv1,97,160875,156049,4826,eur,hic
isr,Israel,2011,mcv2,87,138479,120477,18002,eur,hic
isr,Israel,2012,dtp3,94,163264,153468,9796,eur,hic
isr,Israel,2012,mcv1,96,163264,156733,6531,eur,hic
isr,Israel,2012,dtp1,94,163264,153468,9796,eur,hic
isr,Israel,2012,mcv2,89,141795,126198,15597,eur,hic
isr,Israel,2013,mcv1,98,164901,161603,3298,eur,hic
isr,Israel,2013,dtp1,96,164901,158305,6596,eur,hic
isr,Israel,2013,dtp3,96,164901,158305,6596,eur,hic
isr,Israel,2013,mcv2,95,145173,137914,7259,eur,hic
isr,Israel,2014,mcv1,97,165781,160808,4973,eur,hic
isr,Israel,2014,dtp3,95,165781,157492,8289,eur,hic
isr,Israel,2014,dtp1,95,165781,157492,8289,eur,hic
isr,Israel,2014,mcv2,96,148639,142693,5946,eur,hic
isr,Israel,2015,dtp1,95,165988,157689,8299,eur,hic
isr,Israel,2015,mcv1,98,165988,162668,3320,eur,hic
isr,Israel,2015,dtp3,95,165988,157689,8299,eur,hic
isr,Israel,2015,mcv2,97,152114,147551,4563,eur,hic
isr,Israel,2016,dtp3,94,165689,155748,9941,eur,hic
isr,Israel,2016,mcv1,97,165689,160718,4971,eur,hic
isr,Israel,2016,dtp1,94,165689,155748,9941,eur,hic
isr,Israel,2016,mcv2,97,155624,150955,4669,eur,hic
ita,Italy,2000,dtp1,95,531212,504651,26561,eur,hic
ita,Italy,2000,dtp3,87,531212,462154,69058,eur,hic
ita,Italy,2000,mcv1,74,531212,393097,138115,eur,hic
ita,Italy,2001,dtp1,97,535234,519177,16057,eur,hic
ita,Italy,2001,dtp3,93,535234,497768,37466,eur,hic
ita,Italy,2001,mcv1,77,535234,412130,123104,eur,hic
ita,Italy,2002,dtp1,97,540306,524097,16209,eur,hic
ita,Italy,2002,dtp3,93,540306,502485,37821,eur,hic
ita,Italy,2002,mcv1,81,540306,437648,102658,eur,hic
ita,Italy,2003,dtp1,98,545745,534830,10915,eur,hic
ita,Italy,2003,dtp3,96,545745,523915,21830,eur,hic
ita,Italy,2003,mcv1,84,545745,458426,87319,eur,hic
ita,Italy,2004,mcv1,86,550911,473783,77128,eur,hic
ita,Italy,2004,dtp1,98,550911,539893,11018,eur,hic
ita,Italy,2004,dtp3,94,550911,517856,33055,eur,hic
ita,Italy,2005,dtp1,98,554837,543740,11097,eur,hic
ita,Italy,2005,dtp3,95,554837,527095,27742,eur,hic
ita,Italy,2005,mcv1,87,554837,482708,72129,eur,hic
ita,Italy,2006,dtp1,98,556550,545419,11131,eur,hic
ita,Italy,2006,dtp3,96,556550,534288,22262,eur,hic
ita,Italy,2006,mcv1,88,556550,489764,66786,eur,hic
ita,Italy,2007,dtp1,99,555629,550073,5556,eur,hic
ita,Italy,2007,dtp3,97,555629,538960,16669,eur,hic
ita,Italy,2007,mcv1,90,555629,500066,55563,eur,hic
ita,Italy,2008,dtp3,96,551977,529898,22079,eur,hic
ita,Italy,2008,dtp1,98,551977,540937,11040,eur,hic
ita,Italy,2008,mcv1,90,551977,496779,55198,eur,hic
ita,Italy,2009,dtp3,96,545722,523893,21829,eur,hic
ita,Italy,2009,mcv1,90,545722,491150,54572,eur,hic
ita,Italy,2009,dtp1,98,545722,534808,10914,eur,hic
ita,Italy,2010,mcv1,91,537365,489002,48363,eur,hic
ita,Italy,2010,dtp1,98,537365,526618,10747,eur,hic
ita,Italy,2010,dtp3,96,537365,515870,21495,eur,hic
ita,Italy,2011,dtp3,96,527708,506600,21108,eur,hic
ita,Italy,2011,dtp1,98,527708,517154,10554,eur,hic
ita,Italy,2011,mcv1,90,527708,474937,52771,eur,hic
ita,Italy,2012,dtp3,97,517816,502282,15534,eur,hic
ita,Italy,2012,dtp1,99,517816,512638,5178,eur,hic
ita,Italy,2012,mcv1,90,517816,466034,51782,eur,hic
ita,Italy,2013,dtp1,98,508588,498416,10172,eur,hic
ita,Italy,2013,dtp3,96,508588,488244,20344,eur,hic
ita,Italy,2013,mcv1,90,508588,457729,50859,eur,hic
ita,Italy,2013,mcv2,84,563723,473527,90196,eur,hic
ita,Italy,2014,dtp1,98,500512,490502,10010,eur,hic
ita,Italy,2014,mcv1,87,500512,435445,65067,eur,hic
ita,Italy,2014,dtp3,95,500512,475486,25026,eur,hic
ita,Italy,2014,mcv2,83,560343,465085,95258,eur,hic
ita,Italy,2015,mcv1,85,493839,419763,74076,eur,hic
ita,Italy,2015,dtp1,97,493839,479024,14815,eur,hic
ita,Italy,2015,dtp3,93,493839,459270,34569,eur,hic
ita,Italy,2015,mcv2,83,553603,459490,94113,eur,hic
ita,Italy,2016,dtp3,93,488505,454310,34195,eur,hic
ita,Italy,2016,mcv1,85,488505,415229,73276,eur,hic
ita,Italy,2016,dtp1,97,488505,473850,14655,eur,hic
ita,Italy,2016,mcv2,83,542592,450351,92241,eur,hic
jam,Jamaica,2000,dtp3,93,55420,51541,3879,amr,mic_nongavi
jam,Jamaica,2000,dtp1,97,55420,53757,1663,amr,mic_nongavi
jam,Jamaica,2000,mcv1,88,55420,48770,6650,amr,mic_nongavi
jam,Jamaica,2001,dtp3,99,54463,53918,545,amr,mic_nongavi
jam,Jamaica,2001,mcv1,85,54463,46294,8169,amr,mic_nongavi
jam,Jamaica,2001,dtp1,99,54463,53918,545,amr,mic_nongavi
jam,Jamaica,2001,mcv2,96,57934,55617,2317,amr,mic_nongavi
jam,Jamaica,2002,dtp1,99,53546,53011,535,amr,mic_nongavi
jam,Jamaica,2002,mcv1,86,53546,46050,7496,amr,mic_nongavi
jam,Jamaica,2002,dtp3,99,53546,53011,535,amr,mic_nongavi
jam,Jamaica,2002,mcv2,96,57682,55375,2307,amr,mic_nongavi
jam,Jamaica,2003,mcv1,78,52722,41123,11599,amr,mic_nongavi
jam,Jamaica,2003,dtp1,98,52722,51668,1054,amr,mic_nongavi
jam,Jamaica,2003,dtp3,96,52722,50613,2109,amr,mic_nongavi
jam,Jamaica,2003,mcv2,95,57218,54357,2861,amr,mic_nongavi
jam,Jamaica,2004,mcv1,86,52019,44736,7283,amr,mic_nongavi
jam,Jamaica,2004,dtp3,98,52019,50979,1040,amr,mic_nongavi
jam,Jamaica,2004,dtp1,99,52019,51499,520,amr,mic_nongavi
jam,Jamaica,2004,mcv2,95,56405,53585,2820,amr,mic_nongavi
jam,Jamaica,2005,mcv1,84,51436,43206,8230,amr,mic_nongavi
jam,Jamaica,2005,dtp3,99,51436,50922,514,amr,mic_nongavi
jam,Jamaica,2005,dtp1,99,51436,50922,514,amr,mic_nongavi
jam,Jamaica,2005,mcv2,91,55099,50140,4959,amr,mic_nongavi
jam,Jamaica,2006,mcv1,87,50955,44331,6624,amr,mic_nongavi
jam,Jamaica,2006,dtp3,95,50955,48407,2548,amr,mic_nongavi
jam,Jamaica,2006,dtp1,96,50955,48917,2038,amr,mic_nongavi
jam,Jamaica,2006,mcv2,88,53155,46776,6379,amr,mic_nongavi
jam,Jamaica,2007,dtp3,92,50524,46482,4042,amr,mic_nongavi
jam,Jamaica,2007,mcv1,76,50524,38398,12126,amr,mic_nongavi
jam,Jamaica,2007,dtp1,97,50524,49008,1516,amr,mic_nongavi
jam,Jamaica,2007,mcv2,84,50938,42788,8150,amr,mic_nongavi
jam,Jamaica,2008,dtp1,97,50107,48604,1503,amr,mic_nongavi
jam,Jamaica,2008,mcv1,88,50107,44094,6013,amr,mic_nongavi
jam,Jamaica,2008,dtp3,91,50107,45597,4510,amr,mic_nongavi
jam,Jamaica,2008,mcv2,80,48764,39011,9753,amr,mic_nongavi
jam,Jamaica,2009,dtp1,91,49692,45220,4472,amr,mic_nongavi
jam,Jamaica,2009,mcv1,88,49692,43729,5963,amr,mic_nongavi
jam,Jamaica,2009,dtp3,90,49692,44723,4969,amr,mic_nongavi
jam,Jamaica,2009,mcv2,78,47033,36686,10347,amr,mic_nongavi
jam,Jamaica,2010,dtp3,94,49281,46324,2957,amr,mic_nongavi
jam,Jamaica,2010,dtp1,98,49281,48295,986,amr,mic_nongavi
jam,Jamaica,2010,mcv1,89,49281,43860,5421,amr,mic_nongavi
jam,Jamaica,2010,mcv2,56,46199,25871,20328,amr,mic_nongavi
jam,Jamaica,2011,dtp1,94,48890,45957,2933,amr,mic_nongavi
jam,Jamaica,2011,dtp3,92,48890,44979,3911,amr,mic_nongavi
jam,Jamaica,2011,mcv1,88,48890,43023,5867,amr,mic_nongavi
jam,Jamaica,2011,mcv2,60,45584,27350,18234,amr,mic_nongavi
jam,Jamaica,2012,dtp1,98,48531,47560,971,amr,mic_nongavi
jam,Jamaica,2012,dtp3,96,48531,46590,1941,amr,mic_nongavi
jam,Jamaica,2012,mcv1,93,48531,45134,3397,amr,mic_nongavi
jam,Jamaica,2012,mcv2,76,45236,34379,10857,amr,mic_nongavi
jam,Jamaica,2013,dtp1,97,48206,46760,1446,amr,mic_nongavi
jam,Jamaica,2013,dtp3,93,48206,44832,3374,amr,mic_nongavi
jam,Jamaica,2013,mcv1,94,48206,45314,2892,amr,mic_nongavi
jam,Jamaica,2013,mcv2,71,44907,31884,13023,amr,mic_nongavi
jam,Jamaica,2014,dtp3,92,47901,44069,3832,amr,mic_nongavi
jam,Jamaica,2014,mcv1,92,47901,44069,3832,amr,mic_nongavi
jam,Jamaica,2014,dtp1,97,47901,46464,1437,amr,mic_nongavi
jam,Jamaica,2014,mcv2,72,44247,31858,12389,amr,mic_nongavi
jam,Jamaica,2015,dtp1,97,47593,46165,1428,amr,mic_nongavi
jam,Jamaica,2015,dtp3,91,47593,43310,4283,amr,mic_nongavi
jam,Jamaica,2015,mcv1,91,47593,43310,4283,amr,mic_nongavi
jam,Jamaica,2015,mcv2,83,42857,35571,7286,amr,mic_nongavi
jam,Jamaica,2016,dtp3,99,47250,46778,472,amr,mic_nongavi
jam,Jamaica,2016,mcv1,95,47250,44888,2362,amr,mic_nongavi
jam,Jamaica,2016,dtp1,99,47250,46778,472,amr,mic_nongavi
jam,Jamaica,2016,mcv2,85,41978,35681,6297,amr,mic_nongavi
jor,Jordan,2000,dtp1,91,155252,141279,13973,emr,mic_nongavi
jor,Jordan,2000,dtp3,91,155252,141279,13973,emr,mic_nongavi
jor,Jordan,2000,mcv1,94,155252,145937,9315,emr,mic_nongavi
jor,Jordan,2000,mcv2,83,149121,123770,25351,emr,mic_nongavi
jor,Jordan,2001,dtp3,99,156701,155134,1567,emr,mic_nongavi
jor,Jordan,2001,dtp1,99,156701,155134,1567,emr,mic_nongavi
jor,Jordan,2001,mcv1,99,156701,155134,1567,emr,mic_nongavi
jor,Jordan,2001,mcv2,87,151233,131573,19660,emr,mic_nongavi
jor,Jordan,2002,mcv1,95,158602,150672,7930,emr,mic_nongavi
jor,Jordan,2002,dtp3,95,158602,150672,7930,emr,mic_nongavi
jor,Jordan,2002,dtp1,96,158602,152258,6344,emr,mic_nongavi
jor,Jordan,2002,mcv2,90,153122,137810,15312,emr,mic_nongavi
jor,Jordan,2003,dtp3,97,161222,156385,4837,emr,mic_nongavi
jor,Jordan,2003,dtp1,98,161222,157998,3224,emr,mic_nongavi
jor,Jordan,2003,mcv1,96,161222,154773,6449,emr,mic_nongavi
jor,Jordan,2003,mcv2,91,149795,136313,13482,emr,mic_nongavi
jor,Jordan,2004,dtp1,96,164739,158149,6590,emr,mic_nongavi
jor,Jordan,2004,mcv1,99,164739,163092,1647,emr,mic_nongavi
jor,Jordan,2004,dtp3,95,164739,156502,8237,emr,mic_nongavi
jor,Jordan,2004,mcv2,98,151951,148912,3039,emr,mic_nongavi
jor,Jordan,2005,dtp3,95,169386,160917,8469,emr,mic_nongavi
jor,Jordan,2005,dtp1,98,169386,165998,3388,emr,mic_nongavi
jor,Jordan,2005,mcv1,95,169386,160917,8469,emr,mic_nongavi
jor,Jordan,2005,mcv2,92,156532,144009,12523,emr,mic_nongavi
jor,Jordan,2006,dtp1,99,175327,173574,1753,emr,mic_nongavi
jor,Jordan,2006,dtp3,98,175327,171820,3507,emr,mic_nongavi
jor,Jordan,2006,mcv1,99,175327,173574,1753,emr,mic_nongavi
jor,Jordan,2006,mcv2,88,160761,141470,19291,emr,mic_nongavi
jor,Jordan,2007,dtp1,99,182390,180566,1824,emr,mic_nongavi
jor,Jordan,2007,mcv1,95,182390,173270,9120,emr,mic_nongavi
jor,Jordan,2007,dtp3,98,182390,178742,3648,emr,mic_nongavi
jor,Jordan,2007,mcv2,97,166221,161234,4987,emr,mic_nongavi
jor,Jordan,2008,dtp3,97,190281,184573,5708,emr,mic_nongavi
jor,Jordan,2008,dtp1,98,190281,186475,3806,emr,mic_nongavi
jor,Jordan,2008,mcv1,95,190281,180767,9514,emr,mic_nongavi
jor,Jordan,2008,mcv2,90,174544,157090,17454,emr,mic_nongavi
jor,Jordan,2009,dtp1,98,198706,194732,3974,emr,mic_nongavi
jor,Jordan,2009,dtp3,98,198706,194732,3974,emr,mic_nongavi
jor,Jordan,2009,mcv1,95,198706,188771,9935,emr,mic_nongavi
jor,Jordan,2009,mcv2,90,184018,165616,18402,emr,mic_nongavi
jor,Jordan,2010,dtp1,98,207270,203125,4145,emr,mic_nongavi
jor,Jordan,2010,dtp3,98,207270,203125,4145,emr,mic_nongavi
jor,Jordan,2010,mcv1,98,207270,203125,4145,emr,mic_nongavi
jor,Jordan,2010,mcv2,95,194511,184785,9726,emr,mic_nongavi
jor,Jordan,2011,mcv1,98,215551,211240,4311,emr,mic_nongavi
jor,Jordan,2011,dtp1,98,215551,211240,4311,emr,mic_nongavi
jor,Jordan,2011,dtp3,98,215551,211240,4311,emr,mic_nongavi
jor,Jordan,2011,mcv2,95,205552,195274,10278,emr,mic_nongavi
jor,Jordan,2012,dtp3,98,223170,218707,4463,emr,mic_nongavi
jor,Jordan,2012,dtp1,98,223170,218707,4463,emr,mic_nongavi
jor,Jordan,2012,mcv1,98,223170,218707,4463,emr,mic_nongavi
jor,Jordan,2012,mcv2,96,216805,208133,8672,emr,mic_nongavi
jor,Jordan,2013,dtp1,99,229799,227501,2298,emr,mic_nongavi
jor,Jordan,2013,mcv1,97,229799,222905,6894,emr,mic_nongavi
jor,Jordan,2013,dtp3,98,229799,225203,4596,emr,mic_nongavi
jor,Jordan,2013,mcv2,98,227293,222747,4546,emr,mic_nongavi
jor,Jordan,2014,dtp3,98,235203,230499,4704,emr,mic_nongavi
jor,Jordan,2014,mcv1,98,235203,230499,4704,emr,mic_nongavi
jor,Jordan,2014,dtp1,98,235203,230499,4704,emr,mic_nongavi
jor,Jordan,2014,mcv2,98,235712,230998,4714,emr,mic_nongavi
jor,Jordan,2015,dtp3,99,239216,236824,2392,emr,mic_nongavi
jor,Jordan,2015,dtp1,99,239216,236824,2392,emr,mic_nongavi
jor,Jordan,2015,mcv1,94,239216,224863,14353,emr,mic_nongavi
jor,Jordan,2015,mcv2,96,240703,231075,9628,emr,mic_nongavi
jor,Jordan,2016,dtp1,99,241815,239397,2418,emr,mic_nongavi
jor,Jordan,2016,mcv1,96,241815,232142,9673,emr,mic_nongavi
jor,Jordan,2016,dtp3,98,241815,236979,4836,emr,mic_nongavi
jor,Jordan,2016,mcv2,99,245966,243506,2460,emr,mic_nongavi
jpn,Japan,2000,dtp3,85,1161901,987616,174285,wpr,hic
jpn,Japan,2000,dtp1,88,1161901,1022473,139428,wpr,hic
jpn,Japan,2000,mcv1,96,1161901,1115425,46476,wpr,hic
jpn,Japan,2001,dtp3,95,1151564,1093986,57578,wpr,hic
jpn,Japan,2001,dtp1,98,1151564,1128533,23031,wpr,hic
jpn,Japan,2001,mcv1,98,1151564,1128533,23031,wpr,hic
jpn,Japan,2002,dtp3,96,1141969,1096290,45679,wpr,hic
jpn,Japan,2002,mcv1,98,1141969,1119130,22839,wpr,hic
jpn,Japan,2002,dtp1,98,1141969,1119130,22839,wpr,hic
jpn,Japan,2003,dtp3,97,1133757,1099744,34013,wpr,hic
jpn,Japan,2003,dtp1,99,1133757,1122419,11338,wpr,hic
jpn,Japan,2003,mcv1,98,1133757,1111082,22675,wpr,hic
jpn,Japan,2004,dtp1,99,1126975,1115705,11270,wpr,hic
jpn,Japan,2004,dtp3,99,1126975,1115705,11270,wpr,hic
jpn,Japan,2004,mcv1,98,1126975,1104436,22539,wpr,hic
jpn,Japan,2005,mcv1,98,1121440,1099011,22429,wpr,hic
jpn,Japan,2005,dtp3,98,1121440,1099011,22429,wpr,hic
jpn,Japan,2005,dtp1,99,1121440,1110226,11214,wpr,hic
jpn,Japan,2006,dtp3,98,1116742,1094407,22335,wpr,hic
jpn,Japan,2006,dtp1,99,1116742,1105575,11167,wpr,hic
jpn,Japan,2006,mcv1,97,1116742,1083240,33502,wpr,hic
jpn,Japan,2007,dtp3,98,1112221,1089977,22244,wpr,hic
jpn,Japan,2007,mcv1,96,1112221,1067732,44489,wpr,hic
jpn,Japan,2007,dtp1,99,1112221,1101099,11122,wpr,hic
jpn,Japan,2008,mcv1,95,1107311,1051945,55366,wpr,hic
jpn,Japan,2008,dtp3,98,1107311,1085165,22146,wpr,hic
jpn,Japan,2008,dtp1,99,1107311,1096238,11073,wpr,hic
jpn,Japan,2008,mcv2,78,1135617,885781,249836,wpr,hic
jpn,Japan,2009,dtp1,99,1101715,1090698,11017,wpr,hic
jpn,Japan,2009,dtp3,97,1101715,1068664,33051,wpr,hic
jpn,Japan,2009,mcv1,94,1101715,1035612,66103,wpr,hic
jpn,Japan,2009,mcv2,92,1121737,1031998,89739,wpr,hic
jpn,Japan,2010,dtp1,99,1095198,1084246,10952,wpr,hic
jpn,Japan,2010,dtp3,97,1095198,1062342,32856,wpr,hic
jpn,Japan,2010,mcv1,94,1095198,1029486,65712,wpr,hic
jpn,Japan,2010,mcv2,97,1114760,1081317,33443,wpr,hic
jpn,Japan,2011,dtp1,99,1087676,1076799,10877,wpr,hic
jpn,Japan,2011,dtp3,97,1087676,1055046,32630,wpr,hic
jpn,Japan,2011,mcv1,94,1087676,1022415,65261,wpr,hic
jpn,Japan,2011,mcv2,92,1111751,1022811,88940,wpr,hic
jpn,Japan,2012,mcv1,96,1079352,1036178,43174,wpr,hic
jpn,Japan,2012,dtp3,97,1079352,1046971,32381,wpr,hic
jpn,Japan,2012,dtp1,99,1079352,1068558,10794,wpr,hic
jpn,Japan,2012,mcv2,92,1111145,1022253,88892,wpr,hic
jpn,Japan,2013,dtp1,98,1070442,1049033,21409,wpr,hic
jpn,Japan,2013,dtp3,96,1070442,1027624,42818,wpr,hic
jpn,Japan,2013,mcv1,95,1070442,1016920,53522,wpr,hic
jpn,Japan,2013,mcv2,93,1111338,1033544,77794,wpr,hic
jpn,Japan,2014,dtp3,96,1061053,1018611,42442,wpr,hic
jpn,Japan,2014,mcv1,98,1061053,1039832,21221,wpr,hic
jpn,Japan,2014,dtp1,98,1061053,1039832,21221,wpr,hic
jpn,Japan,2014,mcv2,94,1110002,1043402,66600,wpr,hic
jpn,Japan,2015,dtp3,96,1051286,1009235,42051,wpr,hic
jpn,Japan,2015,mcv1,96,1051286,1009235,42051,wpr,hic
jpn,Japan,2015,dtp1,98,1051286,1030260,21026,wpr,hic
jpn,Japan,2015,mcv2,93,1104232,1026936,77296,wpr,hic
jpn,Japan,2016,dtp3,99,1041244,1030832,10412,wpr,hic
jpn,Japan,2016,mcv1,96,1041244,999594,41650,wpr,hic
jpn,Japan,2016,dtp1,99,1041244,1030832,10412,wpr,hic
jpn,Japan,2016,mcv2,93,1098433,1021543,76890,wpr,hic
kaz,Kazakhstan,2000,dtp1,98,229491,224901,4590,eur,mic_nongavi
kaz,Kazakhstan,2000,mcv1,99,229491,227196,2295,eur,mic_nongavi
kaz,Kazakhstan,2000,dtp3,97,229491,222606,6885,eur,mic_nongavi
kaz,Kazakhstan,2000,mcv2,98,272165,266722,5443,eur,mic_nongavi
kaz,Kazakhstan,2001,mcv1,95,233357,221689,11668,eur,mic_nongavi
kaz,Kazakhstan,2001,dtp1,96,233357,224023,9334,eur,mic_nongavi
kaz,Kazakhstan,2001,dtp3,95,233357,221689,11668,eur,mic_nongavi
kaz,Kazakhstan,2001,mcv2,95,257566,244688,12878,eur,mic_nongavi
kaz,Kazakhstan,2002,dtp3,95,241859,229766,12093,eur,mic_nongavi
kaz,Kazakhstan,2002,mcv1,95,241859,229766,12093,eur,mic_nongavi
kaz,Kazakhstan,2002,dtp1,96,241859,232185,9674,eur,mic_nongavi
kaz,Kazakhstan,2002,mcv2,98,257128,251985,5143,eur,mic_nongavi
kaz,Kazakhstan,2003,mcv1,99,254230,251688,2542,eur,mic_nongavi
kaz,Kazakhstan,2003,dtp1,99,254230,251688,2542,eur,mic_nongavi
kaz,Kazakhstan,2003,dtp3,99,254230,251688,2542,eur,mic_nongavi
kaz,Kazakhstan,2003,mcv2,99,233649,231313,2336,eur,mic_nongavi
kaz,Kazakhstan,2004,dtp1,85,269676,229225,40451,eur,mic_nongavi
kaz,Kazakhstan,2004,dtp3,82,269676,221134,48542,eur,mic_nongavi
kaz,Kazakhstan,2004,mcv1,99,269676,266979,2697,eur,mic_nongavi
kaz,Kazakhstan,2004,mcv2,99,225739,223482,2257,eur,mic_nongavi
kaz,Kazakhstan,2005,dtp1,99,287233,284361,2872,eur,mic_nongavi
kaz,Kazakhstan,2005,mcv1,99,287233,284361,2872,eur,mic_nongavi
kaz,Kazakhstan,2005,dtp3,98,287233,281488,5745,eur,mic_nongavi
kaz,Kazakhstan,2005,mcv2,96,221877,213002,8875,eur,mic_nongavi
kaz,Kazakhstan,2006,dtp1,99,305866,302807,3059,eur,mic_nongavi
kaz,Kazakhstan,2006,mcv1,99,305866,302807,3059,eur,mic_nongavi
kaz,Kazakhstan,2006,dtp3,99,305866,302807,3059,eur,mic_nongavi
kaz,Kazakhstan,2006,mcv2,99,219683,217486,2197,eur,mic_nongavi
kaz,Kazakhstan,2007,dtp1,97,324412,314680,9732,eur,mic_nongavi
kaz,Kazakhstan,2007,dtp3,93,324412,301703,22709,eur,mic_nongavi
kaz,Kazakhstan,2007,mcv1,99,324412,321168,3244,eur,mic_nongavi
kaz,Kazakhstan,2007,mcv2,99,221988,219768,2220,eur,mic_nongavi
kaz,Kazakhstan,2008,dtp1,99,341706,338289,3417,eur,mic_nongavi
kaz,Kazakhstan,2008,dtp3,99,341706,338289,3417,eur,mic_nongavi
kaz,Kazakhstan,2008,mcv1,99,341706,338289,3417,eur,mic_nongavi
kaz,Kazakhstan,2008,mcv2,99,227867,225588,2279,eur,mic_nongavi
kaz,Kazakhstan,2009,dtp1,98,356778,349642,7136,eur,mic_nongavi
kaz,Kazakhstan,2009,dtp3,98,356778,349642,7136,eur,mic_nongavi
kaz,Kazakhstan,2009,mcv1,99,356778,353210,3568,eur,mic_nongavi
kaz,Kazakhstan,2009,mcv2,99,236624,234258,2366,eur,mic_nongavi
kaz,Kazakhstan,2010,mcv1,99,368729,365042,3687,eur,mic_nongavi
kaz,Kazakhstan,2010,dtp3,99,368729,365042,3687,eur,mic_nongavi
kaz,Kazakhstan,2010,dtp1,99,368729,365042,3687,eur,mic_nongavi
kaz,Kazakhstan,2010,mcv2,99,246694,244227,2467,eur,mic_nongavi
kaz,Kazakhstan,2011,mcv1,99,377033,373263,3770,eur,mic_nongavi
kaz,Kazakhstan,2011,dtp3,99,377033,373263,3770,eur,mic_nongavi
kaz,Kazakhstan,2011,dtp1,99,377033,373263,3770,eur,mic_nongavi
kaz,Kazakhstan,2011,mcv2,99,260093,257492,2601,eur,mic_nongavi
kaz,Kazakhstan,2012,mcv1,96,382001,366721,15280,eur,mic_nongavi
kaz,Kazakhstan,2012,dtp3,99,382001,378181,3820,eur,mic_nongavi
kaz,Kazakhstan,2012,dtp1,99,382001,378181,3820,eur,mic_nongavi
kaz,Kazakhstan,2012,mcv2,97,278828,270463,8365,eur,mic_nongavi
kaz,Kazakhstan,2013,mcv1,99,384038,380198,3840,eur,mic_nongavi
kaz,Kazakhstan,2013,dtp1,99,384038,380198,3840,eur,mic_nongavi
kaz,Kazakhstan,2013,dtp3,98,384038,376357,7681,eur,mic_nongavi
kaz,Kazakhstan,2013,mcv2,99,300858,297849,3009,eur,mic_nongavi
kaz,Kazakhstan,2014,dtp1,96,383333,368000,15333,eur,mic_nongavi
kaz,Kazakhstan,2014,dtp3,95,383333,364166,19167,eur,mic_nongavi
kaz,Kazakhstan,2014,mcv1,99,383333,379500,3833,eur,mic_nongavi
kaz,Kazakhstan,2014,mcv2,99,324362,321118,3244,eur,mic_nongavi
kaz,Kazakhstan,2015,dtp1,99,380177,376375,3802,eur,mic_nongavi
kaz,Kazakhstan,2015,mcv1,99,380177,376375,3802,eur,mic_nongavi
kaz,Kazakhstan,2015,dtp3,98,380177,372573,7604,eur,mic_nongavi
kaz,Kazakhstan,2015,mcv2,98,346767,339832,6935,eur,mic_nongavi
kaz,Kazakhstan,2016,dtp3,82,374976,307480,67496,eur,mic_nongavi
kaz,Kazakhstan,2016,dtp1,93,374976,348728,26248,eur,mic_nongavi
kaz,Kazakhstan,2016,mcv1,99,374976,371226,3750,eur,mic_nongavi
kaz,Kazakhstan,2016,mcv2,99,365795,362137,3658,eur,mic_nongavi
ken,Kenya,2000,dtp1,83,1170022,971118,198904,afr,gavi
ken,Kenya,2000,mcv1,78,1170022,912617,257405,afr,gavi
ken,Kenya,2000,dtp3,82,1170022,959418,210604,afr,gavi
ken,Kenya,2001,dtp1,84,1197256,1005695,191561,afr,gavi
ken,Kenya,2001,mcv1,77,1197256,921887,275369,afr,gavi
ken,Kenya,2001,dtp3,80,1197256,957805,239451,afr,gavi
ken,Kenya,2002,dtp3,84,1224215,1028341,195874,afr,gavi
ken,Kenya,2002,mcv1,78,1224215,954888,269327,afr,gavi
ken,Kenya,2002,dtp1,90,1224215,1101794,122421,afr,gavi
ken,Kenya,2003,dtp3,73,1251230,913398,337832,afr,gavi
ken,Kenya,2003,dtp1,89,1251230,1113595,137635,afr,gavi
ken,Kenya,2003,mcv1,72,1251230,900886,350344,afr,gavi
ken,Kenya,2004,dtp1,87,1277961,1111826,166135,afr,gavi
ken,Kenya,2004,dtp3,73,1277961,932912,345049,afr,gavi
ken,Kenya,2004,mcv1,73,1277961,932912,345049,afr,gavi
ken,Kenya,2005,dtp3,76,1303492,990654,312838,afr,gavi
ken,Kenya,2005,dtp1,85,1303492,1107968,195524,afr,gavi
ken,Kenya,2005,mcv1,69,1303492,899409,404083,afr,gavi
ken,Kenya,2006,dtp3,80,1326667,1061334,265333,afr,gavi
ken,Kenya,2006,dtp1,90,1326667,1194000,132667,afr,gavi
ken,Kenya,2006,mcv1,77,1326667,1021534,305133,afr,gavi
ken,Kenya,2007,dtp1,89,1346751,1198608,148143,afr,gavi
ken,Kenya,2007,mcv1,80,1346751,1077401,269350,afr,gavi
ken,Kenya,2007,dtp3,81,1346751,1090868,255883,afr,gavi
ken,Kenya,2008,dtp1,90,1363489,1227140,136349,afr,gavi
ken,Kenya,2008,mcv1,90,1363489,1227140,136349,afr,gavi
ken,Kenya,2008,dtp3,88,1363489,1199870,163619,afr,gavi
ken,Kenya,2009,mcv1,88,1377127,1211872,165255,afr,gavi
ken,Kenya,2009,dtp1,92,1377127,1266957,110170,afr,gavi
ken,Kenya,2009,dtp3,88,1377127,1211872,165255,afr,gavi
ken,Kenya,2010,mcv1,86,1388432,1194052,194380,afr,gavi
ken,Kenya,2010,dtp1,93,1388432,1291242,97190,afr,gavi
ken,Kenya,2010,dtp3,90,1388432,1249589,138843,afr,gavi
ken,Kenya,2011,dtp1,98,1398555,1370584,27971,afr,gavi
ken,Kenya,2011,dtp3,96,1398555,1342613,55942,afr,gavi
ken,Kenya,2011,mcv1,87,1398555,1216743,181812,afr,gavi
ken,Kenya,2012,dtp1,98,1408837,1380660,28177,afr,gavi
ken,Kenya,2012,mcv1,93,1408837,1310218,98619,afr,gavi
ken,Kenya,2012,dtp3,94,1408837,1324307,84530,afr,gavi
ken,Kenya,2013,dtp3,87,1420345,1235700,184645,afr,gavi
ken,Kenya,2013,mcv1,73,1420345,1036852,383493,afr,gavi
ken,Kenya,2013,dtp1,95,1420345,1349328,71017,afr,gavi
ken,Kenya,2014,dtp3,92,1433590,1318903,114687,afr,gavi
ken,Kenya,2014,dtp1,97,1433590,1390582,43008,afr,gavi
ken,Kenya,2014,mcv1,79,1433590,1132536,301054,afr,gavi
ken,Kenya,2015,dtp3,89,1448737,1289376,159361,afr,gavi
ken,Kenya,2015,dtp1,96,1448737,1390788,57949,afr,gavi
ken,Kenya,2015,mcv1,75,1448737,1086553,362184,afr,gavi
ken,Kenya,2015,mcv2,28,1405240,393467,1011773,afr,gavi
ken,Kenya,2016,dtp1,96,1465529,1406908,58621,afr,gavi
ken,Kenya,2016,mcv1,75,1465529,1099147,366382,afr,gavi
ken,Kenya,2016,dtp3,89,1465529,1304321,161208,afr,gavi
ken,Kenya,2016,mcv2,32,1404300,449376,954924,afr,gavi
kgz,Kyrgyzstan,2000,dtp1,99,100980,99970,1010,eur,gavi
kgz,Kyrgyzstan,2000,mcv1,98,100980,98960,2020,eur,gavi
kgz,Kyrgyzstan,2000,dtp3,99,100980,99970,1010,eur,gavi
kgz,Kyrgyzstan,2000,mcv2,96,115616,110991,4625,eur,gavi
kgz,Kyrgyzstan,2001,dtp3,99,99814,98816,998,eur,gavi
kgz,Kyrgyzstan,2001,dtp1,99,99814,98816,998,eur,gavi
kgz,Kyrgyzstan,2001,mcv1,99,99814,98816,998,eur,gavi
kgz,Kyrgyzstan,2001,mcv2,98,113256,110991,2265,eur,gavi
kgz,Kyrgyzstan,2002,dtp3,98,99837,97840,1997,eur,gavi
kgz,Kyrgyzstan,2002,dtp1,99,99837,98839,998,eur,gavi
kgz,Kyrgyzstan,2002,mcv1,98,99837,97840,1997,eur,gavi
kgz,Kyrgyzstan,2002,mcv2,98,109980,107780,2200,eur,gavi
kgz,Kyrgyzstan,2003,dtp1,99,101115,100104,1011,eur,gavi
kgz,Kyrgyzstan,2003,dtp3,98,101115,99093,2022,eur,gavi
kgz,Kyrgyzstan,2003,mcv1,99,101115,100104,1011,eur,gavi
kgz,Kyrgyzstan,2003,mcv2,98,106174,104051,2123,eur,gavi
kgz,Kyrgyzstan,2004,dtp3,99,103650,102614,1036,eur,gavi
kgz,Kyrgyzstan,2004,dtp1,99,103650,102614,1036,eur,gavi
kgz,Kyrgyzstan,2004,mcv1,99,103650,102614,1036,eur,gavi
kgz,Kyrgyzstan,2004,mcv2,98,102160,100117,2043,eur,gavi
kgz,Kyrgyzstan,2005,dtp3,98,107471,105322,2149,eur,gavi
kgz,Kyrgyzstan,2005,dtp1,98,107471,105322,2149,eur,gavi
kgz,Kyrgyzstan,2005,mcv1,99,107471,106396,1075,eur,gavi
kgz,Kyrgyzstan,2005,mcv2,98,98268,96303,1965,eur,gavi
kgz,Kyrgyzstan,2006,dtp1,96,112544,108042,4502,eur,gavi
kgz,Kyrgyzstan,2006,dtp3,92,112544,103540,9004,eur,gavi
kgz,Kyrgyzstan,2006,mcv1,97,112544,109168,3376,eur,gavi
kgz,Kyrgyzstan,2006,mcv2,97,96695,93794,2901,eur,gavi
kgz,Kyrgyzstan,2007,dtp3,94,118532,111420,7112,eur,gavi
kgz,Kyrgyzstan,2007,dtp1,98,118532,116161,2371,eur,gavi
kgz,Kyrgyzstan,2007,mcv1,99,118532,117347,1185,eur,gavi
kgz,Kyrgyzstan,2007,mcv2,95,95997,91197,4800,eur,gavi
kgz,Kyrgyzstan,2008,mcv1,99,124998,123748,1250,eur,gavi
kgz,Kyrgyzstan,2008,dtp1,99,124998,123748,1250,eur,gavi
kgz,Kyrgyzstan,2008,dtp3,95,124998,118748,6250,eur,gavi
kgz,Kyrgyzstan,2008,mcv2,97,96191,93305,2886,eur,gavi
kgz,Kyrgyzstan,2009,dtp1,98,131529,128898,2631,eur,gavi
kgz,Kyrgyzstan,2009,mcv1,99,131529,130214,1315,eur,gavi
kgz,Kyrgyzstan,2009,dtp3,95,131529,124953,6576,eur,gavi
kgz,Kyrgyzstan,2009,mcv2,98,97311,95365,1946,eur,gavi
kgz,Kyrgyzstan,2010,dtp1,99,137588,136212,1376,eur,gavi
kgz,Kyrgyzstan,2010,mcv1,99,137588,136212,1376,eur,gavi
kgz,Kyrgyzstan,2010,dtp3,96,137588,132084,5504,eur,gavi
kgz,Kyrgyzstan,2010,mcv2,98,99355,97368,1987,eur,gavi
kgz,Kyrgyzstan,2011,mcv1,97,142661,138381,4280,eur,gavi
kgz,Kyrgyzstan,2011,dtp3,96,142661,136955,5706,eur,gavi
kgz,Kyrgyzstan,2011,dtp1,97,142661,138381,4280,eur,gavi
kgz,Kyrgyzstan,2011,mcv2,98,102019,99979,2040,eur,gavi
kgz,Kyrgyzstan,2012,dtp1,96,146488,140628,5860,eur,gavi
kgz,Kyrgyzstan,2012,mcv1,98,146488,143558,2930,eur,gavi
kgz,Kyrgyzstan,2012,dtp3,96,146488,140628,5860,eur,gavi
kgz,Kyrgyzstan,2012,mcv2,98,106666,104533,2133,eur,gavi
kgz,Kyrgyzstan,2013,dtp3,97,148915,144448,4467,eur,gavi
kgz,Kyrgyzstan,2013,dtp1,98,148915,145937,2978,eur,gavi
kgz,Kyrgyzstan,2013,mcv1,99,148915,147426,1489,eur,gavi
kgz,Kyrgyzstan,2013,mcv2,97,112633,109254,3379,eur,gavi
kgz,Kyrgyzstan,2014,dtp3,96,149879,143884,5995,eur,gavi
kgz,Kyrgyzstan,2014,dtp1,96,149879,143884,5995,eur,gavi
kgz,Kyrgyzstan,2014,mcv1,96,149879,143884,5995,eur,gavi
kgz,Kyrgyzstan,2014,mcv2,97,119369,115788,3581,eur,gavi
kgz,Kyrgyzstan,2015,dtp1,99,149453,147958,1495,eur,gavi
kgz,Kyrgyzstan,2015,mcv1,99,149453,147958,1495,eur,gavi
kgz,Kyrgyzstan,2015,dtp3,97,149453,144969,4484,eur,gavi
kgz,Kyrgyzstan,2015,mcv2,96,125987,120948,5039,eur,gavi
kgz,Kyrgyzstan,2016,dtp1,97,147873,143437,4436,eur,gavi
kgz,Kyrgyzstan,2016,dtp3,96,147873,141958,5915,eur,gavi
kgz,Kyrgyzstan,2016,mcv1,97,147873,143437,4436,eur,gavi
kgz,Kyrgyzstan,2016,mcv2,98,132450,129801,2649,eur,gavi
khm,Cambodia,2000,dtp1,78,313290,244366,68924,wpr,gavi
khm,Cambodia,2000,dtp3,59,313290,184841,128449,wpr,gavi
khm,Cambodia,2000,mcv1,65,313290,203638,109652,wpr,gavi
khm,Cambodia,2001,dtp3,60,313190,187914,125276,wpr,gavi
khm,Cambodia,2001,mcv1,59,313190,184782,128408,wpr,gavi
khm,Cambodia,2001,dtp1,65,313190,203574,109616,wpr,gavi
khm,Cambodia,2002,mcv1,52,314866,163730,151136,wpr,gavi
khm,Cambodia,2002,dtp1,60,314866,188920,125946,wpr,gavi
khm,Cambodia,2002,dtp3,54,314866,170028,144838,wpr,gavi
khm,Cambodia,2003,mcv1,65,318206,206834,111372,wpr,gavi
khm,Cambodia,2003,dtp1,74,318206,235472,82734,wpr,gavi
khm,Cambodia,2003,dtp3,69,318206,219562,98644,wpr,gavi
khm,Cambodia,2004,mcv1,80,322983,258386,64597,wpr,gavi
khm,Cambodia,2004,dtp3,85,322983,274536,48447,wpr,gavi
khm,Cambodia,2004,dtp1,92,322983,297144,25839,wpr,gavi
khm,Cambodia,2005,dtp3,82,328726,269555,59171,wpr,gavi
khm,Cambodia,2005,dtp1,85,328726,279417,49309,wpr,gavi
khm,Cambodia,2005,mcv1,79,328726,259694,69032,wpr,gavi
khm,Cambodia,2006,dtp3,80,334826,267861,66965,wpr,gavi
khm,Cambodia,2006,dtp1,85,334826,284602,50224,wpr,gavi
khm,Cambodia,2006,mcv1,78,334826,261164,73662,wpr,gavi
khm,Cambodia,2007,dtp3,82,340639,279324,61315,wpr,gavi
khm,Cambodia,2007,mcv1,79,340639,269105,71534,wpr,gavi
khm,Cambodia,2007,dtp1,87,340639,296356,44283,wpr,gavi
khm,Cambodia,2008,dtp1,95,345653,328370,17283,wpr,gavi
khm,Cambodia,2008,dtp3,91,345653,314544,31109,wpr,gavi
khm,Cambodia,2008,mcv1,89,345653,307631,38022,wpr,gavi
khm,Cambodia,2009,dtp1,99,349593,346097,3496,wpr,gavi
khm,Cambodia,2009,mcv1,92,349593,321626,27967,wpr,gavi
khm,Cambodia,2009,dtp3,94,349593,328617,20976,wpr,gavi
khm,Cambodia,2010,dtp1,92,352409,324216,28193,wpr,gavi
khm,Cambodia,2010,mcv1,89,352409,313644,38765,wpr,gavi
khm,Cambodia,2010,dtp3,89,352409,313644,38765,wpr,gavi
khm,Cambodia,2011,dtp3,88,354287,311773,42514,wpr,gavi
khm,Cambodia,2011,mcv1,83,354287,294058,60229,wpr,gavi
khm,Cambodia,2011,dtp1,94,354287,333030,21257,wpr,gavi
khm,Cambodia,2012,dtp3,86,355633,305844,49789,wpr,gavi
khm,Cambodia,2012,mcv1,79,355633,280950,74683,wpr,gavi
khm,Cambodia,2012,dtp1,94,355633,334295,21338,wpr,gavi
khm,Cambodia,2012,mcv2,41,359748,147497,212251,wpr,gavi
khm,Cambodia,2013,dtp3,83,356744,296098,60646,wpr,gavi
khm,Cambodia,2013,dtp1,92,356744,328204,28540,wpr,gavi
khm,Cambodia,2013,mcv1,76,356744,271125,85619,wpr,gavi
khm,Cambodia,2013,mcv2,49,347654,170350,177304,wpr,gavi
khm,Cambodia,2014,dtp3,88,357654,314736,42918,wpr,gavi
khm,Cambodia,2014,mcv1,80,357654,286123,71531,wpr,gavi
khm,Cambodia,2014,dtp1,92,357654,329042,28612,wpr,gavi
khm,Cambodia,2014,mcv2,59,352400,207916,144484,wpr,gavi
khm,Cambodia,2015,mcv1,81,358273,290201,68072,wpr,gavi
khm,Cambodia,2015,dtp3,89,358273,318863,39410,wpr,gavi
khm,Cambodia,2015,dtp1,92,358273,329611,28662,wpr,gavi
khm,Cambodia,2015,mcv2,58,355866,206402,149464,wpr,gavi
khm,Cambodia,2016,dtp3,90,358422,322580,35842,wpr,gavi
khm,Cambodia,2016,dtp1,92,358422,329748,28674,wpr,gavi
khm,Cambodia,2016,mcv1,81,358422,290322,68100,wpr,gavi
khm,Cambodia,2016,mcv2,58,354097,205376,148721,wpr,gavi
kir,Kiribati,2000,dtp3,90,2445,2201,244,wpr,gavi
kir,Kiribati,2000,mcv1,80,2445,1956,489,wpr,gavi
kir,Kiribati,2000,dtp1,95,2445,2323,122,wpr,gavi
kir,Kiribati,2001,mcv1,76,2463,1872,591,wpr,gavi
kir,Kiribati,2001,dtp3,85,2463,2094,369,wpr,gavi
kir,Kiribati,2001,dtp1,85,2463,2094,369,wpr,gavi
kir,Kiribati,2002,mcv1,88,2489,2190,299,wpr,gavi
kir,Kiribati,2002,dtp3,77,2489,1917,572,wpr,gavi
kir,Kiribati,2002,dtp1,82,2489,2041,448,wpr,gavi
kir,Kiribati,2003,dtp1,78,2521,1966,555,wpr,gavi
kir,Kiribati,2003,mcv1,72,2521,1815,706,wpr,gavi
kir,Kiribati,2003,dtp3,70,2521,1765,756,wpr,gavi
kir,Kiribati,2004,mcv1,56,2560,1434,1126,wpr,gavi
kir,Kiribati,2004,dtp3,62,2560,1587,973,wpr,gavi
kir,Kiribati,2004,dtp1,75,2560,1920,640,wpr,gavi
kir,Kiribati,2005,dtp1,93,2606,2424,182,wpr,gavi
kir,Kiribati,2005,dtp3,79,2606,2059,547,wpr,gavi
kir,Kiribati,2005,mcv1,85,2606,2215,391,wpr,gavi
kir,Kiribati,2006,dtp3,86,2657,2285,372,wpr,gavi
kir,Kiribati,2006,dtp1,98,2657,2604,53,wpr,gavi
kir,Kiribati,2006,mcv1,61,2657,1621,1036,wpr,gavi
kir,Kiribati,2007,dtp3,94,2710,2547,163,wpr,gavi
kir,Kiribati,2007,dtp1,99,2710,2683,27,wpr,gavi
kir,Kiribati,2007,mcv1,93,2710,2520,190,wpr,gavi
kir,Kiribati,2008,dtp3,82,2766,2268,498,wpr,gavi
kir,Kiribati,2008,mcv1,72,2766,1992,774,wpr,gavi
kir,Kiribati,2008,dtp1,97,2766,2683,83,wpr,gavi
kir,Kiribati,2009,mcv1,82,2822,2314,508,wpr,gavi
kir,Kiribati,2009,dtp1,90,2822,2540,282,wpr,gavi
kir,Kiribati,2009,dtp3,86,2822,2427,395,wpr,gavi
kir,Kiribati,2009,mcv2,35,2164,757,1407,wpr,gavi
kir,Kiribati,2010,dtp3,91,2874,2615,259,wpr,gavi
kir,Kiribati,2010,mcv1,89,2874,2558,316,wpr,gavi
kir,Kiribati,2010,dtp1,97,2874,2788,86,wpr,gavi
kir,Kiribati,2010,mcv2,21,2144,450,1694,wpr,gavi
kir,Kiribati,2011,mcv1,90,2924,2632,292,wpr,gavi
kir,Kiribati,2011,dtp3,99,2924,2895,29,wpr,gavi
kir,Kiribati,2011,dtp1,99,2924,2895,29,wpr,gavi
kir,Kiribati,2011,mcv2,61,2206,1346,860,wpr,gavi
kir,Kiribati,2012,dtp3,94,2967,2789,178,wpr,gavi
kir,Kiribati,2012,mcv1,91,2967,2700,267,wpr,gavi
kir,Kiribati,2012,dtp1,94,2967,2789,178,wpr,gavi
kir,Kiribati,2012,mcv2,9,2358,212,2146,wpr,gavi
kir,Kiribati,2013,dtp1,95,3006,2856,150,wpr,gavi
kir,Kiribati,2013,mcv1,91,3006,2735,271,wpr,gavi
kir,Kiribati,2013,dtp3,95,3006,2856,150,wpr,gavi
kir,Kiribati,2013,mcv2,84,2554,2145,409,wpr,gavi
kir,Kiribati,2014,dtp3,75,3039,2279,760,wpr,gavi
kir,Kiribati,2014,mcv1,88,3039,2674,365,wpr,gavi
kir,Kiribati,2014,dtp1,83,3039,2522,517,wpr,gavi
kir,Kiribati,2014,mcv2,80,2749,2199,550,wpr,gavi
kir,Kiribati,2015,dtp3,78,3066,2391,675,wpr,gavi
kir,Kiribati,2015,mcv1,84,3066,2575,491,wpr,gavi
kir,Kiribati,2015,dtp1,81,3066,2483,583,wpr,gavi
kir,Kiribati,2015,mcv2,76,2879,2188,691,wpr,gavi
kir,Kiribati,2016,dtp1,82,3088,2532,556,wpr,gavi
kir,Kiribati,2016,dtp3,81,3088,2501,587,wpr,gavi
kir,Kiribati,2016,mcv1,80,3088,2470,618,wpr,gavi
kir,Kiribati,2016,mcv2,79,2956,2335,621,wpr,gavi
kna,Saint Kitts and Nevis,2000,dtp1,99,941.3606373959,932,9.3606373959,amr,hic
kna,Saint Kitts and Nevis,2000,mcv1,99,941.3606373959,932,9.3606373959,amr,hic
kna,Saint Kitts and Nevis,2000,dtp3,98,941.3606373959,923,18.3606373959,amr,hic
kna,Saint Kitts and Nevis,2000,mcv2,99,941.3606373959,932,9.3606373959,amr,hic
kna,Saint Kitts and Nevis,2001,mcv1,90,939.1661287167,845,94.1661287167,amr,hic
kna,Saint Kitts and Nevis,2001,dtp1,99,939.1661287167,930,9.1661287167,amr,hic
kna,Saint Kitts and Nevis,2001,dtp3,99,939.1661287167,930,9.1661287167,amr,hic
kna,Saint Kitts and Nevis,2001,mcv2,99,939.1661287167,930,9.1661287167,amr,hic
kna,Saint Kitts and Nevis,2002,dtp3,96,938.3549994206,901,37.3549994206,amr,hic
kna,Saint Kitts and Nevis,2002,dtp1,99,938.3549994206,929,9.3549994206,amr,hic
kna,Saint Kitts and Nevis,2002,mcv1,99,938.3549994206,929,9.3549994206,amr,hic
kna,Saint Kitts and Nevis,2002,mcv2,99,938.3549994206,929,9.3549994206,amr,hic
kna,Saint Kitts and Nevis,2003,dtp1,98,938.5175222516,920,18.5175222516,amr,hic
kna,Saint Kitts and Nevis,2003,dtp3,98,938.5175222516,920,18.5175222516,amr,hic
kna,Saint Kitts and Nevis,2003,mcv1,98,938.5175222516,920,18.5175222516,amr,hic
kna,Saint Kitts and Nevis,2003,mcv2,98,938.5175222516,920,18.5175222516,amr,hic
kna,Saint Kitts and Nevis,2004,dtp1,98,939.3042725277,921,18.3042725277,amr,hic
kna,Saint Kitts and Nevis,2004,mcv1,98,939.3042725277,921,18.3042725277,amr,hic
kna,Saint Kitts and Nevis,2004,dtp3,95,939.3042725277,892,47.3042725277,amr,hic
kna,Saint Kitts and Nevis,2004,mcv2,98,939.3042725277,921,18.3042725277,amr,hic
kna,Saint Kitts and Nevis,2005,dtp3,99,940.17331855,931,9.17331855,amr,hic
kna,Saint Kitts and Nevis,2005,dtp1,99,940.17331855,931,9.17331855,amr,hic
kna,Saint Kitts and Nevis,2005,mcv1,99,940.17331855,931,9.17331855,amr,hic
kna,Saint Kitts and Nevis,2005,mcv2,97,940.17331855,912,28.17331855,amr,hic
kna,Saint Kitts and Nevis,2006,dtp3,99,940.7372576366,931,9.7372576366,amr,hic
kna,Saint Kitts and Nevis,2006,mcv1,99,940.7372576366,931,9.7372576366,amr,hic
kna,Saint Kitts and Nevis,2006,dtp1,99,940.7372576366,931,9.7372576366,amr,hic
kna,Saint Kitts and Nevis,2006,mcv2,96,940.7372576366,903,37.7372576366,amr,hic
kna,Saint Kitts and Nevis,2007,dtp3,99,941.1391075547,932,9.1391075547,amr,hic
kna,Saint Kitts and Nevis,2007,mcv1,99,941.1391075547,932,9.1391075547,amr,hic
kna,Saint Kitts and Nevis,2007,dtp1,99,941.1391075547,932,9.1391075547,amr,hic
kna,Saint Kitts and Nevis,2007,mcv2,95,941.1391075547,894,47.1391075547,amr,hic
kna,Saint Kitts and Nevis,2008,dtp1,99,941.1942721315,932,9.1942721315,amr,hic
kna,Saint Kitts and Nevis,2008,mcv1,99,941.1942721315,932,9.1942721315,amr,hic
kna,Saint Kitts and Nevis,2008,dtp3,98,941.1942721315,922,19.1942721315,amr,hic
kna,Saint Kitts and Nevis,2008,mcv2,94,941.1942721315,885,56.1942721315,amr,hic
kna,Saint Kitts and Nevis,2009,dtp3,97,941.2563464449,913,28.2563464449,amr,hic
kna,Saint Kitts and Nevis,2009,dtp1,99,941.2563464449,932,9.2563464449,amr,hic
kna,Saint Kitts and Nevis,2009,mcv1,99,941.2563464449,932,9.2563464449,amr,hic
kna,Saint Kitts and Nevis,2009,mcv2,99,941.2563464449,932,9.2563464449,amr,hic
kna,Saint Kitts and Nevis,2010,mcv1,99,941.1588248998,932,9.1588248998,amr,hic
kna,Saint Kitts and Nevis,2010,dtp3,95,941.1588248998,894,47.1588248998,amr,hic
kna,Saint Kitts and Nevis,2010,dtp1,98,941.1588248998,922,19.1588248998,amr,hic
kna,Saint Kitts and Nevis,2010,mcv2,99,941.1588248998,932,9.1588248998,amr,hic
kna,Saint Kitts and Nevis,2011,dtp3,97,940.6875142846,912,28.6875142846,amr,hic
kna,Saint Kitts and Nevis,2011,dtp1,99,940.6875142846,931,9.6875142846,amr,hic
kna,Saint Kitts and Nevis,2011,mcv1,99,940.6875142846,931,9.6875142846,amr,hic
kna,Saint Kitts and Nevis,2011,mcv2,99,940.6875142846,931,9.6875142846,amr,hic
kna,Saint Kitts and Nevis,2012,dtp3,97,940.2461147362,912,28.2461147362,amr,hic
kna,Saint Kitts and Nevis,2012,dtp1,99,940.2461147362,931,9.2461147362,amr,hic
kna,Saint Kitts and Nevis,2012,mcv1,95,940.2461147362,893,47.2461147362,amr,hic
kna,Saint Kitts and Nevis,2012,mcv2,90,940.2461147362,846,94.2461147362,amr,hic
kna,Saint Kitts and Nevis,2013,mcv1,99,939.2913045412,930,9.2913045412,amr,hic
kna,Saint Kitts and Nevis,2013,dtp1,99,939.2913045412,930,9.2913045412,amr,hic
kna,Saint Kitts and Nevis,2013,dtp3,96,939.2913045412,902,37.2913045412,amr,hic
kna,Saint Kitts and Nevis,2013,mcv2,94,939.2913045412,883,56.2913045412,amr,hic
kna,Saint Kitts and Nevis,2014,mcv1,93,937.8610595886,872,65.8610595886,amr,hic
kna,Saint Kitts and Nevis,2014,dtp3,97,937.8610595886,910,27.8610595886,amr,hic
kna,Saint Kitts and Nevis,2014,dtp1,99,937.8610595886,928,9.8610595886,amr,hic
kna,Saint Kitts and Nevis,2014,mcv2,90,937.8610595886,844,93.8610595886,amr,hic
kna,Saint Kitts and Nevis,2015,mcv1,95,935.7974976446,889,46.7974976446,amr,hic
kna,Saint Kitts and Nevis,2015,dtp3,93,935.7974976446,870,65.7974976446,amr,hic
kna,Saint Kitts and Nevis,2015,dtp1,96,935.7974976446,898,37.7974976446,amr,hic
kna,Saint Kitts and Nevis,2015,mcv2,90,935.7974976446,842,93.7974976446,amr,hic
kna,Saint Kitts and Nevis,2016,mcv1,98,933.1736147537,915,18.1736147537,amr,hic
kna,Saint Kitts and Nevis,2016,dtp1,99,933.1736147537,924,9.1736147537,amr,hic
kna,Saint Kitts and Nevis,2016,dtp3,97,933.1736147537,905,28.1736147537,amr,hic
kna,Saint Kitts and Nevis,2016,mcv2,97,NA,NA,#VALUE!,amr,hic
kor,Republic of Korea,2000,mcv1,95,566136,537829,28307,wpr,hic
kor,Republic of Korea,2000,dtp1,97,566136,549152,16984,wpr,hic
kor,Republic of Korea,2000,dtp3,97,566136,549152,16984,wpr,hic
kor,Republic of Korea,2000,mcv2,39,713680,278335,435345,wpr,hic
kor,Republic of Korea,2001,dtp3,97,540614,524396,16218,wpr,hic
kor,Republic of Korea,2001,mcv1,96,540614,518989,21625,wpr,hic
kor,Republic of Korea,2001,dtp1,97,540614,524396,16218,wpr,hic
kor,Republic of Korea,2001,mcv2,67,687047,460321,226726,wpr,hic
kor,Republic of Korea,2002,dtp3,97,517477,501953,15524,wpr,hic
kor,Republic of Korea,2002,mcv1,97,517477,501953,15524,wpr,hic
kor,Republic of Korea,2002,dtp1,97,517477,501953,15524,wpr,hic
kor,Republic of Korea,2002,mcv2,95,649126,616670,32456,wpr,hic
kor,Republic of Korea,2003,dtp1,97,497559,482632,14927,wpr,hic
kor,Republic of Korea,2003,mcv1,96,497559,477657,19902,wpr,hic
kor,Republic of Korea,2003,dtp3,97,497559,482632,14927,wpr,hic
kor,Republic of Korea,2003,mcv2,95,607809,577419,30390,wpr,hic
kor,Republic of Korea,2004,dtp3,88,481500,423720,57780,wpr,hic
kor,Republic of Korea,2004,dtp1,95,481500,457425,24075,wpr,hic
kor,Republic of Korea,2004,mcv1,99,481500,476685,4815,wpr,hic
kor,Republic of Korea,2004,mcv2,99,573921,568182,5739,wpr,hic
kor,Republic of Korea,2005,dtp3,96,469525,450744,18781,wpr,hic
kor,Republic of Korea,2005,dtp1,98,469525,460134,9391,wpr,hic
kor,Republic of Korea,2005,mcv1,99,469525,464830,4695,wpr,hic
kor,Republic of Korea,2005,mcv2,99,560553,554947,5606,wpr,hic
kor,Republic of Korea,2006,dtp1,98,461307,452081,9226,wpr,hic
kor,Republic of Korea,2006,dtp3,98,461307,452081,9226,wpr,hic
kor,Republic of Korea,2006,mcv1,99,461307,456694,4613,wpr,hic
kor,Republic of Korea,2006,mcv2,99,530975,525665,5310,wpr,hic
kor,Republic of Korea,2007,dtp3,91,455733,414717,41016,wpr,hic
kor,Republic of Korea,2007,mcv1,92,455733,419274,36459,wpr,hic
kor,Republic of Korea,2007,dtp1,95,455733,432946,22787,wpr,hic
kor,Republic of Korea,2007,mcv2,99,501824,496806,5018,wpr,hic
kor,Republic of Korea,2008,dtp3,94,451807,424699,27108,wpr,hic
kor,Republic of Korea,2008,mcv1,92,451807,415662,36145,wpr,hic
kor,Republic of Korea,2008,dtp1,95,451807,429217,22590,wpr,hic
kor,Republic of Korea,2008,mcv2,99,476085,471324,4761,wpr,hic
kor,Republic of Korea,2009,dtp3,94,449078,422133,26945,wpr,hic
kor,Republic of Korea,2009,dtp1,96,449078,431115,17963,wpr,hic
kor,Republic of Korea,2009,mcv1,93,449078,417643,31435,wpr,hic
kor,Republic of Korea,2009,mcv2,99,457162,452590,4572,wpr,hic
kor,Republic of Korea,2010,dtp1,96,447225,429336,17889,wpr,hic
kor,Republic of Korea,2010,mcv1,98,447225,438280,8945,wpr,hic
kor,Republic of Korea,2010,dtp3,94,447225,420392,26833,wpr,hic
kor,Republic of Korea,2010,mcv2,98,448838,439861,8977,wpr,hic
kor,Republic of Korea,2011,dtp1,99,446102,441641,4461,wpr,hic
kor,Republic of Korea,2011,mcv1,99,446102,441641,4461,wpr,hic
kor,Republic of Korea,2011,dtp3,99,446102,441641,4461,wpr,hic
kor,Republic of Korea,2011,mcv2,98,447117,438175,8942,wpr,hic
kor,Republic of Korea,2012,dtp3,99,445729,441272,4457,wpr,hic
kor,Republic of Korea,2012,mcv1,99,445729,441272,4457,wpr,hic
kor,Republic of Korea,2012,dtp1,99,445729,441272,4457,wpr,hic
kor,Republic of Korea,2012,mcv2,97,450906,437379,13527,wpr,hic
kor,Republic of Korea,2013,dtp3,99,446040,441580,4460,wpr,hic
kor,Republic of Korea,2013,mcv1,99,446040,441580,4460,wpr,hic
kor,Republic of Korea,2013,dtp1,99,446040,441580,4460,wpr,hic
kor,Republic of Korea,2013,mcv2,95,456320,433504,22816,wpr,hic
kor,Republic of Korea,2014,dtp1,99,446811,442343,4468,wpr,hic
kor,Republic of Korea,2014,mcv1,99,446811,442343,4468,wpr,hic
kor,Republic of Korea,2014,dtp3,99,446811,442343,4468,wpr,hic
kor,Republic of Korea,2014,mcv2,96,458094,439770,18324,wpr,hic
kor,Republic of Korea,2015,mcv1,98,447847,438890,8957,wpr,hic
kor,Republic of Korea,2015,dtp3,98,447847,438890,8957,wpr,hic
kor,Republic of Korea,2015,dtp1,99,447847,443369,4478,wpr,hic
kor,Republic of Korea,2015,mcv2,97,449801,436307,13494,wpr,hic
kor,Republic of Korea,2016,dtp1,98,449015,440035,8980,wpr,hic
kor,Republic of Korea,2016,dtp3,98,449015,440035,8980,wpr,hic
kor,Republic of Korea,2016,mcv1,98,449015,440035,8980,wpr,hic
kor,Republic of Korea,2016,mcv2,97,448442,434989,13453,wpr,hic
kwt,Kuwait,2000,dtp1,98,44008,43128,880,emr,hic
kwt,Kuwait,2000,dtp3,98,44008,43128,880,emr,hic
kwt,Kuwait,2000,mcv1,99,44008,43568,440,emr,hic
kwt,Kuwait,2001,dtp3,99,44505,44060,445,emr,hic
kwt,Kuwait,2001,dtp1,99,44505,44060,445,emr,hic
kwt,Kuwait,2001,mcv1,99,44505,44060,445,emr,hic
kwt,Kuwait,2002,dtp1,99,45182,44730,452,emr,hic
kwt,Kuwait,2002,dtp3,99,45182,44730,452,emr,hic
kwt,Kuwait,2002,mcv1,97,45182,43827,1355,emr,hic
kwt,Kuwait,2003,dtp1,99,46201,45739,462,emr,hic
kwt,Kuwait,2003,dtp3,99,46201,45739,462,emr,hic
kwt,Kuwait,2003,mcv1,97,46201,44815,1386,emr,hic
kwt,Kuwait,2004,mcv1,97,47581,46154,1427,emr,hic
kwt,Kuwait,2004,dtp1,99,47581,47105,476,emr,hic
kwt,Kuwait,2004,dtp3,98,47581,46629,952,emr,hic
kwt,Kuwait,2005,dtp3,99,49292,48799,493,emr,hic
kwt,Kuwait,2005,dtp1,99,49292,48799,493,emr,hic
kwt,Kuwait,2005,mcv1,99,49292,48799,493,emr,hic
kwt,Kuwait,2005,mcv2,77,43598,33570,10028,emr,hic
kwt,Kuwait,2006,dtp1,99,51248,50736,512,emr,hic
kwt,Kuwait,2006,mcv1,99,51248,50736,512,emr,hic
kwt,Kuwait,2006,dtp3,99,51248,50736,512,emr,hic
kwt,Kuwait,2006,mcv2,96,42614,40909,1705,emr,hic
kwt,Kuwait,2007,mcv1,99,53295,52762,533,emr,hic
kwt,Kuwait,2007,dtp1,99,53295,52762,533,emr,hic
kwt,Kuwait,2007,dtp3,99,53295,52762,533,emr,hic
kwt,Kuwait,2007,mcv2,90,42228,38005,4223,emr,hic
kwt,Kuwait,2008,dtp1,99,55286,54733,553,emr,hic
kwt,Kuwait,2008,dtp3,99,55286,54733,553,emr,hic
kwt,Kuwait,2008,mcv1,99,55286,54733,553,emr,hic
kwt,Kuwait,2008,mcv2,86,42984,36966,6018,emr,hic
kwt,Kuwait,2009,dtp3,99,57141,56570,571,emr,hic
kwt,Kuwait,2009,dtp1,99,57141,56570,571,emr,hic
kwt,Kuwait,2009,mcv1,99,57141,56570,571,emr,hic
kwt,Kuwait,2009,mcv2,94,48093,45207,2886,emr,hic
kwt,Kuwait,2010,dtp3,98,58806,57630,1176,emr,hic
kwt,Kuwait,2010,mcv1,98,58806,57630,1176,emr,hic
kwt,Kuwait,2010,dtp1,98,58806,57630,1176,emr,hic
kwt,Kuwait,2010,mcv2,99,54024,53484,540,emr,hic
kwt,Kuwait,2011,dtp3,99,60268,59665,603,emr,hic
kwt,Kuwait,2011,dtp1,99,60268,59665,603,emr,hic
kwt,Kuwait,2011,mcv1,99,60268,59665,603,emr,hic
kwt,Kuwait,2011,mcv2,99,58190,57608,582,emr,hic
kwt,Kuwait,2012,dtp3,98,61549,60318,1231,emr,hic
kwt,Kuwait,2012,dtp1,99,61549,60934,615,emr,hic
kwt,Kuwait,2012,mcv1,99,61549,60934,615,emr,hic
kwt,Kuwait,2012,mcv2,99,62142,61521,621,emr,hic
kwt,Kuwait,2013,dtp1,99,62658,62031,627,emr,hic
kwt,Kuwait,2013,dtp3,99,62658,62031,627,emr,hic
kwt,Kuwait,2013,mcv1,99,62658,62031,627,emr,hic
kwt,Kuwait,2013,mcv2,99,60552,59946,606,emr,hic
kwt,Kuwait,2014,dtp3,95,63568,60390,3178,emr,hic
kwt,Kuwait,2014,mcv1,94,63568,59754,3814,emr,hic
kwt,Kuwait,2014,dtp1,97,63568,61661,1907,emr,hic
kwt,Kuwait,2014,mcv2,86,62008,53327,8681,emr,hic
kwt,Kuwait,2015,mcv1,93,64219,59724,4495,emr,hic
kwt,Kuwait,2015,dtp3,99,64219,63577,642,emr,hic
kwt,Kuwait,2015,dtp1,99,64219,63577,642,emr,hic
kwt,Kuwait,2015,mcv2,96,62699,60191,2508,emr,hic
kwt,Kuwait,2016,mcv1,93,64549,60031,4518,emr,hic
kwt,Kuwait,2016,dtp3,99,64549,63904,645,emr,hic
kwt,Kuwait,2016,dtp1,99,64549,63904,645,emr,hic
kwt,Kuwait,2016,mcv2,96,63591,61047,2544,emr,hic
lao,Lao People’s Democratic Republic,2000,dtp3,51,156672,79903,76769,wpr,gavi
lao,Lao People’s Democratic Republic,2000,mcv1,42,156672,65802,90870,wpr,gavi
lao,Lao People’s Democratic Republic,2000,dtp1,83,156672,130038,26634,wpr,gavi
lao,Lao People’s Democratic Republic,2001,dtp3,52,155128,80667,74461,wpr,gavi
lao,Lao People’s Democratic Republic,2001,dtp1,59,155128,91526,63602,wpr,gavi
lao,Lao People’s Democratic Republic,2001,mcv1,50,155128,77564,77564,wpr,gavi
lao,Lao People’s Democratic Republic,2002,mcv1,55,154220,84821,69399,wpr,gavi
lao,Lao People’s Democratic Republic,2002,dtp3,53,154220,81737,72483,wpr,gavi
lao,Lao People’s Democratic Republic,2002,dtp1,64,154220,98701,55519,wpr,gavi
lao,Lao People’s Democratic Republic,2003,dtp3,49,153907,75414,78493,wpr,gavi
lao,Lao People’s Democratic Republic,2003,dtp1,72,153907,110813,43094,wpr,gavi
lao,Lao People’s Democratic Republic,2003,mcv1,42,153907,64641,89266,wpr,gavi
lao,Lao People’s Democratic Republic,2004,mcv1,36,154154,55495,98659,wpr,gavi
lao,Lao People’s Democratic Republic,2004,dtp3,45,154154,69369,84785,wpr,gavi
lao,Lao People’s Democratic Republic,2004,dtp1,66,154154,101742,52412,wpr,gavi
lao,Lao People’s Democratic Republic,2005,dtp3,49,154835,75869,78966,wpr,gavi
lao,Lao People’s Democratic Republic,2005,dtp1,68,154835,105288,49547,wpr,gavi
lao,Lao People’s Democratic Republic,2005,mcv1,41,154835,63482,91353,wpr,gavi
lao,Lao People’s Democratic Republic,2006,dtp1,68,155753,105912,49841,wpr,gavi
lao,Lao People’s Democratic Republic,2006,mcv1,48,155753,74761,80992,wpr,gavi
lao,Lao People’s Democratic Republic,2006,dtp3,57,155753,88779,66974,wpr,gavi
lao,Lao People’s Democratic Republic,2007,dtp1,59,156663,92431,64232,wpr,gavi
lao,Lao People’s Democratic Republic,2007,dtp3,50,156663,78331,78332,wpr,gavi
lao,Lao People’s Democratic Republic,2007,mcv1,40,156663,62665,93998,wpr,gavi
lao,Lao People’s Democratic Republic,2008,dtp3,61,157367,95994,61373,wpr,gavi
lao,Lao People’s Democratic Republic,2008,dtp1,73,157367,114878,42489,wpr,gavi
lao,Lao People’s Democratic Republic,2008,mcv1,52,157367,81831,75536,wpr,gavi
lao,Lao People’s Democratic Republic,2009,dtp1,76,157768,119904,37864,wpr,gavi
lao,Lao People’s Democratic Republic,2009,mcv1,59,157768,93083,64685,wpr,gavi
lao,Lao People’s Democratic Republic,2009,dtp3,67,157768,105705,52063,wpr,gavi
lao,Lao People’s Democratic Republic,2010,dtp1,81,157829,127841,29988,wpr,gavi
lao,Lao People’s Democratic Republic,2010,dtp3,74,157829,116793,41036,wpr,gavi
lao,Lao People’s Democratic Republic,2010,mcv1,64,157829,101011,56818,wpr,gavi
lao,Lao People’s Democratic Republic,2011,dtp1,83,157586,130796,26790,wpr,gavi
lao,Lao People’s Democratic Republic,2011,dtp3,78,157586,122917,34669,wpr,gavi
lao,Lao People’s Democratic Republic,2011,mcv1,69,157586,108734,48852,wpr,gavi
lao,Lao People’s Democratic Republic,2012,dtp1,87,157167,136735,20432,wpr,gavi
lao,Lao People’s Democratic Republic,2012,dtp3,79,157167,124162,33005,wpr,gavi
lao,Lao People’s Democratic Republic,2012,mcv1,72,157167,113160,44007,wpr,gavi
lao,Lao People’s Democratic Republic,2013,dtp3,87,156673,136306,20367,wpr,gavi
lao,Lao People’s Democratic Republic,2013,dtp1,89,156673,139439,17234,wpr,gavi
lao,Lao People’s Democratic Republic,2013,mcv1,82,156673,128472,28201,wpr,gavi
lao,Lao People’s Democratic Republic,2014,dtp3,88,156127,137392,18735,wpr,gavi
lao,Lao People’s Democratic Republic,2014,dtp1,94,156127,146759,9368,wpr,gavi
lao,Lao People’s Democratic Republic,2014,mcv1,87,156127,135830,20297,wpr,gavi
lao,Lao People’s Democratic Republic,2015,dtp3,89,155540,138431,17109,wpr,gavi
lao,Lao People’s Democratic Republic,2015,mcv1,88,155540,136875,18665,wpr,gavi
lao,Lao People’s Democratic Republic,2015,dtp1,93,155540,144652,10888,wpr,gavi
lao,Lao People’s Democratic Republic,2016,dtp3,82,154902,127020,27882,wpr,gavi
lao,Lao People’s Democratic Republic,2016,dtp1,85,154902,131667,23235,wpr,gavi
lao,Lao People’s Democratic Republic,2016,mcv1,76,154902,117726,37176,wpr,gavi
lbn,Lebanon,2000,dtp3,83,61002,50632,10370,emr,mic_nongavi
lbn,Lebanon,2000,mcv1,71,61002,43311,17691,emr,mic_nongavi
lbn,Lebanon,2000,dtp1,90,61002,54902,6100,emr,mic_nongavi
lbn,Lebanon,2000,mcv2,56,61928,34680,27248,emr,mic_nongavi
lbn,Lebanon,2001,dtp3,80,59590,47672,11918,emr,mic_nongavi
lbn,Lebanon,2001,dtp1,88,59590,52439,7151,emr,mic_nongavi
lbn,Lebanon,2001,mcv1,65,59590,38734,20856,emr,mic_nongavi
lbn,Lebanon,2001,mcv2,42,64216,26971,37245,emr,mic_nongavi
lbn,Lebanon,2002,dtp1,85,57902,49217,8685,emr,mic_nongavi
lbn,Lebanon,2002,dtp3,77,57902,44585,13317,emr,mic_nongavi
lbn,Lebanon,2002,mcv1,59,57902,34162,23740,emr,mic_nongavi
lbn,Lebanon,2002,mcv2,28,67640,18939,48701,emr,mic_nongavi
lbn,Lebanon,2003,dtp1,83,56089,46554,9535,emr,mic_nongavi
lbn,Lebanon,2003,dtp3,74,56089,41506,14583,emr,mic_nongavi
lbn,Lebanon,2003,mcv1,53,56089,29727,26362,emr,mic_nongavi
lbn,Lebanon,2003,mcv2,14,68440,9582,58858,emr,mic_nongavi
lbn,Lebanon,2004,mcv1,58,54355,31526,22829,emr,mic_nongavi
lbn,Lebanon,2004,dtp1,83,54355,45115,9240,emr,mic_nongavi
lbn,Lebanon,2004,dtp3,75,54355,40766,13589,emr,mic_nongavi
lbn,Lebanon,2004,mcv2,24,69165,16600,52565,emr,mic_nongavi
lbn,Lebanon,2005,mcv1,63,53074,33437,19637,emr,mic_nongavi
lbn,Lebanon,2005,dtp1,83,53074,44051,9023,emr,mic_nongavi
lbn,Lebanon,2005,dtp3,77,53074,40867,12207,emr,mic_nongavi
lbn,Lebanon,2005,mcv2,34,68611,23328,45283,emr,mic_nongavi
lbn,Lebanon,2006,dtp3,78,52667,41080,11587,emr,mic_nongavi
lbn,Lebanon,2006,dtp1,84,52667,44240,8427,emr,mic_nongavi
lbn,Lebanon,2006,mcv1,69,52667,36340,16327,emr,mic_nongavi
lbn,Lebanon,2006,mcv2,45,63430,28544,34886,emr,mic_nongavi
lbn,Lebanon,2007,dtp1,84,53375,44835,8540,emr,mic_nongavi
lbn,Lebanon,2007,dtp3,80,53375,42700,10675,emr,mic_nongavi
lbn,Lebanon,2007,mcv1,74,53375,39498,13877,emr,mic_nongavi
lbn,Lebanon,2007,mcv2,55,61510,33830,27680,emr,mic_nongavi
lbn,Lebanon,2008,dtp3,81,55289,44784,10505,emr,mic_nongavi
lbn,Lebanon,2008,dtp1,84,55289,46443,8846,emr,mic_nongavi
lbn,Lebanon,2008,mcv1,79,55289,43678,11611,emr,mic_nongavi
lbn,Lebanon,2008,mcv2,65,54022,35114,18908,emr,mic_nongavi
lbn,Lebanon,2009,dtp3,81,58361,47272,11089,emr,mic_nongavi
lbn,Lebanon,2009,dtp1,84,58361,49023,9338,emr,mic_nongavi
lbn,Lebanon,2009,mcv1,79,58361,46105,12256,emr,mic_nongavi
lbn,Lebanon,2009,mcv2,75,52356,39267,13089,emr,mic_nongavi
lbn,Lebanon,2010,dtp1,84,62432,52443,9989,emr,mic_nongavi
lbn,Lebanon,2010,mcv1,79,62432,49321,13111,emr,mic_nongavi
lbn,Lebanon,2010,dtp3,81,62432,50570,11862,emr,mic_nongavi
lbn,Lebanon,2010,mcv2,75,54497,40873,13624,emr,mic_nongavi
lbn,Lebanon,2011,mcv1,79,67221,53105,14116,emr,mic_nongavi
lbn,Lebanon,2011,dtp1,84,67221,56466,10755,emr,mic_nongavi
lbn,Lebanon,2011,dtp3,81,67221,54449,12772,emr,mic_nongavi
lbn,Lebanon,2011,mcv2,75,58186,43640,14546,emr,mic_nongavi
lbn,Lebanon,2012,dtp3,81,72269,58538,13731,emr,mic_nongavi
lbn,Lebanon,2012,mcv1,79,72269,57093,15176,emr,mic_nongavi
lbn,Lebanon,2012,dtp1,84,72269,60706,11563,emr,mic_nongavi
lbn,Lebanon,2012,mcv2,75,63607,47705,15902,emr,mic_nongavi
lbn,Lebanon,2013,dtp3,81,77134,62479,14655,emr,mic_nongavi
lbn,Lebanon,2013,mcv1,79,77134,60936,16198,emr,mic_nongavi
lbn,Lebanon,2013,dtp1,84,77134,64793,12341,emr,mic_nongavi
lbn,Lebanon,2013,mcv2,75,77318,57988,19330,emr,mic_nongavi
lbn,Lebanon,2014,dtp3,81,81516,66028,15488,emr,mic_nongavi
lbn,Lebanon,2014,dtp1,84,81516,68473,13043,emr,mic_nongavi
lbn,Lebanon,2014,mcv1,79,81516,64398,17118,emr,mic_nongavi
lbn,Lebanon,2014,mcv2,75,85822,64366,21456,emr,mic_nongavi
lbn,Lebanon,2015,dtp1,84,85156,71531,13625,emr,mic_nongavi
lbn,Lebanon,2015,dtp3,81,85156,68976,16180,emr,mic_nongavi
lbn,Lebanon,2015,mcv1,79,85156,67273,17883,emr,mic_nongavi
lbn,Lebanon,2015,mcv2,75,90721,68041,22680,emr,mic_nongavi
lbn,Lebanon,2016,dtp3,81,87903,71201,16702,emr,mic_nongavi
lbn,Lebanon,2016,dtp1,84,87903,73839,14064,emr,mic_nongavi
lbn,Lebanon,2016,mcv1,79,87903,69443,18460,emr,mic_nongavi
lbn,Lebanon,2016,mcv2,75,95899,71924,23975,emr,mic_nongavi
lbr,Liberia,2000,dtp3,46,104915,48261,56654,afr,gavi
lbr,Liberia,2000,dtp1,80,104915,83932,20983,afr,gavi
lbr,Liberia,2000,mcv1,63,104915,66096,38819,afr,gavi
lbr,Liberia,2001,dtp1,76,109143,82949,26194,afr,gavi
lbr,Liberia,2001,mcv1,58,109143,63303,45840,afr,gavi
lbr,Liberia,2001,dtp3,42,109143,45840,63303,afr,gavi
lbr,Liberia,2002,mcv1,52,113093,58808,54285,afr,gavi
lbr,Liberia,2002,dtp1,73,113093,82558,30535,afr,gavi
lbr,Liberia,2002,dtp3,39,113093,44106,68987,afr,gavi
lbr,Liberia,2003,dtp3,35,116741,40859,75882,afr,gavi
lbr,Liberia,2003,dtp1,69,116741,80551,36190,afr,gavi
lbr,Liberia,2003,mcv1,47,116741,54868,61873,afr,gavi
lbr,Liberia,2004,dtp1,65,120051,78033,42018,afr,gavi
lbr,Liberia,2004,dtp3,31,120051,37216,82835,afr,gavi
lbr,Liberia,2004,mcv1,41,120051,49221,70830,afr,gavi
lbr,Liberia,2005,dtp1,75,123037,92278,30759,afr,gavi
lbr,Liberia,2005,dtp3,60,123037,73822,49215,afr,gavi
lbr,Liberia,2005,mcv1,62,123037,76283,46754,afr,gavi
lbr,Liberia,2006,dtp3,60,125760,75456,50304,afr,gavi
lbr,Liberia,2006,dtp1,75,125760,94320,31440,afr,gavi
lbr,Liberia,2006,mcv1,63,125760,79229,46531,afr,gavi
lbr,Liberia,2007,dtp3,65,128344,83424,44920,afr,gavi
lbr,Liberia,2007,mcv1,71,128344,91124,37220,afr,gavi
lbr,Liberia,2007,dtp1,80,128344,102675,25669,afr,gavi
lbr,Liberia,2008,mcv1,76,130888,99475,31413,afr,gavi
lbr,Liberia,2008,dtp1,85,130888,111255,19633,afr,gavi
lbr,Liberia,2008,dtp3,75,130888,98166,32722,afr,gavi
lbr,Liberia,2009,dtp1,90,133435,120092,13343,afr,gavi
lbr,Liberia,2009,mcv1,83,133435,110751,22684,afr,gavi
lbr,Liberia,2009,dtp3,81,133435,108082,25353,afr,gavi
lbr,Liberia,2010,dtp3,70,136001,95201,40800,afr,gavi
lbr,Liberia,2010,dtp1,80,136001,108801,27200,afr,gavi
lbr,Liberia,2010,mcv1,65,136001,88401,47600,afr,gavi
lbr,Liberia,2011,dtp1,86,138574,119174,19400,afr,gavi
lbr,Liberia,2011,dtp3,77,138574,106702,31872,afr,gavi
lbr,Liberia,2011,mcv1,71,138574,98388,40186,afr,gavi
lbr,Liberia,2012,dtp1,92,141117,129828,11289,afr,gavi
lbr,Liberia,2012,dtp3,80,141117,112894,28223,afr,gavi
lbr,Liberia,2012,mcv1,80,141117,112894,28223,afr,gavi
lbr,Liberia,2013,dtp3,76,143613,109146,34467,afr,gavi
lbr,Liberia,2013,mcv1,74,143613,106274,37339,afr,gavi
lbr,Liberia,2013,dtp1,97,143613,139305,4308,afr,gavi
lbr,Liberia,2014,dtp3,50,146070,73035,73035,afr,gavi
lbr,Liberia,2014,dtp1,74,146070,108092,37978,afr,gavi
lbr,Liberia,2014,mcv1,58,146070,84721,61349,afr,gavi
lbr,Liberia,2015,dtp3,52,148506,77223,71283,afr,gavi
lbr,Liberia,2015,mcv1,64,148506,95044,53462,afr,gavi
lbr,Liberia,2015,dtp1,77,148506,114350,34156,afr,gavi
lbr,Liberia,2016,dtp1,99,150946,149437,1509,afr,gavi
lbr,Liberia,2016,dtp3,79,150946,119247,31699,afr,gavi
lbr,Liberia,2016,mcv1,80,150946,120757,30189,afr,gavi
lby,Libya,2000,mcv1,93,113161,105240,7921,emr,mic_nongavi
lby,Libya,2000,dtp3,94,113161,106371,6790,emr,mic_nongavi
lby,Libya,2000,dtp1,97,113161,109766,3395,emr,mic_nongavi
lby,Libya,2001,dtp3,94,113630,106812,6818,emr,mic_nongavi
lby,Libya,2001,dtp1,96,113630,109085,4545,emr,mic_nongavi
lby,Libya,2001,mcv1,93,113630,105676,7954,emr,mic_nongavi
lby,Libya,2001,mcv2,81,113207,91698,21509,emr,mic_nongavi
lby,Libya,2002,dtp1,97,114523,111087,3436,emr,mic_nongavi
lby,Libya,2002,dtp3,93,114523,106506,8017,emr,mic_nongavi
lby,Libya,2002,mcv1,91,114523,104216,10307,emr,mic_nongavi
lby,Libya,2002,mcv2,86,113615,97709,15906,emr,mic_nongavi
lby,Libya,2003,dtp3,95,115780,109991,5789,emr,mic_nongavi
lby,Libya,2003,dtp1,99,115780,114622,1158,emr,mic_nongavi
lby,Libya,2003,mcv1,96,115780,111149,4631,emr,mic_nongavi
lby,Libya,2003,mcv2,90,112601,101341,11260,emr,mic_nongavi
lby,Libya,2004,dtp1,99,117330,116157,1173,emr,mic_nongavi
lby,Libya,2004,dtp3,97,117330,113810,3520,emr,mic_nongavi
lby,Libya,2004,mcv1,99,117330,116157,1173,emr,mic_nongavi
lby,Libya,2004,mcv2,95,113302,107637,5665,emr,mic_nongavi
lby,Libya,2005,dtp3,98,119104,116722,2382,emr,mic_nongavi
lby,Libya,2005,dtp1,98,119104,116722,2382,emr,mic_nongavi
lby,Libya,2005,mcv1,97,119104,115531,3573,emr,mic_nongavi
lby,Libya,2005,mcv2,95,114325,108609,5716,emr,mic_nongavi
lby,Libya,2006,dtp3,98,121038,118617,2421,emr,mic_nongavi
lby,Libya,2006,dtp1,98,121038,118617,2421,emr,mic_nongavi
lby,Libya,2006,mcv1,98,121038,118617,2421,emr,mic_nongavi
lby,Libya,2006,mcv2,96,116022,111381,4641,emr,mic_nongavi
lby,Libya,2007,dtp3,98,123015,120555,2460,emr,mic_nongavi
lby,Libya,2007,mcv1,98,123015,120555,2460,emr,mic_nongavi
lby,Libya,2007,dtp1,98,123015,120555,2460,emr,mic_nongavi
lby,Libya,2007,mcv2,97,117986,114446,3540,emr,mic_nongavi
lby,Libya,2008,mcv1,98,124889,122391,2498,emr,mic_nongavi
lby,Libya,2008,dtp3,98,124889,122391,2498,emr,mic_nongavi
lby,Libya,2008,dtp1,98,124889,122391,2498,emr,mic_nongavi
lby,Libya,2008,mcv2,97,120264,116656,3608,emr,mic_nongavi
lby,Libya,2009,dtp3,98,126519,123989,2530,emr,mic_nongavi
lby,Libya,2009,mcv1,98,126519,123989,2530,emr,mic_nongavi
lby,Libya,2009,dtp1,98,126519,123989,2530,emr,mic_nongavi
lby,Libya,2009,mcv2,97,121974,118315,3659,emr,mic_nongavi
lby,Libya,2010,dtp3,98,127712,125158,2554,emr,mic_nongavi
lby,Libya,2010,dtp1,98,127712,125158,2554,emr,mic_nongavi
lby,Libya,2010,mcv1,98,127712,125158,2554,emr,mic_nongavi
lby,Libya,2010,mcv2,97,123057,119365,3692,emr,mic_nongavi
lby,Libya,2011,dtp1,99,128300,127017,1283,emr,mic_nongavi
lby,Libya,2011,dtp3,98,128300,125734,2566,emr,mic_nongavi
lby,Libya,2011,mcv1,98,128300,125734,2566,emr,mic_nongavi
lby,Libya,2011,mcv2,97,125218,121461,3757,emr,mic_nongavi
lby,Libya,2012,mcv1,98,128243,125678,2565,emr,mic_nongavi
lby,Libya,2012,dtp3,98,128243,125678,2565,emr,mic_nongavi
lby,Libya,2012,dtp1,99,128243,126961,1282,emr,mic_nongavi
lby,Libya,2012,mcv2,97,126673,122873,3800,emr,mic_nongavi
lby,Libya,2013,mcv1,96,127557,122455,5102,emr,mic_nongavi
lby,Libya,2013,dtp3,96,127557,122455,5102,emr,mic_nongavi
lby,Libya,2013,dtp1,98,127557,125006,2551,emr,mic_nongavi
lby,Libya,2013,mcv2,95,125757,119469,6288,emr,mic_nongavi
lby,Libya,2014,mcv1,93,126283,117443,8840,emr,mic_nongavi
lby,Libya,2014,dtp3,94,126283,118706,7577,emr,mic_nongavi
lby,Libya,2014,dtp1,96,126283,121232,5051,emr,mic_nongavi
lby,Libya,2014,mcv2,92,125968,115891,10077,emr,mic_nongavi
lby,Libya,2015,mcv1,98,124525,122034,2491,emr,mic_nongavi
lby,Libya,2015,dtp1,98,124525,122034,2491,emr,mic_nongavi
lby,Libya,2015,dtp3,97,124525,120789,3736,emr,mic_nongavi
lby,Libya,2015,mcv2,97,126229,122442,3787,emr,mic_nongavi
lby,Libya,2016,dtp1,98,122441,119992,2449,emr,mic_nongavi
lby,Libya,2016,dtp3,97,122441,118768,3673,emr,mic_nongavi
lby,Libya,2016,mcv1,97,122441,118768,3673,emr,mic_nongavi
lby,Libya,2016,mcv2,96,126178,121131,5047,emr,mic_nongavi
lca,Saint Lucia,2000,mcv1,88,2867,2523,344,amr,mic_nongavi
lca,Saint Lucia,2000,dtp1,76,2867,2179,688,amr,mic_nongavi
lca,Saint Lucia,2000,dtp3,70,2867,2007,860,amr,mic_nongavi
lca,Saint Lucia,2000,mcv2,89,3179,2829,350,amr,mic_nongavi
lca,Saint Lucia,2001,dtp1,99,2730,2703,27,amr,mic_nongavi
lca,Saint Lucia,2001,dtp3,99,2730,2703,27,amr,mic_nongavi
lca,Saint Lucia,2001,mcv1,89,2730,2430,300,amr,mic_nongavi
lca,Saint Lucia,2001,mcv2,73,3078,2247,831,amr,mic_nongavi
lca,Saint Lucia,2002,dtp3,74,2605,1928,677,amr,mic_nongavi
lca,Saint Lucia,2002,dtp1,99,2605,2579,26,amr,mic_nongavi
lca,Saint Lucia,2002,mcv1,98,2605,2553,52,amr,mic_nongavi
lca,Saint Lucia,2002,mcv2,71,2963,2104,859,amr,mic_nongavi
lca,Saint Lucia,2003,dtp1,90,2500,2250,250,amr,mic_nongavi
lca,Saint Lucia,2003,dtp3,90,2500,2250,250,amr,mic_nongavi
lca,Saint Lucia,2003,mcv1,90,2500,2250,250,amr,mic_nongavi
lca,Saint Lucia,2003,mcv2,69,2772,1913,859,amr,mic_nongavi
lca,Saint Lucia,2004,dtp3,91,2415,2198,217,amr,mic_nongavi
lca,Saint Lucia,2004,dtp1,99,2415,2391,24,amr,mic_nongavi
lca,Saint Lucia,2004,mcv1,95,2415,2294,121,amr,mic_nongavi
lca,Saint Lucia,2004,mcv2,67,2637,1767,870,amr,mic_nongavi
lca,Saint Lucia,2005,dtp1,99,2351,2327,24,amr,mic_nongavi
lca,Saint Lucia,2005,dtp3,95,2351,2233,118,amr,mic_nongavi
lca,Saint Lucia,2005,mcv1,94,2351,2210,141,amr,mic_nongavi
lca,Saint Lucia,2005,mcv2,56,2811,1574,1237,amr,mic_nongavi
lca,Saint Lucia,2006,dtp3,85,2308,1962,346,amr,mic_nongavi
lca,Saint Lucia,2006,dtp1,94,2308,2170,138,amr,mic_nongavi
lca,Saint Lucia,2006,mcv1,94,2308,2170,138,amr,mic_nongavi
lca,Saint Lucia,2006,mcv2,45,2819,1269,1550,amr,mic_nongavi
lca,Saint Lucia,2007,dtp3,99,2276,2253,23,amr,mic_nongavi
lca,Saint Lucia,2007,mcv1,94,2276,2139,137,amr,mic_nongavi
lca,Saint Lucia,2007,dtp1,99,2276,2253,23,amr,mic_nongavi
lca,Saint Lucia,2007,mcv2,33,2699,891,1808,amr,mic_nongavi
lca,Saint Lucia,2008,dtp3,96,2252,2162,90,amr,mic_nongavi
lca,Saint Lucia,2008,mcv1,99,2252,2229,23,amr,mic_nongavi
lca,Saint Lucia,2008,dtp1,99,2252,2229,23,amr,mic_nongavi
lca,Saint Lucia,2008,mcv2,22,2582,568,2014,amr,mic_nongavi
lca,Saint Lucia,2009,mcv1,99,2232,2210,22,amr,mic_nongavi
lca,Saint Lucia,2009,dtp1,99,2232,2210,22,amr,mic_nongavi
lca,Saint Lucia,2009,dtp3,95,2232,2120,112,amr,mic_nongavi
lca,Saint Lucia,2009,mcv2,63,2361,1487,874,amr,mic_nongavi
lca,Saint Lucia,2010,dtp3,97,2214,2148,66,amr,mic_nongavi
lca,Saint Lucia,2010,mcv1,95,2214,2103,111,amr,mic_nongavi
lca,Saint Lucia,2010,dtp1,98,2214,2170,44,amr,mic_nongavi
lca,Saint Lucia,2010,mcv2,74,2314,1712,602,amr,mic_nongavi
lca,Saint Lucia,2011,dtp1,99,2198,2176,22,amr,mic_nongavi
lca,Saint Lucia,2011,mcv1,91,2198,2000,198,amr,mic_nongavi
lca,Saint Lucia,2011,dtp3,99,2198,2176,22,amr,mic_nongavi
lca,Saint Lucia,2011,mcv2,72,2246,1617,629,amr,mic_nongavi
lca,Saint Lucia,2012,mcv1,99,2184,2162,22,amr,mic_nongavi
lca,Saint Lucia,2012,dtp3,98,2184,2140,44,amr,mic_nongavi
lca,Saint Lucia,2012,dtp1,99,2184,2162,22,amr,mic_nongavi
lca,Saint Lucia,2012,mcv2,80,2186,1749,437,amr,mic_nongavi
lca,Saint Lucia,2013,dtp3,99,2172,2150,22,amr,mic_nongavi
lca,Saint Lucia,2013,mcv1,99,2172,2150,22,amr,mic_nongavi
lca,Saint Lucia,2013,dtp1,99,2172,2150,22,amr,mic_nongavi
lca,Saint Lucia,2013,mcv2,62,2136,1324,812,amr,mic_nongavi
lca,Saint Lucia,2014,dtp3,99,2160,2138,22,amr,mic_nongavi
lca,Saint Lucia,2014,mcv1,99,2160,2138,22,amr,mic_nongavi
lca,Saint Lucia,2014,dtp1,99,2160,2138,22,amr,mic_nongavi
lca,Saint Lucia,2014,mcv2,79,2096,1656,440,amr,mic_nongavi
lca,Saint Lucia,2015,dtp3,99,2149,2128,21,amr,mic_nongavi
lca,Saint Lucia,2015,mcv1,97,2149,2085,64,amr,mic_nongavi
lca,Saint Lucia,2015,dtp1,99,2149,2128,21,amr,mic_nongavi
lca,Saint Lucia,2015,mcv2,95,2067,1964,103,amr,mic_nongavi
lca,Saint Lucia,2016,dtp1,95,2137,2030,107,amr,mic_nongavi
lca,Saint Lucia,2016,mcv1,99,2137,2116,21,amr,mic_nongavi
lca,Saint Lucia,2016,dtp3,95,2137,2030,107,amr,mic_nongavi
lca,Saint Lucia,2016,mcv2,88,2089,1838,251,amr,mic_nongavi
lka,Sri Lanka,2000,mcv1,99,342952,339522,3430,sear,gavi
lka,Sri Lanka,2000,dtp3,99,342952,339522,3430,sear,gavi
lka,Sri Lanka,2000,dtp1,99,342952,339522,3430,sear,gavi
lka,Sri Lanka,2001,dtp3,98,346301,339375,6926,sear,gavi
lka,Sri Lanka,2001,mcv1,99,346301,342838,3463,sear,gavi
lka,Sri Lanka,2001,dtp1,99,346301,342838,3463,sear,gavi
lka,Sri Lanka,2001,mcv2,52,326473,169766,156707,sear,gavi
lka,Sri Lanka,2002,dtp3,98,350090,343088,7002,sear,gavi
lka,Sri Lanka,2002,dtp1,99,350090,346589,3501,sear,gavi
lka,Sri Lanka,2002,mcv1,99,350090,346589,3501,sear,gavi
lka,Sri Lanka,2002,mcv2,92,327034,300871,26163,sear,gavi
lka,Sri Lanka,2003,dtp1,99,353913,350374,3539,sear,gavi
lka,Sri Lanka,2003,mcv1,99,353913,350374,3539,sear,gavi
lka,Sri Lanka,2003,dtp3,99,353913,350374,3539,sear,gavi
lka,Sri Lanka,2003,mcv2,90,328836,295952,32884,sear,gavi
lka,Sri Lanka,2004,dtp1,98,357382,350234,7148,sear,gavi
lka,Sri Lanka,2004,mcv1,96,357382,343087,14295,sear,gavi
lka,Sri Lanka,2004,dtp3,97,357382,346661,10721,sear,gavi
lka,Sri Lanka,2004,mcv2,95,334406,317686,16720,sear,gavi
lka,Sri Lanka,2005,mcv1,99,359963,356363,3600,sear,gavi
lka,Sri Lanka,2005,dtp1,99,359963,356363,3600,sear,gavi
lka,Sri Lanka,2005,dtp3,99,359963,356363,3600,sear,gavi
lka,Sri Lanka,2005,mcv2,99,338302,334919,3383,sear,gavi
lka,Sri Lanka,2006,mcv1,99,361143,357532,3611,sear,gavi
lka,Sri Lanka,2006,dtp1,99,361143,357532,3611,sear,gavi
lka,Sri Lanka,2006,dtp3,98,361143,353920,7223,sear,gavi
lka,Sri Lanka,2006,mcv2,98,346311,339385,6926,sear,gavi
lka,Sri Lanka,2007,mcv1,98,360728,353513,7215,sear,gavi
lka,Sri Lanka,2007,dtp3,98,360728,353513,7215,sear,gavi
lka,Sri Lanka,2007,dtp1,99,360728,357121,3607,sear,gavi
lka,Sri Lanka,2007,mcv2,97,354057,343435,10622,sear,gavi
lka,Sri Lanka,2008,dtp3,98,358680,351506,7174,sear,gavi
lka,Sri Lanka,2008,dtp1,99,358680,355093,3587,sear,gavi
lka,Sri Lanka,2008,mcv1,98,358680,351506,7174,sear,gavi
lka,Sri Lanka,2008,mcv2,97,359969,349170,10799,sear,gavi
lka,Sri Lanka,2009,mcv1,97,355056,344404,10652,sear,gavi
lka,Sri Lanka,2009,dtp1,97,355056,344404,10652,sear,gavi
lka,Sri Lanka,2009,dtp3,97,355056,344404,10652,sear,gavi
lka,Sri Lanka,2009,mcv2,97,356892,346185,10707,sear,gavi
lka,Sri Lanka,2010,dtp1,99,350098,346597,3501,sear,gavi
lka,Sri Lanka,2010,mcv1,99,350098,346597,3501,sear,gavi
lka,Sri Lanka,2010,dtp3,99,350098,346597,3501,sear,gavi
lka,Sri Lanka,2010,mcv2,99,358422,354838,3584,sear,gavi
lka,Sri Lanka,2011,mcv1,99,344210,340768,3442,sear,gavi
lka,Sri Lanka,2011,dtp1,99,344210,340768,3442,sear,gavi
lka,Sri Lanka,2011,dtp3,99,344210,340768,3442,sear,gavi
lka,Sri Lanka,2011,mcv2,99,356406,352842,3564,sear,gavi
lka,Sri Lanka,2012,dtp1,99,337938,334559,3379,sear,gavi
lka,Sri Lanka,2012,dtp3,99,337938,334559,3379,sear,gavi
lka,Sri Lanka,2012,mcv1,99,337938,334559,3379,sear,gavi
lka,Sri Lanka,2012,mcv2,99,354808,351260,3548,sear,gavi
lka,Sri Lanka,2013,dtp3,99,331756,328438,3318,sear,gavi
lka,Sri Lanka,2013,dtp1,99,331756,328438,3318,sear,gavi
lka,Sri Lanka,2013,mcv1,99,331756,328438,3318,sear,gavi
lka,Sri Lanka,2013,mcv2,99,350731,347224,3507,sear,gavi
lka,Sri Lanka,2014,dtp1,99,325925,322666,3259,sear,gavi
lka,Sri Lanka,2014,dtp3,99,325925,322666,3259,sear,gavi
lka,Sri Lanka,2014,mcv1,99,325925,322666,3259,sear,gavi
lka,Sri Lanka,2014,mcv2,99,344355,340911,3444,sear,gavi
lka,Sri Lanka,2015,dtp3,99,320568,317362,3206,sear,gavi
lka,Sri Lanka,2015,dtp1,99,320568,317362,3206,sear,gavi
lka,Sri Lanka,2015,mcv1,99,320568,317362,3206,sear,gavi
lka,Sri Lanka,2015,mcv2,99,338065,334684,3381,sear,gavi
lka,Sri Lanka,2016,dtp3,99,315642,312486,3156,sear,gavi
lka,Sri Lanka,2016,mcv1,99,315642,312486,3156,sear,gavi
lka,Sri Lanka,2016,dtp1,99,315642,312486,3156,sear,gavi
lka,Sri Lanka,2016,mcv2,99,328866,325577,3289,sear,gavi
lso,Lesotho,2000,mcv1,74,54097,40032,14065,afr,gavi
lso,Lesotho,2000,dtp3,83,54097,44901,9196,afr,gavi
lso,Lesotho,2000,dtp1,87,54097,47064,7033,afr,gavi
lso,Lesotho,2001,dtp3,78,53496,41727,11769,afr,gavi
lso,Lesotho,2001,dtp1,83,53496,44402,9094,afr,gavi
lso,Lesotho,2001,mcv1,70,53496,37447,16049,afr,gavi
lso,Lesotho,2001,mcv2,46,54655,25141,29514,afr,gavi
lso,Lesotho,2002,dtp3,84,52907,44442,8465,afr,gavi
lso,Lesotho,2002,dtp1,89,52907,47087,5820,afr,gavi
lso,Lesotho,2002,mcv1,78,52907,41267,11640,afr,gavi
lso,Lesotho,2002,mcv2,50,54722,27361,27361,afr,gavi
lso,Lesotho,2003,mcv1,85,52417,44554,7863,afr,gavi
lso,Lesotho,2003,dtp3,90,52417,47175,5242,afr,gavi
lso,Lesotho,2003,dtp1,95,52417,49796,2621,afr,gavi
lso,Lesotho,2003,mcv2,47,52854,24841,28013,afr,gavi
lso,Lesotho,2004,dtp3,90,52083,46875,5208,afr,gavi
lso,Lesotho,2004,mcv1,84,52083,43750,8333,afr,gavi
lso,Lesotho,2004,dtp1,95,52083,49479,2604,afr,gavi
lso,Lesotho,2004,mcv2,56,52212,29239,22973,afr,gavi
lso,Lesotho,2005,mcv1,83,51966,43132,8834,afr,gavi
lso,Lesotho,2005,dtp3,89,51966,46250,5716,afr,gavi
lso,Lesotho,2005,dtp1,95,51966,49368,2598,afr,gavi
lso,Lesotho,2005,mcv2,68,51669,35135,16534,afr,gavi
lso,Lesotho,2006,dtp3,89,52104,46373,5731,afr,gavi
lso,Lesotho,2006,dtp1,96,52104,50020,2084,afr,gavi
lso,Lesotho,2006,mcv1,82,52104,42725,9379,afr,gavi
lso,Lesotho,2006,mcv2,80,50506,40405,10101,afr,gavi
lso,Lesotho,2007,dtp1,96,52475,50376,2099,afr,gavi
lso,Lesotho,2007,mcv1,81,52475,42505,9970,afr,gavi
lso,Lesotho,2007,dtp3,88,52475,46178,6297,afr,gavi
lso,Lesotho,2007,mcv2,80,49501,39601,9900,afr,gavi
lso,Lesotho,2008,dtp1,96,53033,50912,2121,afr,gavi
lso,Lesotho,2008,mcv1,80,53033,42426,10607,afr,gavi
lso,Lesotho,2008,dtp3,88,53033,46669,6364,afr,gavi
lso,Lesotho,2008,mcv2,80,50685,40548,10137,afr,gavi
lso,Lesotho,2009,dtp1,96,53743,51593,2150,afr,gavi
lso,Lesotho,2009,mcv1,84,53743,45144,8599,afr,gavi
lso,Lesotho,2009,dtp3,91,53743,48906,4837,afr,gavi
lso,Lesotho,2009,mcv2,81,50773,41126,9647,afr,gavi
lso,Lesotho,2010,dtp1,97,54551,52914,1637,afr,gavi
lso,Lesotho,2010,mcv1,88,54551,48005,6546,afr,gavi
lso,Lesotho,2010,dtp3,93,54551,50732,3819,afr,gavi
lso,Lesotho,2010,mcv2,81,51179,41455,9724,afr,gavi
lso,Lesotho,2011,mcv1,92,55390,50959,4431,afr,gavi
lso,Lesotho,2011,dtp3,96,55390,53174,2216,afr,gavi
lso,Lesotho,2011,dtp1,97,55390,53728,1662,afr,gavi
lso,Lesotho,2011,mcv2,82,52108,42729,9379,afr,gavi
lso,Lesotho,2012,dtp3,95,56197,53387,2810,afr,gavi
lso,Lesotho,2012,mcv1,91,56197,51139,5058,afr,gavi
lso,Lesotho,2012,dtp1,98,56197,55073,1124,afr,gavi
lso,Lesotho,2012,mcv2,82,53192,43617,9575,afr,gavi
lso,Lesotho,2013,dtp3,93,56912,52928,3984,afr,gavi
lso,Lesotho,2013,mcv1,90,56912,51221,5691,afr,gavi
lso,Lesotho,2013,dtp1,98,56912,55774,1138,afr,gavi
lso,Lesotho,2013,mcv2,82,53671,44010,9661,afr,gavi
lso,Lesotho,2014,dtp3,93,57500,53475,4025,afr,gavi
lso,Lesotho,2014,mcv1,90,57500,51750,5750,afr,gavi
lso,Lesotho,2014,dtp1,98,57500,56350,1150,afr,gavi
lso,Lesotho,2014,mcv2,82,54758,44902,9856,afr,gavi
lso,Lesotho,2015,mcv1,90,57936,52142,5794,afr,gavi
lso,Lesotho,2015,dtp3,93,57936,53880,4056,afr,gavi
lso,Lesotho,2015,dtp1,98,57936,56777,1159,afr,gavi
lso,Lesotho,2015,mcv2,82,55745,45711,10034,afr,gavi
lso,Lesotho,2016,dtp3,93,58221,54146,4075,afr,gavi
lso,Lesotho,2016,dtp1,98,58221,57057,1164,afr,gavi
lso,Lesotho,2016,mcv1,90,58221,52399,5822,afr,gavi
lso,Lesotho,2016,mcv2,82,57304,46989,10315,afr,gavi
ltu,Lithuania,2000,mcv1,97,32940,31952,988,eur,hic
ltu,Lithuania,2000,dtp3,94,32940,30964,1976,eur,hic
ltu,Lithuania,2000,dtp1,99,32940,32611,329,eur,hic
ltu,Lithuania,2000,mcv2,97,36515,35420,1095,eur,hic
ltu,Lithuania,2001,dtp3,95,31745,30158,1587,eur,hic
ltu,Lithuania,2001,mcv1,97,31745,30793,952,eur,hic
ltu,Lithuania,2001,dtp1,98,31745,31110,635,eur,hic
ltu,Lithuania,2001,mcv2,96,54777,52586,2191,eur,hic
ltu,Lithuania,2002,dtp3,95,30906,29361,1545,eur,hic
ltu,Lithuania,2002,dtp1,98,30906,30288,618,eur,hic
ltu,Lithuania,2002,mcv1,98,30906,30288,618,eur,hic
ltu,Lithuania,2002,mcv2,95,41111,39055,2056,eur,hic
ltu,Lithuania,2003,dtp3,94,30392,28568,1824,eur,hic
ltu,Lithuania,2003,mcv1,98,30392,29784,608,eur,hic
ltu,Lithuania,2003,dtp1,98,30392,29784,608,eur,hic
ltu,Lithuania,2003,mcv2,93,38335,35652,2683,eur,hic
ltu,Lithuania,2004,dtp1,94,30174,28364,1810,eur,hic
ltu,Lithuania,2004,mcv1,98,30174,29571,603,eur,hic
ltu,Lithuania,2004,dtp3,94,30174,28364,1810,eur,hic
ltu,Lithuania,2004,mcv2,93,35650,33154,2496,eur,hic
ltu,Lithuania,2005,mcv1,97,30199,29293,906,eur,hic
ltu,Lithuania,2005,dtp1,98,30199,29595,604,eur,hic
ltu,Lithuania,2005,dtp3,94,30199,28387,1812,eur,hic
ltu,Lithuania,2005,mcv2,95,33237,31575,1662,eur,hic
ltu,Lithuania,2006,dtp1,98,30400,29792,608,eur,hic
ltu,Lithuania,2006,dtp3,94,30400,28576,1824,eur,hic
ltu,Lithuania,2006,mcv1,97,30400,29488,912,eur,hic
ltu,Lithuania,2006,mcv2,94,31347,29466,1881,eur,hic
ltu,Lithuania,2007,mcv1,97,30691,29770,921,eur,hic
ltu,Lithuania,2007,dtp1,99,30691,30384,307,eur,hic
ltu,Lithuania,2007,dtp3,95,30691,29156,1535,eur,hic
ltu,Lithuania,2007,mcv2,96,29907,28711,1196,eur,hic
ltu,Lithuania,2008,mcv1,97,30992,30062,930,eur,hic
ltu,Lithuania,2008,dtp1,96,30992,29752,1240,eur,hic
ltu,Lithuania,2008,dtp3,96,30992,29752,1240,eur,hic
ltu,Lithuania,2008,mcv2,96,28821,27668,1153,eur,hic
ltu,Lithuania,2009,dtp3,98,31246,30621,625,eur,hic
ltu,Lithuania,2009,mcv1,96,31246,29996,1250,eur,hic
ltu,Lithuania,2009,dtp1,98,31246,30621,625,eur,hic
ltu,Lithuania,2009,mcv2,94,28008,26328,1680,eur,hic
ltu,Lithuania,2010,mcv1,96,31408,30152,1256,eur,hic
ltu,Lithuania,2010,dtp1,98,31408,30780,628,eur,hic
ltu,Lithuania,2010,dtp3,95,31408,29838,1570,eur,hic
ltu,Lithuania,2010,mcv2,95,27314,25948,1366,eur,hic
ltu,Lithuania,2011,dtp1,95,31463,29890,1573,eur,hic
ltu,Lithuania,2011,mcv1,94,31463,29575,1888,eur,hic
ltu,Lithuania,2011,dtp3,92,31463,28946,2517,eur,hic
ltu,Lithuania,2011,mcv2,94,27020,25399,1621,eur,hic
ltu,Lithuania,2012,dtp3,93,31433,29233,2200,eur,hic
ltu,Lithuania,2012,mcv1,93,31433,29233,2200,eur,hic
ltu,Lithuania,2012,dtp1,97,31433,30490,943,eur,hic
ltu,Lithuania,2012,mcv2,93,26908,25024,1884,eur,hic
ltu,Lithuania,2013,dtp3,93,31349,29155,2194,eur,hic
ltu,Lithuania,2013,mcv1,93,31349,29155,2194,eur,hic
ltu,Lithuania,2013,dtp1,97,31349,30409,940,eur,hic
ltu,Lithuania,2013,mcv2,92,27030,24868,2162,eur,hic
ltu,Lithuania,2014,mcv1,93,31212,29027,2185,eur,hic
ltu,Lithuania,2014,dtp1,97,31212,30276,936,eur,hic
ltu,Lithuania,2014,dtp3,93,31212,29027,2185,eur,hic
ltu,Lithuania,2014,mcv2,92,27330,25144,2186,eur,hic
ltu,Lithuania,2015,dtp1,97,31047,30116,931,eur,hic
ltu,Lithuania,2015,mcv1,94,31047,29184,1863,eur,hic
ltu,Lithuania,2015,dtp3,93,31047,28874,2173,eur,hic
ltu,Lithuania,2015,mcv2,92,27672,25458,2214,eur,hic
ltu,Lithuania,2016,mcv1,94,30878,29025,1853,eur,hic
ltu,Lithuania,2016,dtp1,97,30878,29952,926,eur,hic
ltu,Lithuania,2016,dtp3,94,30878,29025,1853,eur,hic
ltu,Lithuania,2016,mcv2,92,28074,25828,2246,eur,hic
lux,Luxembourg,2000,mcv1,93,5378,5002,376,eur,hic
lux,Luxembourg,2000,dtp1,99,5378,5324,54,eur,hic
lux,Luxembourg,2000,dtp3,99,5378,5324,54,eur,hic
lux,Luxembourg,2001,dtp1,99,5337,5284,53,eur,hic
lux,Luxembourg,2001,mcv1,94,5337,5017,320,eur,hic
lux,Luxembourg,2001,dtp3,99,5337,5284,53,eur,hic
lux,Luxembourg,2002,mcv1,94,5303,4985,318,eur,hic
lux,Luxembourg,2002,dtp1,99,5303,5250,53,eur,hic
lux,Luxembourg,2002,dtp3,99,5303,5250,53,eur,hic
lux,Luxembourg,2003,mcv1,95,5287,5023,264,eur,hic
lux,Luxembourg,2003,dtp3,98,5287,5181,106,eur,hic
lux,Luxembourg,2003,dtp1,99,5287,5234,53,eur,hic
lux,Luxembourg,2004,dtp1,99,5292,5239,53,eur,hic
lux,Luxembourg,2004,dtp3,99,5292,5239,53,eur,hic
lux,Luxembourg,2004,mcv1,95,5292,5027,265,eur,hic
lux,Luxembourg,2005,mcv1,95,5320,5054,266,eur,hic
lux,Luxembourg,2005,dtp3,99,5320,5267,53,eur,hic
lux,Luxembourg,2005,dtp1,99,5320,5267,53,eur,hic
lux,Luxembourg,2006,dtp3,99,5371,5317,54,eur,hic
lux,Luxembourg,2006,mcv1,95,5371,5102,269,eur,hic
lux,Luxembourg,2006,dtp1,99,5371,5317,54,eur,hic
lux,Luxembourg,2007,dtp3,99,5438,5384,54,eur,hic
lux,Luxembourg,2007,dtp1,99,5438,5384,54,eur,hic
lux,Luxembourg,2007,mcv1,96,5438,5220,218,eur,hic
lux,Luxembourg,2008,dtp1,99,5515,5460,55,eur,hic
lux,Luxembourg,2008,mcv1,96,5515,5294,221,eur,hic
lux,Luxembourg,2008,dtp3,99,5515,5460,55,eur,hic
lux,Luxembourg,2009,dtp3,99,5601,5545,56,eur,hic
lux,Luxembourg,2009,mcv1,96,5601,5377,224,eur,hic
lux,Luxembourg,2009,dtp1,99,5601,5545,56,eur,hic
lux,Luxembourg,2010,dtp1,99,5697,5640,57,eur,hic
lux,Luxembourg,2010,dtp3,99,5697,5640,57,eur,hic
lux,Luxembourg,2010,mcv1,96,5697,5469,228,eur,hic
lux,Luxembourg,2011,dtp3,99,5806,5748,58,eur,hic
lux,Luxembourg,2011,mcv1,96,5806,5574,232,eur,hic
lux,Luxembourg,2011,dtp1,99,5806,5748,58,eur,hic
lux,Luxembourg,2012,mcv1,99,5926,5867,59,eur,hic
lux,Luxembourg,2012,dtp3,99,5926,5867,59,eur,hic
lux,Luxembourg,2012,dtp1,99,5926,5867,59,eur,hic
lux,Luxembourg,2013,mcv1,99,6057,5996,61,eur,hic
lux,Luxembourg,2013,dtp3,99,6057,5996,61,eur,hic
lux,Luxembourg,2013,dtp1,99,6057,5996,61,eur,hic
lux,Luxembourg,2013,mcv2,86,6044,5198,846,eur,hic
lux,Luxembourg,2014,dtp1,99,6197,6135,62,eur,hic
lux,Luxembourg,2014,dtp3,99,6197,6135,62,eur,hic
lux,Luxembourg,2014,mcv1,99,6197,6135,62,eur,hic
lux,Luxembourg,2014,mcv2,86,6148,5287,861,eur,hic
lux,Luxembourg,2015,dtp1,99,6336,6273,63,eur,hic
lux,Luxembourg,2015,dtp3,99,6336,6273,63,eur,hic
lux,Luxembourg,2015,mcv1,99,6336,6273,63,eur,hic
lux,Luxembourg,2015,mcv2,86,6253,5378,875,eur,hic
lux,Luxembourg,2016,dtp1,99,6473,6408,65,eur,hic
lux,Luxembourg,2016,dtp3,99,6473,6408,65,eur,hic
lux,Luxembourg,2016,mcv1,99,6473,6408,65,eur,hic
lux,Luxembourg,2016,mcv2,86,6454,5550,904,eur,hic
lva,Latvia,2000,dtp3,96,19068,18305,763,eur,hic
lva,Latvia,2000,dtp1,99,19068,18877,191,eur,hic
lva,Latvia,2000,mcv1,97,19068,18496,572,eur,hic
lva,Latvia,2000,mcv2,90,28493,25644,2849,eur,hic
lva,Latvia,2001,dtp1,99,19428,19234,194,eur,hic
lva,Latvia,2001,dtp3,97,19428,18845,583,eur,hic
lva,Latvia,2001,mcv1,98,19428,19039,389,eur,hic
lva,Latvia,2001,mcv2,95,26124,24818,1306,eur,hic
lva,Latvia,2002,dtp3,97,19997,19397,600,eur,hic
lva,Latvia,2002,mcv1,98,19997,19597,400,eur,hic
lva,Latvia,2002,dtp1,99,19997,19797,200,eur,hic
lva,Latvia,2002,mcv2,96,23766,22815,951,eur,hic
lva,Latvia,2003,dtp1,98,20651,20238,413,eur,hic
lva,Latvia,2003,dtp3,98,20651,20238,413,eur,hic
lva,Latvia,2003,mcv1,98,20651,20238,413,eur,hic
lva,Latvia,2003,mcv2,97,21540,20894,646,eur,hic
lva,Latvia,2004,dtp1,99,21296,21083,213,eur,hic
lva,Latvia,2004,mcv1,98,21296,20870,426,eur,hic
lva,Latvia,2004,dtp3,99,21296,21083,213,eur,hic
lva,Latvia,2004,mcv2,98,19561,19170,391,eur,hic
lva,Latvia,2005,dtp1,99,21837,21619,218,eur,hic
lva,Latvia,2005,dtp3,99,21837,21619,218,eur,hic
lva,Latvia,2005,mcv1,98,21837,21400,437,eur,hic
lva,Latvia,2005,mcv2,99,17936,17757,179,eur,hic
lva,Latvia,2006,dtp1,98,22208,21764,444,eur,hic
lva,Latvia,2006,dtp3,96,22208,21320,888,eur,hic
lva,Latvia,2006,mcv1,98,22208,21764,444,eur,hic
lva,Latvia,2006,mcv2,99,16817,16649,168,eur,hic
lva,Latvia,2007,dtp1,98,22404,21956,448,eur,hic
lva,Latvia,2007,dtp3,94,22404,21060,1344,eur,hic
lva,Latvia,2007,mcv1,95,22404,21284,1120,eur,hic
lva,Latvia,2007,mcv2,98,16760,16425,335,eur,hic
lva,Latvia,2008,dtp1,94,22432,21086,1346,eur,hic
lva,Latvia,2008,dtp3,94,22432,21086,1346,eur,hic
lva,Latvia,2008,mcv1,96,22432,21535,897,eur,hic
lva,Latvia,2008,mcv2,94,17415,16370,1045,eur,hic
lva,Latvia,2009,dtp1,98,22288,21842,446,eur,hic
lva,Latvia,2009,dtp3,94,22288,20951,1337,eur,hic
lva,Latvia,2009,mcv1,92,22288,20505,1783,eur,hic
lva,Latvia,2009,mcv2,92,18443,16968,1475,eur,hic
lva,Latvia,2010,mcv1,95,21997,20897,1100,eur,hic
lva,Latvia,2010,dtp3,92,21997,20237,1760,eur,hic
lva,Latvia,2010,dtp1,99,21997,21777,220,eur,hic
lva,Latvia,2010,mcv2,93,19529,18162,1367,eur,hic
lva,Latvia,2011,mcv1,92,21603,19875,1728,eur,hic
lva,Latvia,2011,dtp1,95,21603,20523,1080,eur,hic
lva,Latvia,2011,dtp3,92,21603,19875,1728,eur,hic
lva,Latvia,2011,mcv2,92,20209,18592,1617,eur,hic
lva,Latvia,2012,mcv1,90,21171,19054,2117,eur,hic
lva,Latvia,2012,dtp3,91,21171,19266,1905,eur,hic
lva,Latvia,2012,dtp1,92,21171,19477,1694,eur,hic
lva,Latvia,2012,mcv2,92,20740,19081,1659,eur,hic
lva,Latvia,2013,dtp3,94,20752,19507,1245,eur,hic
lva,Latvia,2013,dtp1,96,20752,19922,830,eur,hic
lva,Latvia,2013,mcv1,96,20752,19922,830,eur,hic
lva,Latvia,2013,mcv2,92,21121,19431,1690,eur,hic
lva,Latvia,2014,dtp1,93,20371,18945,1426,eur,hic
lva,Latvia,2014,mcv1,95,20371,19352,1019,eur,hic
lva,Latvia,2014,dtp3,92,20371,18741,1630,eur,hic
lva,Latvia,2014,mcv2,89,21368,19018,2350,eur,hic
lva,Latvia,2015,dtp3,95,20034,19032,1002,eur,hic
lva,Latvia,2015,dtp1,98,20034,19633,401,eur,hic
lva,Latvia,2015,mcv1,96,20034,19233,801,eur,hic
lva,Latvia,2015,mcv2,92,21509,19788,1721,eur,hic
lva,Latvia,2016,dtp1,99,19734,19537,197,eur,hic
lva,Latvia,2016,mcv1,93,19734,18353,1381,eur,hic
lva,Latvia,2016,dtp3,98,19734,19339,395,eur,hic
lva,Latvia,2016,mcv2,89,21725,19335,2390,eur,hic
mar,Morocco,2000,dtp1,98,615973,603654,12319,emr,mic_nongavi
mar,Morocco,2000,dtp3,95,615973,585174,30799,emr,mic_nongavi
mar,Morocco,2000,mcv1,93,615973,572855,43118,emr,mic_nongavi
mar,Morocco,2001,dtp3,96,616612,591948,24664,emr,mic_nongavi
mar,Morocco,2001,dtp1,97,616612,598114,18498,emr,mic_nongavi
mar,Morocco,2001,mcv1,96,616612,591948,24664,emr,mic_nongavi
mar,Morocco,2002,mcv1,94,618490,581381,37109,emr,mic_nongavi
mar,Morocco,2002,dtp1,98,618490,606120,12370,emr,mic_nongavi
mar,Morocco,2002,dtp3,94,618490,581381,37109,emr,mic_nongavi
mar,Morocco,2003,dtp3,91,621038,565145,55893,emr,mic_nongavi
mar,Morocco,2003,dtp1,94,621038,583776,37262,emr,mic_nongavi
mar,Morocco,2003,mcv1,90,621038,558934,62104,emr,mic_nongavi
mar,Morocco,2004,dtp3,97,624122,605398,18724,emr,mic_nongavi
mar,Morocco,2004,dtp1,99,624122,617881,6241,emr,mic_nongavi
mar,Morocco,2004,mcv1,95,624122,592916,31206,emr,mic_nongavi
mar,Morocco,2004,mcv2,91,606822,552208,54614,emr,mic_nongavi
mar,Morocco,2005,mcv1,97,628117,609273,18844,emr,mic_nongavi
mar,Morocco,2005,dtp1,99,628117,621836,6281,emr,mic_nongavi
mar,Morocco,2005,dtp3,98,628117,615555,12562,emr,mic_nongavi
mar,Morocco,2005,mcv2,92,597193,549418,47775,emr,mic_nongavi
mar,Morocco,2006,dtp1,99,633670,627333,6337,emr,mic_nongavi
mar,Morocco,2006,mcv1,95,633670,601986,31684,emr,mic_nongavi
mar,Morocco,2006,dtp3,97,633670,614660,19010,emr,mic_nongavi
mar,Morocco,2006,mcv2,92,593427,545953,47474,emr,mic_nongavi
mar,Morocco,2007,dtp3,95,641111,609055,32056,emr,mic_nongavi
mar,Morocco,2007,mcv1,95,641111,609055,32056,emr,mic_nongavi
mar,Morocco,2007,dtp1,98,641111,628289,12822,emr,mic_nongavi
mar,Morocco,2007,mcv2,92,595524,547882,47642,emr,mic_nongavi
mar,Morocco,2008,dtp1,99,650325,643822,6503,emr,mic_nongavi
mar,Morocco,2008,dtp3,99,650325,643822,6503,emr,mic_nongavi
mar,Morocco,2008,mcv1,96,650325,624312,26013,emr,mic_nongavi
mar,Morocco,2009,dtp1,99,660742,654135,6607,emr,mic_nongavi
mar,Morocco,2009,mcv1,98,660742,647527,13215,emr,mic_nongavi
mar,Morocco,2009,dtp3,99,660742,654135,6607,emr,mic_nongavi
mar,Morocco,2010,dtp1,99,671299,664586,6713,emr,mic_nongavi
mar,Morocco,2010,dtp3,99,671299,664586,6713,emr,mic_nongavi
mar,Morocco,2010,mcv1,98,671299,657873,13426,emr,mic_nongavi
mar,Morocco,2011,dtp1,99,680712,673905,6807,emr,mic_nongavi
mar,Morocco,2011,dtp3,99,680712,673905,6807,emr,mic_nongavi
mar,Morocco,2011,mcv1,99,680712,673905,6807,emr,mic_nongavi
mar,Morocco,2012,dtp3,99,687909,681030,6879,emr,mic_nongavi
mar,Morocco,2012,mcv1,99,687909,681030,6879,emr,mic_nongavi
mar,Morocco,2012,dtp1,99,687909,681030,6879,emr,mic_nongavi
mar,Morocco,2013,dtp3,99,692152,685230,6922,emr,mic_nongavi
mar,Morocco,2013,dtp1,99,692152,685230,6922,emr,mic_nongavi
mar,Morocco,2013,mcv1,99,692152,685230,6922,emr,mic_nongavi
mar,Morocco,2014,dtp3,99,693165,686233,6932,emr,mic_nongavi
mar,Morocco,2014,mcv1,99,693165,686233,6932,emr,mic_nongavi
mar,Morocco,2014,dtp1,99,693165,686233,6932,emr,mic_nongavi
mar,Morocco,2014,mcv2,54,681365,367937,313428,emr,mic_nongavi
mar,Morocco,2015,dtp3,99,691047,684137,6910,emr,mic_nongavi
mar,Morocco,2015,dtp1,99,691047,684137,6910,emr,mic_nongavi
mar,Morocco,2015,mcv1,99,691047,684137,6910,emr,mic_nongavi
mar,Morocco,2015,mcv2,95,688818,654377,34441,emr,mic_nongavi
mar,Morocco,2016,dtp3,99,686334,679471,6863,emr,mic_nongavi
mar,Morocco,2016,mcv1,99,686334,679471,6863,emr,mic_nongavi
mar,Morocco,2016,dtp1,99,686334,679471,6863,emr,mic_nongavi
mar,Morocco,2016,mcv2,99,704881,697832,7049,emr,mic_nongavi
mco,Monaco,2000,dtp1,99,405.0718601365,401,4.0718601365,eur,hic
mco,Monaco,2000,mcv1,99,405.0718601365,401,4.0718601365,eur,hic
mco,Monaco,2000,dtp3,99,405.0718601365,401,4.0718601365,eur,hic
mco,Monaco,2001,dtp3,99,409.7699163513,406,3.7699163513,eur,hic
mco,Monaco,2001,dtp1,99,409.7699163513,406,3.7699163513,eur,hic
mco,Monaco,2001,mcv1,99,409.7699163513,406,3.7699163513,eur,hic
mco,Monaco,2002,mcv1,99,414.2902103072,410,4.2902103072,eur,hic
mco,Monaco,2002,dtp1,99,414.2902103072,410,4.2902103072,eur,hic
mco,Monaco,2002,dtp3,99,414.2902103072,410,4.2902103072,eur,hic
mco,Monaco,2003,dtp1,99,419.0839817533,415,4.0839817533,eur,hic
mco,Monaco,2003,dtp3,99,419.0839817533,415,4.0839817533,eur,hic
mco,Monaco,2003,mcv1,99,419.0839817533,415,4.0839817533,eur,hic
mco,Monaco,2004,dtp1,99,424.505361613,420,4.505361613,eur,hic
mco,Monaco,2004,mcv1,99,424.505361613,420,4.505361613,eur,hic
mco,Monaco,2004,dtp3,99,424.505361613,420,4.505361613,eur,hic
mco,Monaco,2005,dtp3,99,430.5876205189,426,4.5876205189,eur,hic
mco,Monaco,2005,mcv1,99,430.5876205189,426,4.5876205189,eur,hic
mco,Monaco,2005,dtp1,99,430.5876205189,426,4.5876205189,eur,hic
mco,Monaco,2006,dtp3,99,437.6069465686,433,4.6069465686,eur,hic
mco,Monaco,2006,dtp1,99,437.6069465686,433,4.6069465686,eur,hic
mco,Monaco,2006,mcv1,99,437.6069465686,433,4.6069465686,eur,hic
mco,Monaco,2007,dtp3,99,444.8716270796,440,4.8716270796,eur,hic
mco,Monaco,2007,mcv1,99,444.8716270796,440,4.8716270796,eur,hic
mco,Monaco,2007,dtp1,99,444.8716270796,440,4.8716270796,eur,hic
mco,Monaco,2008,dtp1,99,451.8049940455,447,4.8049940455,eur,hic
mco,Monaco,2008,dtp3,99,451.8049940455,447,4.8049940455,eur,hic
mco,Monaco,2008,mcv1,99,451.8049940455,447,4.8049940455,eur,hic
mco,Monaco,2009,dtp3,99,457.2174873224,453,4.2174873224,eur,hic
mco,Monaco,2009,mcv1,99,457.2174873224,453,4.2174873224,eur,hic
mco,Monaco,2009,dtp1,99,457.2174873224,453,4.2174873224,eur,hic
mco,Monaco,2010,dtp3,99,460.5117002218,456,4.5117002218,eur,hic
mco,Monaco,2010,mcv1,99,460.5117002218,456,4.5117002218,eur,hic
mco,Monaco,2010,dtp1,99,460.5117002218,456,4.5117002218,eur,hic
mco,Monaco,2011,dtp1,99,461.430044953,457,4.430044953,eur,hic
mco,Monaco,2011,mcv1,99,461.430044953,457,4.430044953,eur,hic
mco,Monaco,2011,dtp3,99,461.430044953,457,4.430044953,eur,hic
mco,Monaco,2012,mcv1,99,460.745996858,456,4.745996858,eur,hic
mco,Monaco,2012,dtp1,99,460.745996858,456,4.745996858,eur,hic
mco,Monaco,2012,dtp3,99,460.745996858,456,4.745996858,eur,hic
mco,Monaco,2013,mcv1,99,458.9057244989,454,4.9057244989,eur,hic
mco,Monaco,2013,dtp1,99,458.9057244989,454,4.9057244989,eur,hic
mco,Monaco,2013,dtp3,99,458.9057244989,454,4.9057244989,eur,hic
mco,Monaco,2014,mcv1,99,456.8789618603,452,4.8789618603,eur,hic
mco,Monaco,2014,dtp1,99,456.8789618603,452,4.8789618603,eur,hic
mco,Monaco,2014,dtp3,99,456.8789618603,452,4.8789618603,eur,hic
mco,Monaco,2015,dtp1,99,455.2510808303,451,4.2510808303,eur,hic
mco,Monaco,2015,mcv1,99,455.2510808303,451,4.2510808303,eur,hic
mco,Monaco,2015,dtp3,99,455.2510808303,451,4.2510808303,eur,hic
mco,Monaco,2016,mcv1,99,454.0875528166,450,4.0875528166,eur,hic
mco,Monaco,2016,dtp1,99,454.0875528166,450,4.0875528166,eur,hic
mco,Monaco,2016,dtp3,99,454.0875528166,450,4.0875528166,eur,hic
mda,Republic of Moldova,2000,dtp1,98,46708,45774,934,eur,gavi
mda,Republic of Moldova,2000,dtp3,95,46708,44373,2335,eur,gavi
mda,Republic of Moldova,2000,mcv1,89,46708,41570,5138,eur,gavi
mda,Republic of Moldova,2001,dtp1,97,44632,43293,1339,eur,gavi
mda,Republic of Moldova,2001,mcv1,94,44632,41954,2678,eur,gavi
mda,Republic of Moldova,2001,dtp3,97,44632,43293,1339,eur,gavi
mda,Republic of Moldova,2002,dtp3,97,43103,41810,1293,eur,gavi
mda,Republic of Moldova,2002,dtp1,99,43103,42672,431,eur,gavi
mda,Republic of Moldova,2002,mcv1,94,43103,40517,2586,eur,gavi
mda,Republic of Moldova,2002,mcv2,69,52905,36504,16401,eur,gavi
mda,Republic of Moldova,2003,mcv1,96,42206,40518,1688,eur,gavi
mda,Republic of Moldova,2003,dtp3,98,42206,41362,844,eur,gavi
mda,Republic of Moldova,2003,dtp1,99,42206,41784,422,eur,gavi
mda,Republic of Moldova,2003,mcv2,96,53221,51092,2129,eur,gavi
mda,Republic of Moldova,2004,dtp3,98,41923,41085,838,eur,gavi
mda,Republic of Moldova,2004,mcv1,96,41923,40246,1677,eur,gavi
mda,Republic of Moldova,2004,dtp1,99,41923,41504,419,eur,gavi
mda,Republic of Moldova,2004,mcv2,98,50341,49334,1007,eur,gavi
mda,Republic of Moldova,2005,dtp1,98,42157,41314,843,eur,gavi
mda,Republic of Moldova,2005,dtp3,98,42157,41314,843,eur,gavi
mda,Republic of Moldova,2005,mcv1,97,42157,40892,1265,eur,gavi
mda,Republic of Moldova,2005,mcv2,98,45190,44286,904,eur,gavi
mda,Republic of Moldova,2006,mcv1,96,42743,41033,1710,eur,gavi
mda,Republic of Moldova,2006,dtp1,97,42743,41461,1282,eur,gavi
mda,Republic of Moldova,2006,dtp3,97,42743,41461,1282,eur,gavi
mda,Republic of Moldova,2006,mcv2,99,45367,44913,454,eur,gavi
mda,Republic of Moldova,2007,mcv1,96,43449,41711,1738,eur,gavi
mda,Republic of Moldova,2007,dtp1,95,43449,41277,2172,eur,gavi
mda,Republic of Moldova,2007,dtp3,92,43449,39973,3476,eur,gavi
mda,Republic of Moldova,2007,mcv2,95,43698,41513,2185,eur,gavi
mda,Republic of Moldova,2008,dtp3,90,44069,39662,4407,eur,gavi
mda,Republic of Moldova,2008,mcv1,95,44069,41866,2203,eur,gavi
mda,Republic of Moldova,2008,dtp1,96,44069,42306,1763,eur,gavi
mda,Republic of Moldova,2008,mcv2,97,42559,41282,1277,eur,gavi
mda,Republic of Moldova,2009,dtp3,85,44487,37814,6673,eur,gavi
mda,Republic of Moldova,2009,mcv1,90,44487,40038,4449,eur,gavi
mda,Republic of Moldova,2009,dtp1,88,44487,39149,5338,eur,gavi
mda,Republic of Moldova,2009,mcv2,98,41877,41039,838,eur,gavi
mda,Republic of Moldova,2010,dtp3,90,44625,40162,4463,eur,gavi
mda,Republic of Moldova,2010,dtp1,93,44625,41501,3124,eur,gavi
mda,Republic of Moldova,2010,mcv1,97,44625,43286,1339,eur,gavi
mda,Republic of Moldova,2010,mcv2,98,41593,40761,832,eur,gavi
mda,Republic of Moldova,2011,mcv1,91,44464,40462,4002,eur,gavi
mda,Republic of Moldova,2011,dtp3,93,44464,41352,3112,eur,gavi
mda,Republic of Moldova,2011,dtp1,96,44464,42685,1779,eur,gavi
mda,Republic of Moldova,2011,mcv2,96,40925,39288,1637,eur,gavi
mda,Republic of Moldova,2012,dtp1,97,44088,42765,1323,eur,gavi
mda,Republic of Moldova,2012,mcv1,91,44088,40120,3968,eur,gavi
mda,Republic of Moldova,2012,dtp3,92,44088,40561,3527,eur,gavi
mda,Republic of Moldova,2012,mcv2,95,40984,38935,2049,eur,gavi
mda,Republic of Moldova,2013,dtp1,96,43566,41823,1743,eur,gavi
mda,Republic of Moldova,2013,dtp3,90,43566,39209,4357,eur,gavi
mda,Republic of Moldova,2013,mcv1,91,43566,39645,3921,eur,gavi
mda,Republic of Moldova,2013,mcv2,94,41535,39043,2492,eur,gavi
mda,Republic of Moldova,2014,dtp3,90,42916,38624,4292,eur,gavi
mda,Republic of Moldova,2014,dtp1,94,42916,40341,2575,eur,gavi
mda,Republic of Moldova,2014,mcv1,90,42916,38624,4292,eur,gavi
mda,Republic of Moldova,2014,mcv2,93,42362,39397,2965,eur,gavi
mda,Republic of Moldova,2015,dtp1,88,42152,37094,5058,eur,gavi
mda,Republic of Moldova,2015,mcv1,89,42152,37515,4637,eur,gavi
mda,Republic of Moldova,2015,dtp3,87,42152,36672,5480,eur,gavi
mda,Republic of Moldova,2015,mcv2,90,43278,38950,4328,eur,gavi
mda,Republic of Moldova,2016,dtp3,89,41293,36751,4542,eur,gavi
mda,Republic of Moldova,2016,mcv1,88,41293,36338,4955,eur,gavi
mda,Republic of Moldova,2016,dtp1,94,41293,38815,2478,eur,gavi
mda,Republic of Moldova,2016,mcv2,95,44144,41937,2207,eur,gavi
mdg,Madagascar,2000,dtp3,57,607611,346338,261273,afr,gavi
mdg,Madagascar,2000,dtp1,74,607611,449632,157979,afr,gavi
mdg,Madagascar,2000,mcv1,57,607611,346338,261273,afr,gavi
mdg,Madagascar,2001,dtp1,75,618704,464028,154676,afr,gavi
mdg,Madagascar,2001,dtp3,60,618704,371222,247482,afr,gavi
mdg,Madagascar,2001,mcv1,59,618704,365035,253669,afr,gavi
mdg,Madagascar,2002,dtp1,76,629354,478309,151045,afr,gavi
mdg,Madagascar,2002,mcv1,61,629354,383906,245448,afr,gavi
mdg,Madagascar,2002,dtp3,62,629354,390199,239155,afr,gavi
mdg,Madagascar,2003,dtp1,79,639872,505499,134373,afr,gavi
mdg,Madagascar,2003,mcv1,65,639872,415917,223955,afr,gavi
mdg,Madagascar,2003,dtp3,66,639872,422316,217556,afr,gavi
mdg,Madagascar,2004,mcv1,79,650421,513833,136588,afr,gavi
mdg,Madagascar,2004,dtp1,82,650421,533345,117076,afr,gavi
mdg,Madagascar,2004,dtp3,78,650421,507328,143093,afr,gavi
mdg,Madagascar,2005,dtp3,85,661052,561894,99158,afr,gavi
mdg,Madagascar,2005,mcv1,74,661052,489178,171874,afr,gavi
mdg,Madagascar,2005,dtp1,88,661052,581726,79326,afr,gavi
mdg,Madagascar,2006,dtp3,85,671719,570961,100758,afr,gavi
mdg,Madagascar,2006,dtp1,93,671719,624699,47020,afr,gavi
mdg,Madagascar,2006,mcv1,71,671719,476920,194799,afr,gavi
mdg,Madagascar,2007,dtp3,84,682373,573193,109180,afr,gavi
mdg,Madagascar,2007,dtp1,92,682373,627783,54590,afr,gavi
mdg,Madagascar,2007,mcv1,81,682373,552722,129651,afr,gavi
mdg,Madagascar,2008,dtp1,84,693053,582165,110888,afr,gavi
mdg,Madagascar,2008,dtp3,77,693053,533651,159402,afr,gavi
mdg,Madagascar,2008,mcv1,70,693053,485137,207916,afr,gavi
mdg,Madagascar,2009,dtp1,80,703913,563130,140783,afr,gavi
mdg,Madagascar,2009,dtp3,77,703913,542013,161900,afr,gavi
mdg,Madagascar,2009,mcv1,63,703913,443465,260448,afr,gavi
mdg,Madagascar,2010,dtp1,78,715220,557872,157348,afr,gavi
mdg,Madagascar,2010,mcv1,66,715220,472045,243175,afr,gavi
mdg,Madagascar,2010,dtp3,70,715220,500654,214566,afr,gavi
mdg,Madagascar,2011,mcv1,62,727265,450904,276361,afr,gavi
mdg,Madagascar,2011,dtp3,73,727265,530903,196362,afr,gavi
mdg,Madagascar,2011,dtp1,80,727265,581812,145453,afr,gavi
mdg,Madagascar,2012,dtp3,70,740212,518148,222064,afr,gavi
mdg,Madagascar,2012,mcv1,61,740212,451529,288683,afr,gavi
mdg,Madagascar,2012,dtp1,80,740212,592170,148042,afr,gavi
mdg,Madagascar,2013,dtp3,74,754125,558052,196073,afr,gavi
mdg,Madagascar,2013,mcv1,63,754125,475099,279026,afr,gavi
mdg,Madagascar,2013,dtp1,80,754125,603300,150825,afr,gavi
mdg,Madagascar,2014,dtp3,73,768979,561355,207624,afr,gavi
mdg,Madagascar,2014,mcv1,64,768979,492147,276832,afr,gavi
mdg,Madagascar,2014,dtp1,83,768979,638253,130726,afr,gavi
mdg,Madagascar,2015,mcv1,58,784680,455114,329566,afr,gavi
mdg,Madagascar,2015,dtp3,69,784680,541429,243251,afr,gavi
mdg,Madagascar,2015,dtp1,79,784680,619897,164783,afr,gavi
mdg,Madagascar,2016,mcv1,58,801052,464610,336442,afr,gavi
mdg,Madagascar,2016,dtp3,77,801052,616810,184242,afr,gavi
mdg,Madagascar,2016,dtp1,84,801052,672884,128168,afr,gavi
mdv,Maldives,2000,dtp1,98,6161,6038,123,sear,mic_nongavi
mdv,Maldives,2000,mcv1,99,6161,6099,62,sear,mic_nongavi
mdv,Maldives,2000,dtp3,98,6161,6038,123,sear,mic_nongavi
mdv,Maldives,2001,dtp1,99,6057,5996,61,sear,mic_nongavi
mdv,Maldives,2001,mcv1,98,6057,5936,121,sear,mic_nongavi
mdv,Maldives,2001,dtp3,98,6057,5936,121,sear,mic_nongavi
mdv,Maldives,2002,dtp1,98,6009,5889,120,sear,mic_nongavi
mdv,Maldives,2002,mcv1,97,6009,5829,180,sear,mic_nongavi
mdv,Maldives,2002,dtp3,98,6009,5889,120,sear,mic_nongavi
mdv,Maldives,2003,dtp3,98,6011,5891,120,sear,mic_nongavi
mdv,Maldives,2003,mcv1,96,6011,5771,240,sear,mic_nongavi
mdv,Maldives,2003,dtp1,98,6011,5891,120,sear,mic_nongavi
mdv,Maldives,2004,mcv1,97,6063,5881,182,sear,mic_nongavi
mdv,Maldives,2004,dtp3,96,6063,5820,243,sear,mic_nongavi
mdv,Maldives,2004,dtp1,98,6063,5942,121,sear,mic_nongavi
mdv,Maldives,2005,dtp3,98,6164,6041,123,sear,mic_nongavi
mdv,Maldives,2005,mcv1,97,6164,5979,185,sear,mic_nongavi
mdv,Maldives,2005,dtp1,99,6164,6102,62,sear,mic_nongavi
mdv,Maldives,2006,mcv1,97,6317,6127,190,sear,mic_nongavi
mdv,Maldives,2006,dtp3,98,6317,6191,126,sear,mic_nongavi
mdv,Maldives,2006,dtp1,98,6317,6191,126,sear,mic_nongavi
mdv,Maldives,2007,dtp3,98,6513,6383,130,sear,mic_nongavi
mdv,Maldives,2007,dtp1,99,6513,6448,65,sear,mic_nongavi
mdv,Maldives,2007,mcv1,97,6513,6318,195,sear,mic_nongavi
mdv,Maldives,2007,mcv2,56,6076,3403,2673,sear,mic_nongavi
mdv,Maldives,2008,dtp3,98,6736,6601,135,sear,mic_nongavi
mdv,Maldives,2008,mcv1,97,6736,6534,202,sear,mic_nongavi
mdv,Maldives,2008,dtp1,99,6736,6669,67,sear,mic_nongavi
mdv,Maldives,2008,mcv2,76,6149,4673,1476,sear,mic_nongavi
mdv,Maldives,2009,dtp1,99,6971,6901,70,sear,mic_nongavi
mdv,Maldives,2009,mcv1,98,6971,6832,139,sear,mic_nongavi
mdv,Maldives,2009,dtp3,98,6971,6832,139,sear,mic_nongavi
mdv,Maldives,2009,mcv2,96,6334,6081,253,sear,mic_nongavi
mdv,Maldives,2010,dtp1,97,7199,6983,216,sear,mic_nongavi
mdv,Maldives,2010,mcv1,97,7199,6983,216,sear,mic_nongavi
mdv,Maldives,2010,dtp3,96,7199,6911,288,sear,mic_nongavi
mdv,Maldives,2010,mcv2,96,6557,6295,262,sear,mic_nongavi
mdv,Maldives,2011,mcv1,96,7403,7107,296,sear,mic_nongavi
mdv,Maldives,2011,dtp3,96,7403,7107,296,sear,mic_nongavi
mdv,Maldives,2011,dtp1,97,7403,7181,222,sear,mic_nongavi
mdv,Maldives,2011,mcv2,96,6806,6534,272,sear,mic_nongavi
mdv,Maldives,2012,dtp3,99,7569,7493,76,sear,mic_nongavi
mdv,Maldives,2012,dtp1,99,7569,7493,76,sear,mic_nongavi
mdv,Maldives,2012,mcv1,98,7569,7418,151,sear,mic_nongavi
mdv,Maldives,2012,mcv2,99,7083,7012,71,sear,mic_nongavi
mdv,Maldives,2013,dtp3,99,7689,7612,77,sear,mic_nongavi
mdv,Maldives,2013,dtp1,99,7689,7612,77,sear,mic_nongavi
mdv,Maldives,2013,mcv1,99,7689,7612,77,sear,mic_nongavi
mdv,Maldives,2013,mcv2,99,7346,7273,73,sear,mic_nongavi
mdv,Maldives,2014,dtp3,99,7754,7676,78,sear,mic_nongavi
mdv,Maldives,2014,mcv1,99,7754,7676,78,sear,mic_nongavi
mdv,Maldives,2014,dtp1,99,7754,7676,78,sear,mic_nongavi
mdv,Maldives,2014,mcv2,97,7572,7345,227,sear,mic_nongavi
mdv,Maldives,2015,mcv1,99,7759,7681,78,sear,mic_nongavi
mdv,Maldives,2015,dtp3,99,7759,7681,78,sear,mic_nongavi
mdv,Maldives,2015,dtp1,99,7759,7681,78,sear,mic_nongavi
mdv,Maldives,2015,mcv2,99,7730,7653,77,sear,mic_nongavi
mdv,Maldives,2016,dtp3,99,7708,7631,77,sear,mic_nongavi
mdv,Maldives,2016,mcv1,99,7708,7631,77,sear,mic_nongavi
mdv,Maldives,2016,dtp1,99,7708,7631,77,sear,mic_nongavi
mdv,Maldives,2016,mcv2,99,7901,7822,79,sear,mic_nongavi
mex,Mexico,2000,dtp3,97,2393026,2321235,71791,amr,mic_nongavi
mex,Mexico,2000,mcv1,96,2393026,2297305,95721,amr,mic_nongavi
mex,Mexico,2000,dtp1,99,2393026,2369096,23930,amr,mic_nongavi
mex,Mexico,2000,mcv2,98,2354255,2307170,47085,amr,mic_nongavi
mex,Mexico,2001,dtp3,97,2383843,2312328,71515,amr,mic_nongavi
mex,Mexico,2001,dtp1,99,2383843,2360005,23838,amr,mic_nongavi
mex,Mexico,2001,mcv1,95,2383843,2264651,119192,amr,mic_nongavi
mex,Mexico,2001,mcv2,99,2361232,2337620,23612,amr,mic_nongavi
mex,Mexico,2002,mcv1,96,2371779,2276908,94871,amr,mic_nongavi
mex,Mexico,2002,dtp3,97,2371779,2300626,71153,amr,mic_nongavi
mex,Mexico,2002,dtp1,99,2371779,2348061,23718,amr,mic_nongavi
mex,Mexico,2002,mcv2,89,2368002,2107522,260480,amr,mic_nongavi
mex,Mexico,2003,dtp1,99,2357546,2333971,23575,amr,mic_nongavi
mex,Mexico,2003,mcv1,96,2357546,2263244,94302,amr,mic_nongavi
mex,Mexico,2003,dtp3,98,2357546,2310395,47151,amr,mic_nongavi
mex,Mexico,2003,mcv2,96,2374323,2279350,94973,amr,mic_nongavi
mex,Mexico,2004,dtp1,99,2342082,2318661,23421,amr,mic_nongavi
mex,Mexico,2004,dtp3,98,2342082,2295240,46842,amr,mic_nongavi
mex,Mexico,2004,mcv1,96,2342082,2248399,93683,amr,mic_nongavi
mex,Mexico,2004,mcv2,97,2380074,2308672,71402,amr,mic_nongavi
mex,Mexico,2005,dtp1,99,2327082,2303811,23271,amr,mic_nongavi
mex,Mexico,2005,mcv1,96,2327082,2233999,93083,amr,mic_nongavi
mex,Mexico,2005,dtp3,98,2327082,2280540,46542,amr,mic_nongavi
mex,Mexico,2005,mcv2,97,2386094,2314511,71583,amr,mic_nongavi
mex,Mexico,2006,dtp3,98,2314452,2268163,46289,amr,mic_nongavi
mex,Mexico,2006,mcv1,96,2314452,2221874,92578,amr,mic_nongavi
mex,Mexico,2006,dtp1,99,2314452,2291307,23145,amr,mic_nongavi
mex,Mexico,2006,mcv2,91,2379382,2165238,214144,amr,mic_nongavi
mex,Mexico,2007,mcv1,96,2305284,2213073,92211,amr,mic_nongavi
mex,Mexico,2007,dtp3,98,2305284,2259178,46106,amr,mic_nongavi
mex,Mexico,2007,dtp1,99,2305284,2282231,23053,amr,mic_nongavi
mex,Mexico,2007,mcv2,85,2369610,2014168,355442,amr,mic_nongavi
mex,Mexico,2008,dtp3,96,2300014,2208013,92001,amr,mic_nongavi
mex,Mexico,2008,dtp1,98,2300014,2254014,46000,amr,mic_nongavi
mex,Mexico,2008,mcv1,96,2300014,2208013,92001,amr,mic_nongavi
mex,Mexico,2008,mcv2,94,2356652,2215253,141399,amr,mic_nongavi
mex,Mexico,2009,dtp1,98,2298449,2252480,45969,amr,mic_nongavi
mex,Mexico,2009,mcv1,96,2298449,2206511,91938,amr,mic_nongavi
mex,Mexico,2009,dtp3,95,2298449,2183527,114922,amr,mic_nongavi
mex,Mexico,2009,mcv2,92,2341575,2154249,187326,amr,mic_nongavi
mex,Mexico,2010,mcv1,95,2299584,2184605,114979,amr,mic_nongavi
mex,Mexico,2010,dtp3,95,2299584,2184605,114979,amr,mic_nongavi
mex,Mexico,2010,dtp1,96,2299584,2207601,91983,amr,mic_nongavi
mex,Mexico,2010,mcv2,91,2327054,2117619,209435,amr,mic_nongavi
mex,Mexico,2011,dtp1,99,2301768,2278750,23018,amr,mic_nongavi
mex,Mexico,2011,mcv1,98,2301768,2255733,46035,amr,mic_nongavi
mex,Mexico,2011,dtp3,97,2301768,2232715,69053,amr,mic_nongavi
mex,Mexico,2011,mcv2,97,2314773,2245330,69443,amr,mic_nongavi
mex,Mexico,2012,dtp1,99,2302968,2279938,23030,amr,mic_nongavi
mex,Mexico,2012,dtp3,99,2302968,2279938,23030,amr,mic_nongavi
mex,Mexico,2012,mcv1,99,2302968,2279938,23030,amr,mic_nongavi
mex,Mexico,2012,mcv2,92,2301777,2117635,184142,amr,mic_nongavi
mex,Mexico,2013,dtp1,90,2301578,2071420,230158,amr,mic_nongavi
mex,Mexico,2013,mcv1,89,2301578,2048404,253174,amr,mic_nongavi
mex,Mexico,2013,dtp3,83,2301578,1910310,391268,amr,mic_nongavi
mex,Mexico,2013,mcv2,76,2289312,1739877,549435,amr,mic_nongavi
mex,Mexico,2014,dtp3,87,2296874,1998280,298594,amr,mic_nongavi
mex,Mexico,2014,dtp1,95,2296874,2182030,114844,amr,mic_nongavi
mex,Mexico,2014,mcv1,97,2296874,2227968,68906,amr,mic_nongavi
mex,Mexico,2014,mcv2,95,2278817,2164876,113941,amr,mic_nongavi
mex,Mexico,2015,dtp3,87,2288617,1991097,297520,amr,mic_nongavi
mex,Mexico,2015,dtp1,99,2288617,2265731,22886,amr,mic_nongavi
mex,Mexico,2015,mcv1,97,2288617,2219958,68659,amr,mic_nongavi
mex,Mexico,2015,mcv2,96,2271510,2180650,90860,amr,mic_nongavi
mex,Mexico,2016,dtp3,97,2277176,2208861,68315,amr,mic_nongavi
mex,Mexico,2016,dtp1,99,2277176,2254404,22772,amr,mic_nongavi
mex,Mexico,2016,mcv1,96,2277176,2186089,91087,amr,mic_nongavi
mex,Mexico,2016,mcv2,98,2271756,2226321,45435,amr,mic_nongavi
mhl,Marshall Islands,2000,dtp1,64,1392.0208600906,891,501.0208600906,wpr,mic_nongavi
mhl,Marshall Islands,2000,mcv1,94,1392.0208600906,1308,84.0208600906,wpr,mic_nongavi
mhl,Marshall Islands,2000,dtp3,39,1392.0208600906,543,849.0208600906,wpr,mic_nongavi
mhl,Marshall Islands,2000,mcv2,6,1392.0208600906,84,1308.0208600906,wpr,mic_nongavi
mhl,Marshall Islands,2001,mcv1,64,1362.40953615,872,490.40953615,wpr,mic_nongavi
mhl,Marshall Islands,2001,dtp1,99,1362.40953615,1349,13.40953615,wpr,mic_nongavi
mhl,Marshall Islands,2001,dtp3,48,1362.40953615,654,708.40953615,wpr,mic_nongavi
mhl,Marshall Islands,2001,mcv2,6,1362.40953615,82,1280.40953615,wpr,mic_nongavi
mhl,Marshall Islands,2002,dtp1,90,1331.1601337668,1198,133.1601337668,wpr,mic_nongavi
mhl,Marshall Islands,2002,dtp3,80,1331.1601337668,1065,266.1601337668,wpr,mic_nongavi
mhl,Marshall Islands,2002,mcv1,80,1331.1601337668,1065,266.1601337668,wpr,mic_nongavi
mhl,Marshall Islands,2002,mcv2,70,1331.1601337668,932,399.1601337668,wpr,mic_nongavi
mhl,Marshall Islands,2003,dtp1,90,1300.1722354804,1170,130.1722354804,wpr,mic_nongavi
mhl,Marshall Islands,2003,mcv1,90,1300.1722354804,1170,130.1722354804,wpr,mic_nongavi
mhl,Marshall Islands,2003,dtp3,68,1300.1722354804,884,416.1722354804,wpr,mic_nongavi
mhl,Marshall Islands,2003,mcv2,90,1300.1722354804,1170,130.1722354804,wpr,mic_nongavi
mhl,Marshall Islands,2004,dtp1,71,1270.131495319,902,368.131495319,wpr,mic_nongavi
mhl,Marshall Islands,2004,dtp3,64,1270.131495319,813,457.131495319,wpr,mic_nongavi
mhl,Marshall Islands,2004,mcv1,70,1270.131495319,889,381.131495319,wpr,mic_nongavi
mhl,Marshall Islands,2004,mcv2,92,1270.131495319,1169,101.131495319,wpr,mic_nongavi
mhl,Marshall Islands,2005,mcv1,86,1241.7701769582,1068,173.7701769582,wpr,mic_nongavi
mhl,Marshall Islands,2005,dtp3,77,1241.7701769582,956,285.7701769582,wpr,mic_nongavi
mhl,Marshall Islands,2005,dtp1,89,1241.7701769582,1105,136.7701769582,wpr,mic_nongavi
mhl,Marshall Islands,2005,mcv2,71,1241.7701769582,882,359.7701769582,wpr,mic_nongavi
mhl,Marshall Islands,2006,dtp3,74,1216.6368467729,900,316.6368467729,wpr,mic_nongavi
mhl,Marshall Islands,2006,dtp1,90,1216.6368467729,1095,121.6368467729,wpr,mic_nongavi
mhl,Marshall Islands,2006,mcv1,96,1216.6368467729,1168,48.6368467729,wpr,mic_nongavi
mhl,Marshall Islands,2006,mcv2,60,1216.6368467729,730,486.6368467729,wpr,mic_nongavi
mhl,Marshall Islands,2007,dtp3,93,1194.6441321374,1111,83.6441321374,wpr,mic_nongavi
mhl,Marshall Islands,2007,dtp1,99,1194.6441321374,1183,11.6441321374,wpr,mic_nongavi
mhl,Marshall Islands,2007,mcv1,94,1194.6441321374,1123,71.6441321374,wpr,mic_nongavi
mhl,Marshall Islands,2007,mcv2,91,1194.6441321374,1087,107.6441321374,wpr,mic_nongavi
mhl,Marshall Islands,2008,dtp3,95,1175.320543699,1117,58.320543699,wpr,mic_nongavi
mhl,Marshall Islands,2008,dtp1,99,1175.320543699,1164,11.320543699,wpr,mic_nongavi
mhl,Marshall Islands,2008,mcv1,86,1175.320543699,1011,164.320543699,wpr,mic_nongavi
mhl,Marshall Islands,2008,mcv2,79,1175.320543699,929,246.320543699,wpr,mic_nongavi
mhl,Marshall Islands,2009,dtp3,96,1158.4505106994,1112,46.4505106994,wpr,mic_nongavi
mhl,Marshall Islands,2009,dtp1,99,1158.4505106994,1147,11.4505106994,wpr,mic_nongavi
mhl,Marshall Islands,2009,mcv1,78,1158.4505106994,904,254.4505106994,wpr,mic_nongavi
mhl,Marshall Islands,2009,mcv2,66,1158.4505106994,765,393.4505106994,wpr,mic_nongavi
mhl,Marshall Islands,2010,dtp1,99,1143.4151660507,1132,11.4151660507,wpr,mic_nongavi
mhl,Marshall Islands,2010,dtp3,94,1143.4151660507,1075,68.4151660507,wpr,mic_nongavi
mhl,Marshall Islands,2010,mcv1,97,1143.4151660507,1109,34.4151660507,wpr,mic_nongavi
mhl,Marshall Islands,2010,mcv2,90,1143.4151660507,1029,114.4151660507,wpr,mic_nongavi
mhl,Marshall Islands,2011,dtp1,99,1129.8408014457,1119,10.8408014457,wpr,mic_nongavi
mhl,Marshall Islands,2011,dtp3,87,1129.8408014457,983,146.8408014457,wpr,mic_nongavi
mhl,Marshall Islands,2011,mcv1,88,1129.8408014457,994,135.8408014457,wpr,mic_nongavi
mhl,Marshall Islands,2011,mcv2,74,1129.8408014457,836,293.8408014457,wpr,mic_nongavi
mhl,Marshall Islands,2012,dtp3,80,1117.332565398,894,223.332565398,wpr,mic_nongavi
mhl,Marshall Islands,2012,mcv1,78,1117.332565398,872,245.332565398,wpr,mic_nongavi
mhl,Marshall Islands,2012,dtp1,97,1117.332565398,1084,33.332565398,wpr,mic_nongavi
mhl,Marshall Islands,2012,mcv2,58,1117.332565398,648,469.332565398,wpr,mic_nongavi
mhl,Marshall Islands,2013,mcv1,79,1105.5204628882,873,232.5204628882,wpr,mic_nongavi
mhl,Marshall Islands,2013,dtp3,79,1105.5204628882,873,232.5204628882,wpr,mic_nongavi
mhl,Marshall Islands,2013,dtp1,97,1105.5204628882,1072,33.5204628882,wpr,mic_nongavi
mhl,Marshall Islands,2013,mcv2,56,1105.5204628882,619,486.5204628882,wpr,mic_nongavi
mhl,Marshall Islands,2014,mcv1,79,1093.9701251607,864,229.9701251607,wpr,mic_nongavi
mhl,Marshall Islands,2014,dtp1,97,1093.9701251607,1061,32.9701251607,wpr,mic_nongavi
mhl,Marshall Islands,2014,dtp3,78,1093.9701251607,853,240.9701251607,wpr,mic_nongavi
mhl,Marshall Islands,2014,mcv2,53,1093.9701251607,580,513.9701251607,wpr,mic_nongavi
mhl,Marshall Islands,2015,dtp1,95,1083.476196168,1029,54.476196168,wpr,mic_nongavi
mhl,Marshall Islands,2015,mcv1,75,1083.476196168,813,270.476196168,wpr,mic_nongavi
mhl,Marshall Islands,2015,dtp3,85,1083.476196168,921,162.476196168,wpr,mic_nongavi
mhl,Marshall Islands,2015,mcv2,70,1083.476196168,758,325.476196168,wpr,mic_nongavi
mhl,Marshall Islands,2016,mcv1,75,1073.8556632438,805,268.8556632438,wpr,mic_nongavi
mhl,Marshall Islands,2016,dtp3,71,1073.8556632438,762,311.8556632438,wpr,mic_nongavi
mhl,Marshall Islands,2016,dtp1,87,1073.8556632438,934,139.8556632438,wpr,mic_nongavi
mhl,Marshall Islands,2016,mcv2,49,NA,NA,#VALUE!,wpr,mic_nongavi
mkd,The former Yugoslav Republic of Macedonia,2000,dtp3,95,25960,24662,1298,eur,mic_nongavi
mkd,The former Yugoslav Republic of Macedonia,2000,mcv1,97,25960,25181,779,eur,mic_nongavi
mkd,The former Yugoslav Republic of Macedonia,2000,dtp1,98,25960,25441,519,eur,mic_nongavi
mkd,The former Yugoslav Republic of Macedonia,2000,mcv2,95,31651,30068,1583,eur,mic_nongavi
mkd,The former Yugoslav Republic of Macedonia,2001,mcv1,92,25476,23438,2038,eur,mic_nongavi
mkd,The former Yugoslav Republic of Macedonia,2001,dtp1,95,25476,24202,1274,eur,mic_nongavi
mkd,The former Yugoslav Republic of Macedonia,2001,dtp3,91,25476,23183,2293,eur,mic_nongavi
mkd,The former Yugoslav Republic of Macedonia,2001,mcv2,94,31052,29189,1863,eur,mic_nongavi
mkd,The former Yugoslav Republic of Macedonia,2002,mcv1,98,25008,24508,500,eur,mic_nongavi
mkd,The former Yugoslav Republic of Macedonia,2002,dtp3,96,25008,24008,1000,eur,mic_nongavi
mkd,The former Yugoslav Republic of Macedonia,2002,dtp1,99,25008,24758,250,eur,mic_nongavi
mkd,The former Yugoslav Republic of Macedonia,2002,mcv2,95,30157,28649,1508,eur,mic_nongavi
mkd,The former Yugoslav Republic of Macedonia,2003,mcv1,96,24533,23552,981,eur,mic_nongavi
mkd,The former Yugoslav Republic of Macedonia,2003,dtp3,96,24533,23552,981,eur,mic_nongavi
mkd,The former Yugoslav Republic of Macedonia,2003,dtp1,99,24533,24288,245,eur,mic_nongavi
mkd,The former Yugoslav Republic of Macedonia,2003,mcv2,97,29090,28217,873,eur,mic_nongavi
mkd,The former Yugoslav Republic of Macedonia,2004,dtp1,96,24052,23090,962,eur,mic_nongavi
mkd,The former Yugoslav Republic of Macedonia,2004,mcv1,96,24052,23090,962,eur,mic_nongavi
mkd,The former Yugoslav Republic of Macedonia,2004,dtp3,94,24052,22609,1443,eur,mic_nongavi
mkd,The former Yugoslav Republic of Macedonia,2004,mcv2,95,27980,26581,1399,eur,mic_nongavi
mkd,The former Yugoslav Republic of Macedonia,2005,dtp1,99,23593,23357,236,eur,mic_nongavi
mkd,The former Yugoslav Republic of Macedonia,2005,mcv1,96,23593,22649,944,eur,mic_nongavi
mkd,The former Yugoslav Republic of Macedonia,2005,dtp3,97,23593,22885,708,eur,mic_nongavi
mkd,The former Yugoslav Republic of Macedonia,2005,mcv2,95,26940,25593,1347,eur,mic_nongavi
mkd,The former Yugoslav Republic of Macedonia,2006,mcv1,94,23198,21806,1392,eur,mic_nongavi
mkd,The former Yugoslav Republic of Macedonia,2006,dtp3,93,23198,21574,1624,eur,mic_nongavi
mkd,The former Yugoslav Republic of Macedonia,2006,dtp1,95,23198,22038,1160,eur,mic_nongavi
mkd,The former Yugoslav Republic of Macedonia,2006,mcv2,96,26104,25060,1044,eur,mic_nongavi
mkd,The former Yugoslav Republic of Macedonia,2007,dtp3,95,22906,21761,1145,eur,mic_nongavi
mkd,The former Yugoslav Republic of Macedonia,2007,mcv1,96,22906,21990,916,eur,mic_nongavi
mkd,The former Yugoslav Republic of Macedonia,2007,dtp1,95,22906,21761,1145,eur,mic_nongavi
mkd,The former Yugoslav Republic of Macedonia,2007,mcv2,95,25564,24286,1278,eur,mic_nongavi
mkd,The former Yugoslav Republic of Macedonia,2008,dtp1,96,22739,21829,910,eur,mic_nongavi
mkd,The former Yugoslav Republic of Macedonia,2008,dtp3,95,22739,21602,1137,eur,mic_nongavi
mkd,The former Yugoslav Republic of Macedonia,2008,mcv1,98,22739,22284,455,eur,mic_nongavi
mkd,The former Yugoslav Republic of Macedonia,2008,mcv2,95,25216,23955,1261,eur,mic_nongavi
mkd,The former Yugoslav Republic of Macedonia,2009,mcv1,96,22691,21783,908,eur,mic_nongavi
mkd,The former Yugoslav Republic of Macedonia,2009,dtp1,96,22691,21783,908,eur,mic_nongavi
mkd,The former Yugoslav Republic of Macedonia,2009,dtp3,96,22691,21783,908,eur,mic_nongavi
mkd,The former Yugoslav Republic of Macedonia,2009,mcv2,97,24951,24202,749,eur,mic_nongavi
mkd,The former Yugoslav Republic of Macedonia,2010,mcv1,98,22746,22291,455,eur,mic_nongavi
mkd,The former Yugoslav Republic of Macedonia,2010,dtp1,97,22746,22064,682,eur,mic_nongavi
mkd,The former Yugoslav Republic of Macedonia,2010,dtp3,95,22746,21609,1137,eur,mic_nongavi
mkd,The former Yugoslav Republic of Macedonia,2010,mcv2,99,24308,24065,243,eur,mic_nongavi
mkd,The former Yugoslav Republic of Macedonia,2011,dtp3,96,22872,21957,915,eur,mic_nongavi
mkd,The former Yugoslav Republic of Macedonia,2011,mcv1,97,22872,22186,686,eur,mic_nongavi
mkd,The former Yugoslav Republic of Macedonia,2011,dtp1,97,22872,22186,686,eur,mic_nongavi
mkd,The former Yugoslav Republic of Macedonia,2011,mcv2,98,23859,23382,477,eur,mic_nongavi
mkd,The former Yugoslav Republic of Macedonia,2012,dtp3,95,23023,21872,1151,eur,mic_nongavi
mkd,The former Yugoslav Republic of Macedonia,2012,mcv1,96,23023,22102,921,eur,mic_nongavi
mkd,The former Yugoslav Republic of Macedonia,2012,dtp1,98,23023,22563,460,eur,mic_nongavi
mkd,The former Yugoslav Republic of Macedonia,2012,mcv2,96,23344,22410,934,eur,mic_nongavi
mkd,The former Yugoslav Republic of Macedonia,2013,mcv1,96,23158,22232,926,eur,mic_nongavi
mkd,The former Yugoslav Republic of Macedonia,2013,dtp1,99,23158,22926,232,eur,mic_nongavi
mkd,The former Yugoslav Republic of Macedonia,2013,dtp3,98,23158,22695,463,eur,mic_nongavi
mkd,The former Yugoslav Republic of Macedonia,2013,mcv2,96,22843,21929,914,eur,mic_nongavi
mkd,The former Yugoslav Republic of Macedonia,2014,dtp1,98,23253,22788,465,eur,mic_nongavi
mkd,The former Yugoslav Republic of Macedonia,2014,mcv1,93,23253,21625,1628,eur,mic_nongavi
mkd,The former Yugoslav Republic of Macedonia,2014,dtp3,95,23253,22090,1163,eur,mic_nongavi
mkd,The former Yugoslav Republic of Macedonia,2014,mcv2,96,22435,21538,897,eur,mic_nongavi
mkd,The former Yugoslav Republic of Macedonia,2015,mcv1,89,23293,20731,2562,eur,mic_nongavi
mkd,The former Yugoslav Republic of Macedonia,2015,dtp1,98,23293,22827,466,eur,mic_nongavi
mkd,The former Yugoslav Republic of Macedonia,2015,dtp3,91,23293,21197,2096,eur,mic_nongavi
mkd,The former Yugoslav Republic of Macedonia,2015,mcv2,93,22230,20674,1556,eur,mic_nongavi
mkd,The former Yugoslav Republic of Macedonia,2016,dtp1,97,23277,22579,698,eur,mic_nongavi
mkd,The former Yugoslav Republic of Macedonia,2016,mcv1,82,23277,19087,4190,eur,mic_nongavi
mkd,The former Yugoslav Republic of Macedonia,2016,dtp3,95,23277,22113,1164,eur,mic_nongavi
mkd,The former Yugoslav Republic of Macedonia,2016,mcv2,93,22243,20686,1557,eur,mic_nongavi
mli,Mali,2000,dtp3,43,475929,204649,271280,afr,gavi
mli,Mali,2000,mcv1,49,475929,233205,242724,afr,gavi
mli,Mali,2000,dtp1,61,475929,290317,185612,afr,gavi
mli,Mali,2001,dtp1,76,491948,373880,118068,afr,gavi
mli,Mali,2001,dtp3,49,491948,241055,250893,afr,gavi
mli,Mali,2001,mcv1,54,491948,265652,226296,afr,gavi
mli,Mali,2002,mcv1,56,508841,284951,223890,afr,gavi
mli,Mali,2002,dtp1,82,508841,417250,91591,afr,gavi
mli,Mali,2002,dtp3,61,508841,310393,198448,afr,gavi
mli,Mali,2003,dtp3,63,526342,331595,194747,afr,gavi
mli,Mali,2003,mcv1,57,526342,300015,226327,afr,gavi
mli,Mali,2003,dtp1,85,526342,447391,78951,afr,gavi
mli,Mali,2004,dtp1,86,544167,467984,76183,afr,gavi
mli,Mali,2004,dtp3,69,544167,375475,168692,afr,gavi
mli,Mali,2004,mcv1,63,544167,342825,201342,afr,gavi
mli,Mali,2005,dtp3,77,561916,432675,129241,afr,gavi
mli,Mali,2005,dtp1,87,561916,488867,73049,afr,gavi
mli,Mali,2005,mcv1,73,561916,410199,151717,afr,gavi
mli,Mali,2006,dtp1,86,579178,498093,81085,afr,gavi
mli,Mali,2006,mcv1,68,579178,393841,185337,afr,gavi
mli,Mali,2006,dtp3,78,579178,451759,127419,afr,gavi
mli,Mali,2007,dtp3,74,595699,440817,154882,afr,gavi
mli,Mali,2007,dtp1,86,595699,512301,83398,afr,gavi
mli,Mali,2007,mcv1,66,595699,393161,202538,afr,gavi
mli,Mali,2008,mcv1,71,611321,434038,177283,afr,gavi
mli,Mali,2008,dtp3,74,611321,452378,158943,afr,gavi
mli,Mali,2008,dtp1,85,611321,519623,91698,afr,gavi
mli,Mali,2009,dtp1,82,625974,513299,112675,afr,gavi
mli,Mali,2009,mcv1,73,625974,456961,169013,afr,gavi
mli,Mali,2009,dtp3,73,625974,456961,169013,afr,gavi
mli,Mali,2010,mcv1,78,639684,498954,140730,afr,gavi
mli,Mali,2010,dtp1,81,639684,518144,121540,afr,gavi
mli,Mali,2010,dtp3,73,639684,466969,172715,afr,gavi
mli,Mali,2011,mcv1,72,652598,469871,182727,afr,gavi
mli,Mali,2011,dtp1,80,652598,522078,130520,afr,gavi
mli,Mali,2011,dtp3,66,652598,430715,221883,afr,gavi
mli,Mali,2012,dtp3,66,665075,438950,226125,afr,gavi
mli,Mali,2012,dtp1,81,665075,538711,126364,afr,gavi
mli,Mali,2012,mcv1,73,665075,485505,179570,afr,gavi
mli,Mali,2013,dtp3,69,677465,467451,210014,afr,gavi
mli,Mali,2013,dtp1,85,677465,575845,101620,afr,gavi
mli,Mali,2013,mcv1,76,677465,514873,162592,afr,gavi
mli,Mali,2014,dtp3,73,689987,503691,186296,afr,gavi
mli,Mali,2014,dtp1,92,689987,634788,55199,afr,gavi
mli,Mali,2014,mcv1,74,689987,510590,179397,afr,gavi
mli,Mali,2015,dtp1,82,702854,576340,126514,afr,gavi
mli,Mali,2015,dtp3,64,702854,449827,253027,afr,gavi
mli,Mali,2015,mcv1,70,702854,491998,210856,afr,gavi
mli,Mali,2016,mcv1,75,716209,537157,179052,afr,gavi
mli,Mali,2016,dtp3,68,716209,487022,229187,afr,gavi
mli,Mali,2016,dtp1,86,716209,615940,100269,afr,gavi
mlt,Malta,2000,dtp1,97,4449,4316,133,eur,hic
mlt,Malta,2000,dtp3,94,4449,4182,267,eur,hic
mlt,Malta,2000,mcv1,74,4449,3292,1157,eur,hic
mlt,Malta,2001,mcv1,70,4276,2993,1283,eur,hic
mlt,Malta,2001,dtp1,98,4276,4190,86,eur,hic
mlt,Malta,2001,dtp3,95,4276,4062,214,eur,hic
mlt,Malta,2002,mcv1,65,4119,2677,1442,eur,hic
mlt,Malta,2002,dtp3,95,4119,3913,206,eur,hic
mlt,Malta,2002,dtp1,95,4119,3913,206,eur,hic
mlt,Malta,2003,dtp1,96,3990,3830,160,eur,hic
mlt,Malta,2003,dtp3,94,3990,3751,239,eur,hic
mlt,Malta,2003,mcv1,90,3990,3591,399,eur,hic
mlt,Malta,2003,mcv2,2,5126,103,5023,eur,hic
mlt,Malta,2004,dtp3,89,3897,3468,429,eur,hic
mlt,Malta,2004,dtp1,92,3897,3585,312,eur,hic
mlt,Malta,2004,mcv1,94,3897,3663,234,eur,hic
mlt,Malta,2004,mcv2,31,5062,1569,3493,eur,hic
mlt,Malta,2005,mcv1,86,3841,3303,538,eur,hic
mlt,Malta,2005,dtp3,92,3841,3534,307,eur,hic
mlt,Malta,2005,dtp1,94,3841,3611,230,eur,hic
mlt,Malta,2005,mcv2,60,5258,3155,2103,eur,hic
mlt,Malta,2006,dtp3,85,3822,3249,573,eur,hic
mlt,Malta,2006,dtp1,85,3822,3249,573,eur,hic
mlt,Malta,2006,mcv1,94,3822,3593,229,eur,hic
mlt,Malta,2006,mcv2,86,4775,4106,669,eur,hic
mlt,Malta,2007,dtp3,74,3828,2833,995,eur,hic
mlt,Malta,2007,dtp1,84,3828,3216,612,eur,hic
mlt,Malta,2007,mcv1,79,3828,3024,804,eur,hic
mlt,Malta,2007,mcv2,77,4553,3506,1047,eur,hic
mlt,Malta,2008,dtp1,88,3852,3390,462,eur,hic
mlt,Malta,2008,dtp3,72,3852,2773,1079,eur,hic
mlt,Malta,2008,mcv1,78,3852,3005,847,eur,hic
mlt,Malta,2008,mcv2,83,4480,3718,762,eur,hic
mlt,Malta,2009,dtp3,73,3888,2838,1050,eur,hic
mlt,Malta,2009,dtp1,91,3888,3538,350,eur,hic
mlt,Malta,2009,mcv1,82,3888,3188,700,eur,hic
mlt,Malta,2009,mcv2,85,3789,3221,568,eur,hic
mlt,Malta,2010,dtp1,97,3930,3812,118,eur,hic
mlt,Malta,2010,dtp3,76,3930,2987,943,eur,hic
mlt,Malta,2010,mcv1,73,3930,2869,1061,eur,hic
mlt,Malta,2010,mcv2,85,3856,3278,578,eur,hic
mlt,Malta,2011,dtp3,96,3979,3820,159,eur,hic
mlt,Malta,2011,mcv1,84,3979,3342,637,eur,hic
mlt,Malta,2011,dtp1,99,3979,3939,40,eur,hic
mlt,Malta,2011,mcv2,85,3943,3352,591,eur,hic
mlt,Malta,2012,dtp3,99,4031,3991,40,eur,hic
mlt,Malta,2012,mcv1,93,4031,3749,282,eur,hic
mlt,Malta,2012,dtp1,99,4031,3991,40,eur,hic
mlt,Malta,2012,mcv2,91,4054,3689,365,eur,hic
mlt,Malta,2013,mcv1,99,4086,4045,41,eur,hic
mlt,Malta,2013,dtp3,99,4086,4045,41,eur,hic
mlt,Malta,2013,dtp1,99,4086,4045,41,eur,hic
mlt,Malta,2013,mcv2,88,4161,3662,499,eur,hic
mlt,Malta,2014,mcv1,98,4138,4055,83,eur,hic
mlt,Malta,2014,dtp3,99,4138,4097,41,eur,hic
mlt,Malta,2014,dtp1,99,4138,4097,41,eur,hic
mlt,Malta,2014,mcv2,94,4150,3901,249,eur,hic
mlt,Malta,2015,dtp1,98,4185,4101,84,eur,hic
mlt,Malta,2015,mcv1,89,4185,3725,460,eur,hic
mlt,Malta,2015,dtp3,97,4185,4059,126,eur,hic
mlt,Malta,2015,mcv2,91,4229,3848,381,eur,hic
mlt,Malta,2016,dtp1,97,4226,4099,127,eur,hic
mlt,Malta,2016,mcv1,93,4226,3930,296,eur,hic
mlt,Malta,2016,dtp3,97,4226,4099,127,eur,hic
mlt,Malta,2016,mcv2,86,4282,3683,599,eur,hic
mmr,Myanmar,2000,dtp3,82,1061534,870458,191076,sear,gavi
mmr,Myanmar,2000,dtp1,87,1061534,923535,137999,sear,gavi
mmr,Myanmar,2000,mcv1,84,1061534,891689,169845,sear,gavi
mmr,Myanmar,2001,dtp3,73,1070055,781140,288915,sear,gavi
mmr,Myanmar,2001,dtp1,81,1070055,866745,203310,sear,gavi
mmr,Myanmar,2001,mcv1,73,1070055,781140,288915,sear,gavi
mmr,Myanmar,2002,mcv1,77,1073473,826574,246899,sear,gavi
mmr,Myanmar,2002,dtp1,81,1073473,869513,203960,sear,gavi
mmr,Myanmar,2002,dtp3,79,1073473,848044,225429,sear,gavi
mmr,Myanmar,2003,mcv1,80,1071032,856826,214206,sear,gavi
mmr,Myanmar,2003,dtp1,80,1071032,856826,214206,sear,gavi
mmr,Myanmar,2003,dtp3,78,1071032,835405,235627,sear,gavi
mmr,Myanmar,2004,dtp1,86,1062580,913819,148761,sear,gavi
mmr,Myanmar,2004,dtp3,82,1062580,871316,191264,sear,gavi
mmr,Myanmar,2004,mcv1,86,1062580,913819,148761,sear,gavi
mmr,Myanmar,2005,dtp1,76,1048534,796886,251648,sear,gavi
mmr,Myanmar,2005,mcv1,84,1048534,880769,167765,sear,gavi
mmr,Myanmar,2005,dtp3,73,1048534,765430,283104,sear,gavi
mmr,Myanmar,2006,dtp3,82,1029994,844595,185399,sear,gavi
mmr,Myanmar,2006,dtp1,86,1029994,885795,144199,sear,gavi
mmr,Myanmar,2006,mcv1,78,1029994,803395,226599,sear,gavi
mmr,Myanmar,2007,dtp3,86,1009118,867841,141277,sear,gavi
mmr,Myanmar,2007,dtp1,89,1009118,898115,111003,sear,gavi
mmr,Myanmar,2007,mcv1,81,1009118,817386,191732,sear,gavi
mmr,Myanmar,2008,dtp3,85,987970,839775,148195,sear,gavi
mmr,Myanmar,2008,dtp1,88,987970,869414,118556,sear,gavi
mmr,Myanmar,2008,mcv1,82,987970,810135,177835,sear,gavi
mmr,Myanmar,2008,mcv2,57,1030792,587551,443241,sear,gavi
mmr,Myanmar,2009,dtp1,93,967868,900117,67751,sear,gavi
mmr,Myanmar,2009,mcv1,87,967868,842045,125823,sear,gavi
mmr,Myanmar,2009,dtp3,90,967868,871081,96787,sear,gavi
mmr,Myanmar,2009,mcv2,65,1012378,658046,354332,sear,gavi
mmr,Myanmar,2010,mcv1,88,950035,836031,114004,sear,gavi
mmr,Myanmar,2010,dtp3,90,950035,855032,95003,sear,gavi
mmr,Myanmar,2010,dtp1,93,950035,883533,66502,sear,gavi
mmr,Myanmar,2010,mcv2,75,993836,745377,248459,sear,gavi
mmr,Myanmar,2011,mcv1,88,935251,823021,112230,sear,gavi
mmr,Myanmar,2011,dtp3,84,935251,785611,149640,sear,gavi
mmr,Myanmar,2011,dtp1,88,935251,823021,112230,sear,gavi
mmr,Myanmar,2011,mcv2,80,954480,763584,190896,sear,gavi
mmr,Myanmar,2012,dtp3,84,923357,775620,147737,sear,gavi
mmr,Myanmar,2012,dtp1,89,923357,821788,101569,sear,gavi
mmr,Myanmar,2012,mcv1,84,923357,775620,147737,sear,gavi
mmr,Myanmar,2013,dtp3,75,914121,685591,228530,sear,gavi
mmr,Myanmar,2013,mcv1,86,914121,786144,127977,sear,gavi
mmr,Myanmar,2013,dtp1,90,914121,822709,91412,sear,gavi
mmr,Myanmar,2013,mcv2,80,932834,746267,186567,sear,gavi
mmr,Myanmar,2014,mcv1,88,907560,798653,108907,sear,gavi
mmr,Myanmar,2014,dtp1,92,907560,834955,72605,sear,gavi
mmr,Myanmar,2014,dtp3,88,907560,798653,108907,sear,gavi
mmr,Myanmar,2014,mcv2,82,916542,751564,164978,sear,gavi
mmr,Myanmar,2015,dtp3,89,903495,804111,99384,sear,gavi
mmr,Myanmar,2015,dtp1,94,903495,849285,54210,sear,gavi
mmr,Myanmar,2015,mcv1,84,903495,758936,144559,sear,gavi
mmr,Myanmar,2015,mcv2,78,904514,705521,198993,sear,gavi
mmr,Myanmar,2016,dtp3,90,901525,811372,90153,sear,gavi
mmr,Myanmar,2016,mcv1,91,901525,820388,81137,sear,gavi
mmr,Myanmar,2016,dtp1,94,901525,847434,54091,sear,gavi
mmr,Myanmar,2016,mcv2,86,901524,775311,126213,sear,gavi
mne,Montenegro,2006,dtp3,90,8096,7286,810,eur,mic_nongavi
mne,Montenegro,2006,mcv1,90,8096,7286,810,eur,mic_nongavi
mne,Montenegro,2006,dtp1,95,8096,7691,405,eur,mic_nongavi
mne,Montenegro,2007,dtp1,98,8042,7881,161,eur,mic_nongavi
mne,Montenegro,2007,dtp3,92,8042,7399,643,eur,mic_nongavi
mne,Montenegro,2007,mcv1,90,8042,7238,804,eur,mic_nongavi
mne,Montenegro,2007,mcv2,95,7979,7580,399,eur,mic_nongavi
mne,Montenegro,2008,dtp1,98,7971,7812,159,eur,mic_nongavi
mne,Montenegro,2008,mcv1,89,7971,7094,877,eur,mic_nongavi
mne,Montenegro,2008,dtp3,95,7971,7572,399,eur,mic_nongavi
mne,Montenegro,2008,mcv2,96,7940,7622,318,eur,mic_nongavi
mne,Montenegro,2009,dtp1,96,7881,7566,315,eur,mic_nongavi
mne,Montenegro,2009,dtp3,92,7881,7251,630,eur,mic_nongavi
mne,Montenegro,2009,mcv1,86,7881,6778,1103,eur,mic_nongavi
mne,Montenegro,2009,mcv2,96,7901,7585,316,eur,mic_nongavi
mne,Montenegro,2010,dtp1,97,7773,7540,233,eur,mic_nongavi
mne,Montenegro,2010,dtp3,94,7773,7307,466,eur,mic_nongavi
mne,Montenegro,2010,mcv1,90,7773,6996,777,eur,mic_nongavi
mne,Montenegro,2010,mcv2,97,7856,7620,236,eur,mic_nongavi
mne,Montenegro,2011,dtp1,98,7655,7502,153,eur,mic_nongavi
mne,Montenegro,2011,mcv1,91,7655,6966,689,eur,mic_nongavi
mne,Montenegro,2011,dtp3,95,7655,7272,383,eur,mic_nongavi
mne,Montenegro,2011,mcv2,97,7856,7620,236,eur,mic_nongavi
mne,Montenegro,2012,dtp1,98,7534,7383,151,eur,mic_nongavi
mne,Montenegro,2012,dtp3,94,7534,7082,452,eur,mic_nongavi
mne,Montenegro,2012,mcv1,90,7534,6781,753,eur,mic_nongavi
mne,Montenegro,2012,mcv2,97,7877,7641,236,eur,mic_nongavi
mne,Montenegro,2013,dtp3,94,7418,6973,445,eur,mic_nongavi
mne,Montenegro,2013,dtp1,98,7418,7270,148,eur,mic_nongavi
mne,Montenegro,2013,mcv1,88,7418,6528,890,eur,mic_nongavi
mne,Montenegro,2013,mcv2,94,7901,7427,474,eur,mic_nongavi
mne,Montenegro,2014,dtp3,91,7308,6650,658,eur,mic_nongavi
mne,Montenegro,2014,mcv1,76,7308,5554,1754,eur,mic_nongavi
mne,Montenegro,2014,dtp1,97,7308,7089,219,eur,mic_nongavi
mne,Montenegro,2014,mcv2,95,7913,7517,396,eur,mic_nongavi
mne,Montenegro,2015,dtp3,89,7209,6416,793,eur,mic_nongavi
mne,Montenegro,2015,mcv1,64,7209,4614,2595,eur,mic_nongavi
mne,Montenegro,2015,dtp1,96,7209,6921,288,eur,mic_nongavi
mne,Montenegro,2015,mcv2,94,7891,7418,473,eur,mic_nongavi
mne,Montenegro,2016,dtp1,97,7120,6906,214,eur,mic_nongavi
mne,Montenegro,2016,dtp3,89,7120,6337,783,eur,mic_nongavi
mne,Montenegro,2016,mcv1,47,7120,3346,3774,eur,mic_nongavi
mne,Montenegro,2016,mcv2,86,7831,6735,1096,eur,mic_nongavi
mng,Mongolia,2000,dtp1,95,44193,41983,2210,wpr,gavi
mng,Mongolia,2000,mcv1,92,44193,40658,3535,wpr,gavi
mng,Mongolia,2000,dtp3,94,44193,41541,2652,wpr,gavi
mng,Mongolia,2000,mcv2,75,46061,34546,11515,wpr,gavi
mng,Mongolia,2001,dtp1,95,44029,41828,2201,wpr,gavi
mng,Mongolia,2001,mcv1,95,44029,41828,2201,wpr,gavi
mng,Mongolia,2001,dtp3,95,44029,41828,2201,wpr,gavi
mng,Mongolia,2001,mcv2,95,45432,43160,2272,wpr,gavi
mng,Mongolia,2002,dtp1,99,44462,44017,445,wpr,gavi
mng,Mongolia,2002,dtp3,98,44462,43573,889,wpr,gavi
mng,Mongolia,2002,mcv1,98,44462,43573,889,wpr,gavi
mng,Mongolia,2002,mcv2,96,45166,43359,1807,wpr,gavi
mng,Mongolia,2003,dtp1,98,45480,44570,910,wpr,gavi
mng,Mongolia,2003,dtp3,98,45480,44570,910,wpr,gavi
mng,Mongolia,2003,mcv1,98,45480,44570,910,wpr,gavi
mng,Mongolia,2003,mcv2,98,42917,42059,858,wpr,gavi
mng,Mongolia,2004,dtp1,99,47057,46586,471,wpr,gavi
mng,Mongolia,2004,dtp3,99,47057,46586,471,wpr,gavi
mng,Mongolia,2004,mcv1,99,47057,46586,471,wpr,gavi
mng,Mongolia,2004,mcv2,98,43019,42159,860,wpr,gavi
mng,Mongolia,2005,dtp3,99,49212,48720,492,wpr,gavi
mng,Mongolia,2005,dtp1,99,49212,48720,492,wpr,gavi
mng,Mongolia,2005,mcv1,97,49212,47736,1476,wpr,gavi
mng,Mongolia,2005,mcv2,98,43716,42842,874,wpr,gavi
mng,Mongolia,2006,mcv1,99,51959,51439,520,wpr,gavi
mng,Mongolia,2006,dtp3,99,51959,51439,520,wpr,gavi
mng,Mongolia,2006,dtp1,99,51959,51439,520,wpr,gavi
mng,Mongolia,2006,mcv2,96,44740,42950,1790,wpr,gavi
mng,Mongolia,2007,mcv1,98,55172,54069,1103,wpr,gavi
mng,Mongolia,2007,dtp3,95,55172,52413,2759,wpr,gavi
mng,Mongolia,2007,dtp1,95,55172,52413,2759,wpr,gavi
mng,Mongolia,2007,mcv2,97,46340,44950,1390,wpr,gavi
mng,Mongolia,2008,dtp3,96,58659,56313,2346,wpr,gavi
mng,Mongolia,2008,dtp1,98,58659,57486,1173,wpr,gavi
mng,Mongolia,2008,mcv1,97,58659,56899,1760,wpr,gavi
mng,Mongolia,2008,mcv2,96,49132,47167,1965,wpr,gavi
mng,Mongolia,2009,dtp3,95,62204,59094,3110,wpr,gavi
mng,Mongolia,2009,dtp1,95,62204,59094,3110,wpr,gavi
mng,Mongolia,2009,mcv1,94,62204,58472,3732,wpr,gavi
mng,Mongolia,2009,mcv2,97,51944,50386,1558,wpr,gavi
mng,Mongolia,2010,dtp1,98,65512,64202,1310,wpr,gavi
mng,Mongolia,2010,mcv1,97,65512,63547,1965,wpr,gavi
mng,Mongolia,2010,dtp3,96,65512,62892,2620,wpr,gavi
mng,Mongolia,2010,mcv2,95,55186,52427,2759,wpr,gavi
mng,Mongolia,2011,dtp1,99,68285,67602,683,wpr,gavi
mng,Mongolia,2011,mcv1,98,68285,66919,1366,wpr,gavi
mng,Mongolia,2011,dtp3,99,68285,67602,683,wpr,gavi
mng,Mongolia,2011,mcv2,98,59668,58475,1193,wpr,gavi
mng,Mongolia,2012,mcv1,99,70352,69648,704,wpr,gavi
mng,Mongolia,2012,dtp3,99,70352,69648,704,wpr,gavi
mng,Mongolia,2012,dtp1,99,70352,69648,704,wpr,gavi
mng,Mongolia,2012,mcv2,98,64197,62913,1284,wpr,gavi
mng,Mongolia,2013,mcv1,97,71620,69471,2149,wpr,gavi
mng,Mongolia,2013,dtp3,98,71620,70188,1432,wpr,gavi
mng,Mongolia,2013,dtp1,98,71620,70188,1432,wpr,gavi
mng,Mongolia,2013,mcv2,97,66613,64615,1998,wpr,gavi
mng,Mongolia,2014,mcv1,98,72053,70612,1441,wpr,gavi
mng,Mongolia,2014,dtp3,99,72053,71332,721,wpr,gavi
mng,Mongolia,2014,dtp1,99,72053,71332,721,wpr,gavi
mng,Mongolia,2014,mcv2,98,69831,68434,1397,wpr,gavi
mng,Mongolia,2015,dtp1,99,71705,70988,717,wpr,gavi
mng,Mongolia,2015,dtp3,99,71705,70988,717,wpr,gavi
mng,Mongolia,2015,mcv1,98,71705,70271,1434,wpr,gavi
mng,Mongolia,2015,mcv2,98,72032,70591,1441,wpr,gavi
mng,Mongolia,2016,mcv1,98,70725,69310,1415,wpr,gavi
mng,Mongolia,2016,dtp3,99,70725,70018,707,wpr,gavi
mng,Mongolia,2016,dtp1,99,70725,70018,707,wpr,gavi
mng,Mongolia,2016,mcv2,90,74704,67234,7470,wpr,gavi
moz,Mozambique,2000,dtp3,70,732639,512847,219792,afr,gavi
moz,Mozambique,2000,dtp1,84,732639,615417,117222,afr,gavi
moz,Mozambique,2000,mcv1,71,732639,520174,212465,afr,gavi
moz,Mozambique,2001,dtp3,73,753493,550050,203443,afr,gavi
moz,Mozambique,2001,dtp1,86,753493,648004,105489,afr,gavi
moz,Mozambique,2001,mcv1,74,753493,557585,195908,afr,gavi
moz,Mozambique,2002,dtp1,88,774111,681218,92893,afr,gavi
moz,Mozambique,2002,mcv1,77,774111,596065,178046,afr,gavi
moz,Mozambique,2002,dtp3,76,774111,588324,185787,afr,gavi
moz,Mozambique,2003,mcv1,80,794597,635678,158919,afr,gavi
moz,Mozambique,2003,dtp1,89,794597,707191,87406,afr,gavi
moz,Mozambique,2003,dtp3,85,794597,675407,119190,afr,gavi
moz,Mozambique,2004,mcv1,79,814943,643805,171138,afr,gavi
moz,Mozambique,2004,dtp1,88,814943,717150,97793,afr,gavi
moz,Mozambique,2004,dtp3,83,814943,676403,138540,afr,gavi
moz,Mozambique,2005,dtp1,87,835154,726584,108570,afr,gavi
moz,Mozambique,2005,dtp3,80,835154,668123,167031,afr,gavi
moz,Mozambique,2005,mcv1,78,835154,651420,183734,afr,gavi
moz,Mozambique,2006,dtp1,86,855249,735514,119735,afr,gavi
moz,Mozambique,2006,mcv1,76,855249,649989,205260,afr,gavi
moz,Mozambique,2006,dtp3,78,855249,667094,188155,afr,gavi
moz,Mozambique,2007,dtp3,75,875259,656444,218815,afr,gavi
moz,Mozambique,2007,dtp1,85,875259,743970,131289,afr,gavi
moz,Mozambique,2007,mcv1,75,875259,656444,218815,afr,gavi
moz,Mozambique,2008,dtp3,75,895212,671409,223803,afr,gavi
moz,Mozambique,2008,dtp1,87,895212,778834,116378,afr,gavi
moz,Mozambique,2008,mcv1,77,895212,689313,205899,afr,gavi
moz,Mozambique,2009,dtp1,89,915123,814459,100664,afr,gavi
moz,Mozambique,2009,mcv1,80,915123,732098,183025,afr,gavi
moz,Mozambique,2009,dtp3,74,915123,677191,237932,afr,gavi
moz,Mozambique,2010,dtp1,91,934944,850799,84145,afr,gavi
moz,Mozambique,2010,mcv1,82,934944,766654,168290,afr,gavi
moz,Mozambique,2010,dtp3,74,934944,691859,243085,afr,gavi
moz,Mozambique,2011,mcv1,82,954601,782773,171828,afr,gavi
moz,Mozambique,2011,dtp3,76,954601,725497,229104,afr,gavi
moz,Mozambique,2011,dtp1,91,954601,868687,85914,afr,gavi
moz,Mozambique,2012,dtp3,76,974090,740308,233782,afr,gavi
moz,Mozambique,2012,dtp1,91,974090,886422,87668,afr,gavi
moz,Mozambique,2012,mcv1,82,974090,798754,175336,afr,gavi
moz,Mozambique,2013,dtp3,78,993472,774908,218564,afr,gavi
moz,Mozambique,2013,dtp1,93,993472,923929,69543,afr,gavi
moz,Mozambique,2013,mcv1,85,993472,844451,149021,afr,gavi
moz,Mozambique,2014,dtp3,79,1012853,800154,212699,afr,gavi
moz,Mozambique,2014,mcv1,85,1012853,860925,151928,afr,gavi
moz,Mozambique,2014,dtp1,92,1012853,931825,81028,afr,gavi
moz,Mozambique,2015,dtp3,80,1032424,825939,206485,afr,gavi
moz,Mozambique,2015,dtp1,90,1032424,929182,103242,afr,gavi
moz,Mozambique,2015,mcv1,85,1032424,877560,154864,afr,gavi
moz,Mozambique,2016,dtp3,80,1052399,841919,210480,afr,gavi
moz,Mozambique,2016,dtp1,90,1052399,947159,105240,afr,gavi
moz,Mozambique,2016,mcv1,91,1052399,957683,94716,afr,gavi
moz,Mozambique,2016,mcv2,51,989538,504664,484874,afr,gavi
mrt,Mauritania,2000,dtp3,51,96258,49092,47166,afr,gavi
mrt,Mauritania,2000,dtp1,73,96258,70268,25990,afr,gavi
mrt,Mauritania,2000,mcv1,46,96258,44279,51979,afr,gavi
mrt,Mauritania,2001,dtp1,76,98529,74882,23647,afr,gavi
mrt,Mauritania,2001,mcv1,58,98529,57147,41382,afr,gavi
mrt,Mauritania,2001,dtp3,75,98529,73897,24632,afr,gavi
mrt,Mauritania,2002,dtp1,96,100850,96816,4034,afr,gavi
mrt,Mauritania,2002,dtp3,89,100850,89756,11094,afr,gavi
mrt,Mauritania,2002,mcv1,87,100850,87740,13110,afr,gavi
mrt,Mauritania,2003,dtp3,76,103223,78449,24774,afr,gavi
mrt,Mauritania,2003,dtp1,91,103223,93933,9290,afr,gavi
mrt,Mauritania,2003,mcv1,84,103223,86707,16516,afr,gavi
mrt,Mauritania,2004,dtp1,83,105653,87692,17961,afr,gavi
mrt,Mauritania,2004,dtp3,70,105653,73957,31696,afr,gavi
mrt,Mauritania,2004,mcv1,73,105653,77127,28526,afr,gavi
mrt,Mauritania,2005,mcv1,65,108157,70302,37855,afr,gavi
mrt,Mauritania,2005,dtp1,85,108157,91933,16224,afr,gavi
mrt,Mauritania,2005,dtp3,71,108157,76791,31366,afr,gavi
mrt,Mauritania,2006,dtp1,85,110761,94147,16614,afr,gavi
mrt,Mauritania,2006,mcv1,62,110761,68672,42089,afr,gavi
mrt,Mauritania,2006,dtp3,68,110761,75317,35444,afr,gavi
mrt,Mauritania,2007,dtp1,92,113465,104388,9077,afr,gavi
mrt,Mauritania,2007,mcv1,67,113465,76022,37443,afr,gavi
mrt,Mauritania,2007,dtp3,75,113465,85099,28366,afr,gavi
mrt,Mauritania,2008,dtp1,88,116255,102304,13951,afr,gavi
mrt,Mauritania,2008,mcv1,65,116255,75566,40689,afr,gavi
mrt,Mauritania,2008,dtp3,74,116255,86029,30226,afr,gavi
mrt,Mauritania,2009,dtp1,79,119104,94092,25012,afr,gavi
mrt,Mauritania,2009,mcv1,59,119104,70271,48833,afr,gavi
mrt,Mauritania,2009,dtp3,64,119104,76227,42877,afr,gavi
mrt,Mauritania,2010,dtp1,82,121970,100015,21955,afr,gavi
mrt,Mauritania,2010,mcv1,67,121970,81720,40250,afr,gavi
mrt,Mauritania,2010,dtp3,64,121970,78061,43909,afr,gavi
mrt,Mauritania,2011,dtp1,91,124801,113569,11232,afr,gavi
mrt,Mauritania,2011,dtp3,75,124801,93601,31200,afr,gavi
mrt,Mauritania,2011,mcv1,67,124801,83617,41184,afr,gavi
mrt,Mauritania,2012,dtp1,95,127554,121176,6378,afr,gavi
mrt,Mauritania,2012,dtp3,80,127554,102043,25511,afr,gavi
mrt,Mauritania,2012,mcv1,75,127554,95666,31888,afr,gavi
mrt,Mauritania,2013,dtp3,80,130197,104158,26039,afr,gavi
mrt,Mauritania,2013,mcv1,80,130197,104158,26039,afr,gavi
mrt,Mauritania,2013,dtp1,95,130197,123687,6510,afr,gavi
mrt,Mauritania,2014,dtp3,84,132714,111480,21234,afr,gavi
mrt,Mauritania,2014,dtp1,88,132714,116788,15926,afr,gavi
mrt,Mauritania,2014,mcv1,84,132714,111480,21234,afr,gavi
mrt,Mauritania,2015,dtp3,73,135102,98624,36478,afr,gavi
mrt,Mauritania,2015,mcv1,70,135102,94571,40531,afr,gavi
mrt,Mauritania,2015,dtp1,87,135102,117539,17563,afr,gavi
mrt,Mauritania,2016,dtp1,87,137377,119518,17859,afr,gavi
mrt,Mauritania,2016,dtp3,73,137377,100285,37092,afr,gavi
mrt,Mauritania,2016,mcv1,70,137377,96164,41213,afr,gavi
mus,Mauritius,2000,dtp3,88,19759,17388,2371,afr,mic_nongavi
mus,Mauritius,2000,mcv1,84,19759,16598,3161,afr,mic_nongavi
mus,Mauritius,2000,dtp1,88,19759,17388,2371,afr,mic_nongavi
mus,Mauritius,2001,dtp3,92,19458,17901,1557,afr,mic_nongavi
mus,Mauritius,2001,dtp1,92,19458,17901,1557,afr,mic_nongavi
mus,Mauritius,2001,mcv1,90,19458,17512,1946,afr,mic_nongavi
mus,Mauritius,2002,dtp1,96,19108,18344,764,afr,mic_nongavi
mus,Mauritius,2002,dtp3,88,19108,16815,2293,afr,mic_nongavi
mus,Mauritius,2002,mcv1,84,19108,16051,3057,afr,mic_nongavi
mus,Mauritius,2003,dtp1,99,18693,18506,187,afr,mic_nongavi
mus,Mauritius,2003,dtp3,99,18693,18506,187,afr,mic_nongavi
mus,Mauritius,2003,mcv1,91,18693,17011,1682,afr,mic_nongavi
mus,Mauritius,2004,dtp1,98,18213,17849,364,afr,mic_nongavi
mus,Mauritius,2004,mcv1,98,18213,17849,364,afr,mic_nongavi
mus,Mauritius,2004,dtp3,98,18213,17849,364,afr,mic_nongavi
mus,Mauritius,2004,mcv2,80,19730,15784,3946,afr,mic_nongavi
mus,Mauritius,2005,dtp3,97,17673,17143,530,afr,mic_nongavi
mus,Mauritius,2005,dtp1,99,17673,17496,177,afr,mic_nongavi
mus,Mauritius,2005,mcv1,98,17673,17320,353,afr,mic_nongavi
mus,Mauritius,2005,mcv2,78,18743,14620,4123,afr,mic_nongavi
mus,Mauritius,2006,dtp3,97,17089,16576,513,afr,mic_nongavi
mus,Mauritius,2006,dtp1,99,17089,16918,171,afr,mic_nongavi
mus,Mauritius,2006,mcv1,99,17089,16918,171,afr,mic_nongavi
mus,Mauritius,2006,mcv2,85,18648,15851,2797,afr,mic_nongavi
mus,Mauritius,2007,dtp1,97,16484,15989,495,afr,mic_nongavi
mus,Mauritius,2007,dtp3,97,16484,15989,495,afr,mic_nongavi
mus,Mauritius,2007,mcv1,98,16484,16154,330,afr,mic_nongavi
mus,Mauritius,2007,mcv2,80,18751,15001,3750,afr,mic_nongavi
mus,Mauritius,2008,dtp1,99,15889,15730,159,afr,mic_nongavi
mus,Mauritius,2008,dtp3,99,15889,15730,159,afr,mic_nongavi
mus,Mauritius,2008,mcv1,98,15889,15571,318,afr,mic_nongavi
mus,Mauritius,2008,mcv2,83,18898,15685,3213,afr,mic_nongavi
mus,Mauritius,2009,dtp1,99,15324,15171,153,afr,mic_nongavi
mus,Mauritius,2009,mcv1,99,15324,15171,153,afr,mic_nongavi
mus,Mauritius,2009,dtp3,99,15324,15171,153,afr,mic_nongavi
mus,Mauritius,2009,mcv2,85,18864,16034,2830,afr,mic_nongavi
mus,Mauritius,2010,dtp1,99,14812,14664,148,afr,mic_nongavi
mus,Mauritius,2010,mcv1,99,14812,14664,148,afr,mic_nongavi
mus,Mauritius,2010,dtp3,99,14812,14664,148,afr,mic_nongavi
mus,Mauritius,2010,mcv2,90,18384,16546,1838,afr,mic_nongavi
mus,Mauritius,2011,dtp3,98,14372,14085,287,afr,mic_nongavi
mus,Mauritius,2011,mcv1,99,14372,14228,144,afr,mic_nongavi
mus,Mauritius,2011,dtp1,99,14372,14228,144,afr,mic_nongavi
mus,Mauritius,2011,mcv2,89,17794,15837,1957,afr,mic_nongavi
mus,Mauritius,2012,dtp3,98,14005,13725,280,afr,mic_nongavi
mus,Mauritius,2012,dtp1,99,14005,13865,140,afr,mic_nongavi
mus,Mauritius,2012,mcv1,99,14005,13865,140,afr,mic_nongavi
mus,Mauritius,2012,mcv2,90,17039,15335,1704,afr,mic_nongavi
mus,Mauritius,2013,dtp3,98,13710,13436,274,afr,mic_nongavi
mus,Mauritius,2013,dtp1,99,13710,13573,137,afr,mic_nongavi
mus,Mauritius,2013,mcv1,99,13710,13573,137,afr,mic_nongavi
mus,Mauritius,2013,mcv2,85,16208,13777,2431,afr,mic_nongavi
mus,Mauritius,2014,dtp3,97,13490,13085,405,afr,mic_nongavi
mus,Mauritius,2014,dtp1,97,13490,13085,405,afr,mic_nongavi
mus,Mauritius,2014,mcv1,98,13490,13220,270,afr,mic_nongavi
mus,Mauritius,2014,mcv2,85,15433,13118,2315,afr,mic_nongavi
mus,Mauritius,2015,dtp3,97,13340,12940,400,afr,mic_nongavi
mus,Mauritius,2015,dtp1,98,13340,13073,267,afr,mic_nongavi
mus,Mauritius,2015,mcv1,99,13340,13207,133,afr,mic_nongavi
mus,Mauritius,2015,mcv2,96,14874,14279,595,afr,mic_nongavi
mus,Mauritius,2016,dtp3,96,13251,12721,530,afr,mic_nongavi
mus,Mauritius,2016,dtp1,97,13251,12853,398,afr,mic_nongavi
mus,Mauritius,2016,mcv1,92,13251,12191,1060,afr,mic_nongavi
mus,Mauritius,2016,mcv2,92,14378,13228,1150,afr,mic_nongavi
mwi,Malawi,2000,dtp1,98,449117,440135,8982,afr,gavi
mwi,Malawi,2000,dtp3,75,449117,336838,112279,afr,gavi
mwi,Malawi,2000,mcv1,73,449117,327855,121262,afr,gavi
mwi,Malawi,2001,dtp3,90,460383,414345,46038,afr,gavi
mwi,Malawi,2001,dtp1,99,460383,455779,4604,afr,gavi
mwi,Malawi,2001,mcv1,81,460383,372910,87473,afr,gavi
mwi,Malawi,2002,mcv1,69,473035,326394,146641,afr,gavi
mwi,Malawi,2002,dtp3,64,473035,302742,170293,afr,gavi
mwi,Malawi,2002,dtp1,94,473035,444653,28382,afr,gavi
mwi,Malawi,2003,dtp1,99,486780,481912,4868,afr,gavi
mwi,Malawi,2003,mcv1,77,486780,374821,111959,afr,gavi
mwi,Malawi,2003,dtp3,84,486780,408895,77885,afr,gavi
mwi,Malawi,2004,dtp1,99,501230,496218,5012,afr,gavi
mwi,Malawi,2004,mcv1,80,501230,400984,100246,afr,gavi
mwi,Malawi,2004,dtp3,89,501230,446095,55135,afr,gavi
mwi,Malawi,2005,dtp3,93,515623,479529,36094,afr,gavi
mwi,Malawi,2005,dtp1,99,515623,510467,5156,afr,gavi
mwi,Malawi,2005,mcv1,82,515623,422811,92812,afr,gavi
mwi,Malawi,2006,mcv1,85,529068,449708,79360,afr,gavi
mwi,Malawi,2006,dtp1,99,529068,523777,5291,afr,gavi
mwi,Malawi,2006,dtp3,99,529068,523777,5291,afr,gavi
mwi,Malawi,2007,dtp3,87,541006,470675,70331,afr,gavi
mwi,Malawi,2007,dtp1,96,541006,519366,21640,afr,gavi
mwi,Malawi,2007,mcv1,83,541006,449035,91971,afr,gavi
mwi,Malawi,2008,dtp3,91,551193,501586,49607,afr,gavi
mwi,Malawi,2008,dtp1,97,551193,534657,16536,afr,gavi
mwi,Malawi,2008,mcv1,88,551193,485050,66143,afr,gavi
mwi,Malawi,2009,dtp1,97,559703,542912,16791,afr,gavi
mwi,Malawi,2009,mcv1,92,559703,514927,44776,afr,gavi
mwi,Malawi,2009,dtp3,93,559703,520524,39179,afr,gavi
mwi,Malawi,2010,dtp3,93,567038,527345,39693,afr,gavi
mwi,Malawi,2010,dtp1,97,567038,550027,17011,afr,gavi
mwi,Malawi,2010,mcv1,93,567038,527345,39693,afr,gavi
mwi,Malawi,2011,mcv1,96,574016,551055,22961,afr,gavi
mwi,Malawi,2011,dtp3,97,574016,556796,17220,afr,gavi
mwi,Malawi,2011,dtp1,98,574016,562536,11480,afr,gavi
mwi,Malawi,2012,dtp3,96,581573,558310,23263,afr,gavi
mwi,Malawi,2012,mcv1,90,581573,523416,58157,afr,gavi
mwi,Malawi,2012,dtp1,99,581573,575757,5816,afr,gavi
mwi,Malawi,2013,dtp3,89,590403,525459,64944,afr,gavi
mwi,Malawi,2013,mcv1,88,590403,519555,70848,afr,gavi
mwi,Malawi,2013,dtp1,96,590403,566787,23616,afr,gavi
mwi,Malawi,2014,dtp3,91,600748,546681,54067,afr,gavi
mwi,Malawi,2014,dtp1,97,600748,582726,18022,afr,gavi
mwi,Malawi,2014,mcv1,85,600748,510636,90112,afr,gavi
mwi,Malawi,2015,mcv1,87,612599,532961,79638,afr,gavi
mwi,Malawi,2015,dtp3,88,612599,539087,73512,afr,gavi
mwi,Malawi,2015,dtp1,93,612599,569717,42882,afr,gavi
mwi,Malawi,2015,mcv2,8,581326,46506,534820,afr,gavi
mwi,Malawi,2016,dtp3,84,625660,525554,100106,afr,gavi
mwi,Malawi,2016,dtp1,89,625660,556837,68823,afr,gavi
mwi,Malawi,2016,mcv1,81,625660,506785,118875,afr,gavi
mwi,Malawi,2016,mcv2,61,580957,354384,226573,afr,gavi
mys,Malaysia,2000,dtp1,99,503410,498376,5034,wpr,mic_nongavi
mys,Malaysia,2000,mcv1,96,503410,483274,20136,wpr,mic_nongavi
mys,Malaysia,2000,dtp3,98,503410,493342,10068,wpr,mic_nongavi
mys,Malaysia,2001,dtp1,98,491571,481740,9831,wpr,mic_nongavi
mys,Malaysia,2001,dtp3,96,491571,471908,19663,wpr,mic_nongavi
mys,Malaysia,2001,mcv1,95,491571,466992,24579,wpr,mic_nongavi
mys,Malaysia,2002,mcv1,94,480725,451882,28843,wpr,mic_nongavi
mys,Malaysia,2002,dtp3,94,480725,451882,28843,wpr,mic_nongavi
mys,Malaysia,2002,dtp1,98,480725,471110,9615,wpr,mic_nongavi
mys,Malaysia,2003,mcv1,93,472095,439048,33047,wpr,mic_nongavi
mys,Malaysia,2003,dtp1,98,472095,462653,9442,wpr,mic_nongavi
mys,Malaysia,2003,dtp3,96,472095,453211,18884,wpr,mic_nongavi
mys,Malaysia,2004,mcv1,95,466367,443049,23318,wpr,mic_nongavi
mys,Malaysia,2004,dtp3,95,466367,443049,23318,wpr,mic_nongavi
mys,Malaysia,2004,dtp1,98,466367,457040,9327,wpr,mic_nongavi
mys,Malaysia,2005,dtp1,98,463896,454618,9278,wpr,mic_nongavi
mys,Malaysia,2005,dtp3,96,463896,445340,18556,wpr,mic_nongavi
mys,Malaysia,2005,mcv1,96,463896,445340,18556,wpr,mic_nongavi
mys,Malaysia,2005,mcv2,91,542156,493362,48794,wpr,mic_nongavi
mys,Malaysia,2006,dtp3,95,464551,441323,23228,wpr,mic_nongavi
mys,Malaysia,2006,mcv1,95,464551,441323,23228,wpr,mic_nongavi
mys,Malaysia,2006,dtp1,98,464551,455260,9291,wpr,mic_nongavi
mys,Malaysia,2006,mcv2,90,546306,491675,54631,wpr,mic_nongavi
mys,Malaysia,2007,dtp1,99,467444,462770,4674,wpr,mic_nongavi
mys,Malaysia,2007,dtp3,97,467444,453421,14023,wpr,mic_nongavi
mys,Malaysia,2007,mcv1,95,467444,444072,23372,wpr,mic_nongavi
mys,Malaysia,2007,mcv2,92,544951,501355,43596,wpr,mic_nongavi
mys,Malaysia,2008,dtp3,97,471758,457605,14153,wpr,mic_nongavi
mys,Malaysia,2008,mcv1,95,471758,448170,23588,wpr,mic_nongavi
mys,Malaysia,2008,dtp1,99,471758,467040,4718,wpr,mic_nongavi
mys,Malaysia,2008,mcv2,97,539793,523599,16194,wpr,mic_nongavi
mys,Malaysia,2009,dtp3,97,477131,462817,14314,wpr,mic_nongavi
mys,Malaysia,2009,dtp1,99,477131,472360,4771,wpr,mic_nongavi
mys,Malaysia,2009,mcv1,95,477131,453274,23857,wpr,mic_nongavi
mys,Malaysia,2009,mcv2,95,532873,506229,26644,wpr,mic_nongavi
mys,Malaysia,2010,dtp1,98,483321,473655,9666,wpr,mic_nongavi
mys,Malaysia,2010,dtp3,96,483321,463988,19333,wpr,mic_nongavi
mys,Malaysia,2010,mcv1,95,483321,459155,24166,wpr,mic_nongavi
mys,Malaysia,2010,mcv2,95,526363,500045,26318,wpr,mic_nongavi
mys,Malaysia,2011,dtp1,98,490204,480400,9804,wpr,mic_nongavi
mys,Malaysia,2011,dtp3,96,490204,470596,19608,wpr,mic_nongavi
mys,Malaysia,2011,mcv1,95,490204,465694,24510,wpr,mic_nongavi
mys,Malaysia,2011,mcv2,95,517642,491760,25882,wpr,mic_nongavi
mys,Malaysia,2012,dtp3,97,497666,482736,14930,wpr,mic_nongavi
mys,Malaysia,2012,dtp1,99,497666,492689,4977,wpr,mic_nongavi
mys,Malaysia,2012,mcv1,95,497666,472783,24883,wpr,mic_nongavi
mys,Malaysia,2012,mcv2,99,509444,504350,5094,wpr,mic_nongavi
mys,Malaysia,2013,dtp1,99,505478,500423,5055,wpr,mic_nongavi
mys,Malaysia,2013,dtp3,97,505478,490314,15164,wpr,mic_nongavi
mys,Malaysia,2013,mcv1,95,505478,480204,25274,wpr,mic_nongavi
mys,Malaysia,2013,mcv2,99,502464,497439,5025,wpr,mic_nongavi
mys,Malaysia,2014,dtp3,97,513290,497891,15399,wpr,mic_nongavi
mys,Malaysia,2014,mcv1,93,513290,477360,35930,wpr,mic_nongavi
mys,Malaysia,2014,dtp1,99,513290,508157,5133,wpr,mic_nongavi
mys,Malaysia,2014,mcv2,99,497478,492503,4975,wpr,mic_nongavi
mys,Malaysia,2015,dtp3,99,520770,515562,5208,wpr,mic_nongavi
mys,Malaysia,2015,mcv1,93,520770,484316,36454,wpr,mic_nongavi
mys,Malaysia,2015,dtp1,99,520770,515562,5208,wpr,mic_nongavi
mys,Malaysia,2015,mcv2,99,495423,490469,4954,wpr,mic_nongavi
mys,Malaysia,2016,dtp1,99,527655,522378,5277,wpr,mic_nongavi
mys,Malaysia,2016,dtp3,98,527655,517102,10553,wpr,mic_nongavi
mys,Malaysia,2016,mcv1,96,527655,506549,21106,wpr,mic_nongavi
mys,Malaysia,2016,mcv2,99,495521,490566,4955,wpr,mic_nongavi
nam,Namibia,2000,mcv1,69,55959,38612,17347,afr,mic_nongavi
nam,Namibia,2000,dtp1,90,55959,50363,5596,afr,mic_nongavi
nam,Namibia,2000,dtp3,79,55959,44208,11751,afr,mic_nongavi
nam,Namibia,2001,dtp1,88,56102,49370,6732,afr,mic_nongavi
nam,Namibia,2001,mcv1,58,56102,32539,23563,afr,mic_nongavi
nam,Namibia,2001,dtp3,78,56102,43760,12342,afr,mic_nongavi
nam,Namibia,2002,dtp3,77,56267,43326,12941,afr,mic_nongavi
nam,Namibia,2002,mcv1,68,56267,38262,18005,afr,mic_nongavi
nam,Namibia,2002,dtp1,86,56267,48390,7877,afr,mic_nongavi
nam,Namibia,2003,dtp3,79,56487,44625,11862,afr,mic_nongavi
nam,Namibia,2003,dtp1,87,56487,49144,7343,afr,mic_nongavi
nam,Namibia,2003,mcv1,70,56487,39541,16946,afr,mic_nongavi
nam,Namibia,2004,mcv1,70,56802,39761,17041,afr,mic_nongavi
nam,Namibia,2004,dtp1,88,56802,49986,6816,afr,mic_nongavi
nam,Namibia,2004,dtp3,81,56802,46010,10792,afr,mic_nongavi
nam,Namibia,2005,mcv1,73,57288,41820,15468,afr,mic_nongavi
nam,Namibia,2005,dtp3,86,57288,49268,8020,afr,mic_nongavi
nam,Namibia,2005,dtp1,93,57288,53278,4010,afr,mic_nongavi
nam,Namibia,2006,mcv1,63,58019,36552,21467,afr,mic_nongavi
nam,Namibia,2006,dtp1,91,58019,52797,5222,afr,mic_nongavi
nam,Namibia,2006,dtp3,86,58019,49896,8123,afr,mic_nongavi
nam,Namibia,2007,mcv1,69,59009,40716,18293,afr,mic_nongavi
nam,Namibia,2007,dtp3,86,59009,50748,8261,afr,mic_nongavi
nam,Namibia,2007,dtp1,88,59009,51928,7081,afr,mic_nongavi
nam,Namibia,2008,dtp1,88,60235,53007,7228,afr,mic_nongavi
nam,Namibia,2008,mcv1,73,60235,43972,16263,afr,mic_nongavi
nam,Namibia,2008,dtp3,83,60235,49995,10240,afr,mic_nongavi
nam,Namibia,2009,mcv1,76,61655,46858,14797,afr,mic_nongavi
nam,Namibia,2009,dtp1,87,61655,53640,8015,afr,mic_nongavi
nam,Namibia,2009,dtp3,83,61655,51174,10481,afr,mic_nongavi
nam,Namibia,2010,mcv1,75,63189,47392,15797,afr,mic_nongavi
nam,Namibia,2010,dtp1,87,63189,54974,8215,afr,mic_nongavi
nam,Namibia,2010,dtp3,83,63189,52447,10742,afr,mic_nongavi
nam,Namibia,2011,mcv1,74,64731,47901,16830,afr,mic_nongavi
nam,Namibia,2011,dtp1,88,64731,56963,7768,afr,mic_nongavi
nam,Namibia,2011,dtp3,82,64731,53079,11652,afr,mic_nongavi
nam,Namibia,2012,dtp1,89,66175,58896,7279,afr,mic_nongavi
nam,Namibia,2012,mcv1,76,66175,50293,15882,afr,mic_nongavi
nam,Namibia,2012,dtp3,84,66175,55587,10588,afr,mic_nongavi
nam,Namibia,2013,dtp3,89,67441,60022,7419,afr,mic_nongavi
nam,Namibia,2013,dtp1,94,67441,63395,4046,afr,mic_nongavi
nam,Namibia,2013,mcv1,82,67441,55302,12139,afr,mic_nongavi
nam,Namibia,2014,dtp1,92,68488,63009,5479,afr,mic_nongavi
nam,Namibia,2014,dtp3,88,68488,60269,8219,afr,mic_nongavi
nam,Namibia,2014,mcv1,83,68488,56845,11643,afr,mic_nongavi
nam,Namibia,2015,dtp1,98,69306,67920,1386,afr,mic_nongavi
nam,Namibia,2015,dtp3,92,69306,63762,5544,afr,mic_nongavi
nam,Namibia,2015,mcv1,85,69306,58910,10396,afr,mic_nongavi
nam,Namibia,2016,mcv1,85,69922,59434,10488,afr,mic_nongavi
nam,Namibia,2016,dtp3,92,69922,64328,5594,afr,mic_nongavi
nam,Namibia,2016,dtp1,98,69922,68524,1398,afr,mic_nongavi
ner,Niger,2000,dtp3,34,551412,187480,363932,afr,gavi
ner,Niger,2000,dtp1,46,551412,253650,297762,afr,gavi
ner,Niger,2000,mcv1,37,551412,204022,347390,afr,gavi
ner,Niger,2001,mcv1,39,570405,222458,347947,afr,gavi
ner,Niger,2001,dtp1,48,570405,273794,296611,afr,gavi
ner,Niger,2001,dtp3,36,570405,205346,365059,afr,gavi
ner,Niger,2002,dtp3,39,589767,230009,359758,afr,gavi
ner,Niger,2002,mcv1,41,589767,241804,347963,afr,gavi
ner,Niger,2002,dtp1,51,589767,300781,288986,afr,gavi
ner,Niger,2003,dtp3,41,609617,249943,359674,afr,gavi
ner,Niger,2003,dtp1,53,609617,323097,286520,afr,gavi
ner,Niger,2003,mcv1,43,609617,262135,347482,afr,gavi
ner,Niger,2004,dtp1,56,630035,352820,277215,afr,gavi
ner,Niger,2004,dtp3,43,630035,270915,359120,afr,gavi
ner,Niger,2004,mcv1,45,630035,283516,346519,afr,gavi
ner,Niger,2005,dtp1,58,651078,377625,273453,afr,gavi
ner,Niger,2005,dtp3,45,651078,292985,358093,afr,gavi
ner,Niger,2005,mcv1,47,651078,306007,345071,afr,gavi
ner,Niger,2006,dtp3,51,672791,343123,329668,afr,gavi
ner,Niger,2006,dtp1,63,672791,423858,248933,afr,gavi
ner,Niger,2006,mcv1,53,672791,356579,316212,afr,gavi
ner,Niger,2007,dtp3,57,695220,396275,298945,afr,gavi
ner,Niger,2007,dtp1,68,695220,472750,222470,afr,gavi
ner,Niger,2007,mcv1,60,695220,417132,278088,afr,gavi
ner,Niger,2008,mcv1,66,718430,474164,244266,afr,gavi
ner,Niger,2008,dtp3,67,718430,481348,237082,afr,gavi
ner,Niger,2008,dtp1,76,718430,546007,172423,afr,gavi
ner,Niger,2009,dtp1,81,742500,601425,141075,afr,gavi
ner,Niger,2009,mcv1,69,742500,512325,230175,afr,gavi
ner,Niger,2009,dtp3,71,742500,527175,215325,afr,gavi
ner,Niger,2010,dtp1,83,767507,637031,130476,afr,gavi
ner,Niger,2010,dtp3,70,767507,537255,230252,afr,gavi
ner,Niger,2010,mcv1,67,767507,514230,253277,afr,gavi
ner,Niger,2011,dtp1,86,793509,682418,111091,afr,gavi
ner,Niger,2011,mcv1,69,793509,547521,245988,afr,gavi
ner,Niger,2011,dtp3,75,793509,595132,198377,afr,gavi
ner,Niger,2012,dtp1,87,820525,713857,106668,afr,gavi
ner,Niger,2012,dtp3,71,820525,582573,237952,afr,gavi
ner,Niger,2012,mcv1,75,820525,615394,205131,afr,gavi
ner,Niger,2013,dtp3,67,848571,568543,280028,afr,gavi
ner,Niger,2013,dtp1,87,848571,738257,110314,afr,gavi
ner,Niger,2013,mcv1,76,848571,644914,203657,afr,gavi
ner,Niger,2014,mcv1,72,877676,631927,245749,afr,gavi
ner,Niger,2014,dtp3,68,877676,596820,280856,afr,gavi
ner,Niger,2014,dtp1,89,877676,781132,96544,afr,gavi
ner,Niger,2014,mcv2,3,782098,23463,758635,afr,gavi
ner,Niger,2015,dtp3,65,907871,590116,317755,afr,gavi
ner,Niger,2015,dtp1,85,907871,771690,136181,afr,gavi
ner,Niger,2015,mcv1,73,907871,662746,245125,afr,gavi
ner,Niger,2015,mcv2,16,810707,129713,680994,afr,gavi
ner,Niger,2016,dtp1,87,939175,817082,122093,afr,gavi
ner,Niger,2016,dtp3,67,939175,629247,309928,afr,gavi
ner,Niger,2016,mcv1,74,939175,694990,244185,afr,gavi
ner,Niger,2016,mcv2,37,841720,311436,530284,afr,gavi
nga,Nigeria,2000,dtp3,29,4698899,1362681,3336218,afr,gavi
nga,Nigeria,2000,dtp1,42,4698899,1973538,2725361,afr,gavi
nga,Nigeria,2000,mcv1,33,4698899,1550637,3148262,afr,gavi
nga,Nigeria,2001,dtp1,42,4826916,2027305,2799611,afr,gavi
nga,Nigeria,2001,mcv1,32,4826916,1544613,3282303,afr,gavi
nga,Nigeria,2001,dtp3,27,4826916,1303267,3523649,afr,gavi
nga,Nigeria,2002,dtp3,25,4956673,1239168,3717505,afr,gavi
nga,Nigeria,2002,mcv1,30,4956673,1487002,3469671,afr,gavi
nga,Nigeria,2002,dtp1,43,4956673,2131369,2825304,afr,gavi
nga,Nigeria,2003,dtp1,45,5087306,2289288,2798018,afr,gavi
nga,Nigeria,2003,mcv1,34,5087306,1729684,3357622,afr,gavi
nga,Nigeria,2003,dtp3,29,5087306,1475319,3611987,afr,gavi
nga,Nigeria,2004,dtp1,46,5218206,2400375,2817831,afr,gavi
nga,Nigeria,2004,dtp3,33,5218206,1722008,3496198,afr,gavi
nga,Nigeria,2004,mcv1,37,5218206,1930736,3287470,afr,gavi
nga,Nigeria,2005,dtp1,48,5349589,2567803,2781786,afr,gavi
nga,Nigeria,2005,dtp3,36,5349589,1925852,3423737,afr,gavi
nga,Nigeria,2005,mcv1,41,5349589,2193331,3156258,afr,gavi
nga,Nigeria,2006,dtp3,40,5482237,2192895,3289342,afr,gavi
nga,Nigeria,2006,dtp1,49,5482237,2686296,2795941,afr,gavi
nga,Nigeria,2006,mcv1,44,5482237,2412184,3070053,afr,gavi
nga,Nigeria,2007,dtp1,52,5616727,2920698,2696029,afr,gavi
nga,Nigeria,2007,dtp3,42,5616727,2359025,3257702,afr,gavi
nga,Nigeria,2007,mcv1,41,5616727,2302858,3313869,afr,gavi
nga,Nigeria,2008,dtp1,63,5752954,3624361,2128593,afr,gavi
nga,Nigeria,2008,dtp3,53,5752954,3049066,2703888,afr,gavi
nga,Nigeria,2008,mcv1,53,5752954,3049066,2703888,afr,gavi
nga,Nigeria,2009,mcv1,64,5890025,3769616,2120409,afr,gavi
nga,Nigeria,2009,dtp1,73,5890025,4299718,1590307,afr,gavi
nga,Nigeria,2009,dtp3,63,5890025,3710716,2179309,afr,gavi
nga,Nigeria,2010,dtp1,60,6026201,3615721,2410480,afr,gavi
nga,Nigeria,2010,mcv1,56,6026201,3374673,2651528,afr,gavi
nga,Nigeria,2010,dtp3,54,6026201,3254149,2772052,afr,gavi
nga,Nigeria,2011,mcv1,49,6159425,3018118,3141307,afr,gavi
nga,Nigeria,2011,dtp3,48,6159425,2956524,3202901,afr,gavi
nga,Nigeria,2011,dtp1,56,6159425,3449278,2710147,afr,gavi
nga,Nigeria,2012,mcv1,42,6288241,2641061,3647180,afr,gavi
nga,Nigeria,2012,dtp1,51,6288241,3207003,3081238,afr,gavi
nga,Nigeria,2012,dtp3,42,6288241,2641061,3647180,afr,gavi
nga,Nigeria,2013,dtp1,58,6411860,3718879,2692981,afr,gavi
nga,Nigeria,2013,dtp3,46,6411860,2949456,3462404,afr,gavi
nga,Nigeria,2013,mcv1,46,6411860,2949456,3462404,afr,gavi
nga,Nigeria,2014,dtp3,49,6530229,3199812,3330417,afr,gavi
nga,Nigeria,2014,dtp1,64,6530229,4179347,2350882,afr,gavi
nga,Nigeria,2014,mcv1,51,6530229,3330417,3199812,afr,gavi
nga,Nigeria,2015,dtp3,49,6643886,3255504,3388382,afr,gavi
nga,Nigeria,2015,dtp1,64,6643886,4252087,2391799,afr,gavi
nga,Nigeria,2015,mcv1,51,6643886,3388382,3255504,afr,gavi
nga,Nigeria,2016,dtp1,64,6754000,4322560,2431440,afr,gavi
nga,Nigeria,2016,mcv1,51,6754000,3444540,3309460,afr,gavi
nga,Nigeria,2016,dtp3,49,6754000,3309460,3444540,afr,gavi
nic,Nicaragua,2000,dtp1,97,131048,127117,3931,amr,gavi
nic,Nicaragua,2000,dtp3,83,131048,108770,22278,amr,gavi
nic,Nicaragua,2000,mcv1,86,131048,112701,18347,amr,gavi
nic,Nicaragua,2001,mcv1,99,129973,128673,1300,amr,gavi
nic,Nicaragua,2001,dtp3,87,129973,113077,16896,amr,gavi
nic,Nicaragua,2001,dtp1,92,129973,119575,10398,amr,gavi
nic,Nicaragua,2002,dtp1,88,129068,113580,15488,amr,gavi
nic,Nicaragua,2002,mcv1,98,129068,126487,2581,amr,gavi
nic,Nicaragua,2002,dtp3,85,129068,109708,19360,amr,gavi
nic,Nicaragua,2003,mcv1,93,128348,119364,8984,amr,gavi
nic,Nicaragua,2003,dtp1,86,128348,110379,17969,amr,gavi
nic,Nicaragua,2003,dtp3,86,128348,110379,17969,amr,gavi
nic,Nicaragua,2004,dtp1,80,127800,102240,25560,amr,gavi
nic,Nicaragua,2004,mcv1,84,127800,107352,20448,amr,gavi
nic,Nicaragua,2004,dtp3,79,127800,100962,26838,amr,gavi
nic,Nicaragua,2005,dtp3,86,127371,109539,17832,amr,gavi
nic,Nicaragua,2005,dtp1,92,127371,117181,10190,amr,gavi
nic,Nicaragua,2005,mcv1,96,127371,122276,5095,amr,gavi
nic,Nicaragua,2006,dtp1,94,126980,119361,7619,amr,gavi
nic,Nicaragua,2006,dtp3,88,126980,111742,15238,amr,gavi
nic,Nicaragua,2006,mcv1,99,126980,125710,1270,amr,gavi
nic,Nicaragua,2007,dtp1,94,126533,118941,7592,amr,gavi
nic,Nicaragua,2007,dtp3,93,126533,117676,8857,amr,gavi
nic,Nicaragua,2007,mcv1,99,126533,125268,1265,amr,gavi
nic,Nicaragua,2008,dtp1,99,125960,124700,1260,amr,gavi
nic,Nicaragua,2008,dtp3,97,125960,122181,3779,amr,gavi
nic,Nicaragua,2008,mcv1,99,125960,124700,1260,amr,gavi
nic,Nicaragua,2009,dtp1,99,125231,123979,1252,amr,gavi
nic,Nicaragua,2009,dtp3,98,125231,122726,2505,amr,gavi
nic,Nicaragua,2009,mcv1,99,125231,123979,1252,amr,gavi
nic,Nicaragua,2010,dtp1,99,124349,123106,1243,amr,gavi
nic,Nicaragua,2010,dtp3,98,124349,121862,2487,amr,gavi
nic,Nicaragua,2010,mcv1,99,124349,123106,1243,amr,gavi
nic,Nicaragua,2011,dtp1,99,123343,122110,1233,amr,gavi
nic,Nicaragua,2011,mcv1,99,123343,122110,1233,amr,gavi
nic,Nicaragua,2011,dtp3,98,123343,120876,2467,amr,gavi
nic,Nicaragua,2012,dtp3,98,122273,119828,2445,amr,gavi
nic,Nicaragua,2012,mcv1,99,122273,121050,1223,amr,gavi
nic,Nicaragua,2012,dtp1,99,122273,121050,1223,amr,gavi
nic,Nicaragua,2013,dtp3,98,121189,118765,2424,amr,gavi
nic,Nicaragua,2013,dtp1,99,121189,119977,1212,amr,gavi
nic,Nicaragua,2013,mcv1,99,121189,119977,1212,amr,gavi
nic,Nicaragua,2014,dtp3,98,120105,117703,2402,amr,gavi
nic,Nicaragua,2014,mcv1,99,120105,118904,1201,amr,gavi
nic,Nicaragua,2014,dtp1,99,120105,118904,1201,amr,gavi
nic,Nicaragua,2015,dtp3,98,119023,116643,2380,amr,gavi
nic,Nicaragua,2015,mcv1,99,119023,117833,1190,amr,gavi
nic,Nicaragua,2015,dtp1,99,119023,117833,1190,amr,gavi
nic,Nicaragua,2016,dtp3,98,117926,115567,2359,amr,gavi
nic,Nicaragua,2016,dtp1,99,117926,116747,1179,amr,gavi
nic,Nicaragua,2016,mcv1,99,117926,116747,1179,amr,gavi
niu,Niue,2000,mcv1,99,48.3667863814,48,0.3667863814,wpr,NA
niu,Niue,2000,dtp1,99,48.3667863814,48,0.3667863814,wpr,NA
niu,Niue,2000,dtp3,99,48.3667863814,48,0.3667863814,wpr,NA
niu,Niue,2000,mcv2,99,48.3667863814,48,0.3667863814,wpr,NA
niu,Niue,2001,dtp3,99,46.4450849174,46,0.4450849174,wpr,NA
niu,Niue,2001,dtp1,99,46.4450849174,46,0.4450849174,wpr,NA
niu,Niue,2001,mcv1,99,46.4450849174,46,0.4450849174,wpr,NA
niu,Niue,2001,mcv2,99,46.4450849174,46,0.4450849174,wpr,NA
niu,Niue,2002,dtp3,99,44.1302370703,44,0.1302370703,wpr,NA
niu,Niue,2002,dtp1,99,44.1302370703,44,0.1302370703,wpr,NA
niu,Niue,2002,mcv1,99,44.1302370703,44,0.1302370703,wpr,NA
niu,Niue,2002,mcv2,90,44.1302370703,40,4.1302370703,wpr,NA
niu,Niue,2003,dtp3,94,42.6784304246,40,2.6784304246,wpr,NA
niu,Niue,2003,dtp1,99,42.6784304246,42,0.6784304246,wpr,NA
niu,Niue,2003,mcv1,85,42.6784304246,36,6.6784304246,wpr,NA
niu,Niue,2003,mcv2,86,42.6784304246,37,5.6784304246,wpr,NA
niu,Niue,2004,dtp1,99,41.1498375806,41,0.1498375806,wpr,NA
niu,Niue,2004,dtp3,99,41.1498375806,41,0.1498375806,wpr,NA
niu,Niue,2004,mcv1,99,41.1498375806,41,0.1498375806,wpr,NA
niu,Niue,2004,mcv2,99,41.1498375806,41,0.1498375806,wpr,NA
niu,Niue,2005,mcv1,99,39.8823228412,39,0.8823228412,wpr,NA
niu,Niue,2005,dtp1,94,39.8823228412,37,2.8823228412,wpr,NA
niu,Niue,2005,dtp3,84,39.8823228412,34,5.8823228412,wpr,NA
niu,Niue,2005,mcv2,70,39.8823228412,28,11.8823228412,wpr,NA
niu,Niue,2006,dtp1,99,38.8825556074,38,0.8825556074,wpr,NA
niu,Niue,2006,dtp3,99,38.8825556074,38,0.8825556074,wpr,NA
niu,Niue,2006,mcv1,99,38.8825556074,38,0.8825556074,wpr,NA
niu,Niue,2006,mcv2,99,38.8825556074,38,0.8825556074,wpr,NA
niu,Niue,2007,dtp1,98,38.1278979037,37,1.1278979037,wpr,NA
niu,Niue,2007,mcv1,98,38.1278979037,37,1.1278979037,wpr,NA
niu,Niue,2007,dtp3,98,38.1278979037,37,1.1278979037,wpr,NA
niu,Niue,2007,mcv2,99,38.1278979037,38,0.1278979037,wpr,NA
niu,Niue,2008,dtp3,99,37.3538296946,37,0.3538296946,wpr,NA
niu,Niue,2008,dtp1,99,37.3538296946,37,0.3538296946,wpr,NA
niu,Niue,2008,mcv1,99,37.3538296946,37,0.3538296946,wpr,NA
niu,Niue,2008,mcv2,99,37.3538296946,37,0.3538296946,wpr,NA
niu,Niue,2009,dtp3,99,36.7309180632,36,0.7309180632,wpr,NA
niu,Niue,2009,mcv1,99,36.7309180632,36,0.7309180632,wpr,NA
niu,Niue,2009,dtp1,99,36.7309180632,36,0.7309180632,wpr,NA
niu,Niue,2009,mcv2,99,36.7309180632,36,0.7309180632,wpr,NA
niu,Niue,2010,dtp1,99,36.0068043996,36,0.0068043996,wpr,NA
niu,Niue,2010,mcv1,99,36.0068043996,36,0.0068043996,wpr,NA
niu,Niue,2010,dtp3,99,36.0068043996,36,0.0068043996,wpr,NA
niu,Niue,2010,mcv2,99,36.0068043996,36,0.0068043996,wpr,NA
niu,Niue,2011,dtp1,99,35.4312577444,35,0.4312577444,wpr,NA
niu,Niue,2011,dtp3,98,35.4312577444,35,0.4312577444,wpr,NA
niu,Niue,2011,mcv1,99,35.4312577444,35,0.4312577444,wpr,NA
niu,Niue,2011,mcv2,98,35.4312577444,35,0.4312577444,wpr,NA
niu,Niue,2012,dtp3,98,34.687728807,34,0.687728807,wpr,NA
niu,Niue,2012,dtp1,99,34.687728807,34,0.687728807,wpr,NA
niu,Niue,2012,mcv1,99,34.687728807,34,0.687728807,wpr,NA
niu,Niue,2012,mcv2,98,34.687728807,34,0.687728807,wpr,NA
niu,Niue,2013,mcv1,99,34.1165352144,34,0.1165352144,wpr,NA
niu,Niue,2013,dtp3,99,34.1165352144,34,0.1165352144,wpr,NA
niu,Niue,2013,dtp1,99,34.1165352144,34,0.1165352144,wpr,NA
niu,Niue,2013,mcv2,99,34.1165352144,34,0.1165352144,wpr,NA
niu,Niue,2014,mcv1,99,33.4273553292,33,0.4273553292,wpr,NA
niu,Niue,2014,dtp3,99,33.4273553292,33,0.4273553292,wpr,NA
niu,Niue,2014,dtp1,99,33.4273553292,33,0.4273553292,wpr,NA
niu,Niue,2014,mcv2,99,33.4273553292,33,0.4273553292,wpr,NA
niu,Niue,2015,mcv1,99,33.2001743674,33,0.2001743674,wpr,NA
niu,Niue,2015,dtp3,99,33.2001743674,33,0.2001743674,wpr,NA
niu,Niue,2015,dtp1,99,33.2001743674,33,0.2001743674,wpr,NA
niu,Niue,2015,mcv2,99,33.2001743674,33,0.2001743674,wpr,NA
niu,Niue,2016,mcv1,99,32.625092205,32,0.625092205,wpr,NA
niu,Niue,2016,dtp3,99,32.625092205,32,0.625092205,wpr,NA
niu,Niue,2016,dtp1,99,32.625092205,32,0.625092205,wpr,NA
niu,Niue,2016,mcv2,99,NA,NA,#VALUE!,wpr,NA
nld,Netherlands,2000,dtp1,99,196478,194513,1965,eur,hic
nld,Netherlands,2000,dtp3,97,196478,190584,5894,eur,hic
nld,Netherlands,2000,mcv1,96,196478,188619,7859,eur,hic
nld,Netherlands,2001,dtp1,99,197111,195140,1971,eur,hic
nld,Netherlands,2001,mcv1,95,197111,187255,9856,eur,hic
nld,Netherlands,2001,dtp3,97,197111,191198,5913,eur,hic
nld,Netherlands,2002,dtp1,99,197174,195202,1972,eur,hic
nld,Netherlands,2002,dtp3,97,197174,191259,5915,eur,hic
nld,Netherlands,2002,mcv1,95,197174,187315,9859,eur,hic
nld,Netherlands,2002,mcv2,96,200977,192938,8039,eur,hic
nld,Netherlands,2003,mcv1,96,196488,188628,7860,eur,hic
nld,Netherlands,2003,dtp3,98,196488,192558,3930,eur,hic
nld,Netherlands,2003,dtp1,99,196488,194523,1965,eur,hic
nld,Netherlands,2003,mcv2,98,201028,197007,4021,eur,hic
nld,Netherlands,2004,dtp3,98,195040,191139,3901,eur,hic
nld,Netherlands,2004,dtp1,99,195040,193090,1950,eur,hic
nld,Netherlands,2004,mcv1,96,195040,187238,7802,eur,hic
nld,Netherlands,2004,mcv2,98,200111,196109,4002,eur,hic
nld,Netherlands,2005,mcv1,95,192903,183258,9645,eur,hic
nld,Netherlands,2005,dtp1,98,192903,189045,3858,eur,hic
nld,Netherlands,2005,dtp3,96,192903,185187,7716,eur,hic
nld,Netherlands,2005,mcv2,93,199084,185148,13936,eur,hic
nld,Netherlands,2006,dtp3,96,190250,182640,7610,eur,hic
nld,Netherlands,2006,dtp1,98,190250,186445,3805,eur,hic
nld,Netherlands,2006,mcv1,96,190250,182640,7610,eur,hic
nld,Netherlands,2006,mcv2,92,197934,182099,15835,eur,hic
nld,Netherlands,2007,dtp3,97,187396,181774,5622,eur,hic
nld,Netherlands,2007,dtp1,99,187396,185522,1874,eur,hic
nld,Netherlands,2007,mcv1,96,187396,179900,7496,eur,hic
nld,Netherlands,2007,mcv2,92,196959,181202,15757,eur,hic
nld,Netherlands,2008,dtp3,97,184639,179100,5539,eur,hic
nld,Netherlands,2008,dtp1,99,184639,182793,1846,eur,hic
nld,Netherlands,2008,mcv1,96,184639,177253,7386,eur,hic
nld,Netherlands,2008,mcv2,93,197203,183399,13804,eur,hic
nld,Netherlands,2009,dtp3,97,182168,176703,5465,eur,hic
nld,Netherlands,2009,mcv1,96,182168,174881,7287,eur,hic
nld,Netherlands,2009,dtp1,99,182168,180346,1822,eur,hic
nld,Netherlands,2009,mcv2,93,198917,184993,13924,eur,hic
nld,Netherlands,2010,dtp1,99,180167,178365,1802,eur,hic
nld,Netherlands,2010,dtp3,97,180167,174762,5405,eur,hic
nld,Netherlands,2010,mcv1,96,180167,172960,7207,eur,hic
nld,Netherlands,2010,mcv2,92,200698,184642,16056,eur,hic
nld,Netherlands,2011,dtp1,99,178750,176962,1788,eur,hic
nld,Netherlands,2011,dtp3,97,178750,173388,5362,eur,hic
nld,Netherlands,2011,mcv1,96,178750,171600,7150,eur,hic
nld,Netherlands,2011,mcv2,93,202211,188056,14155,eur,hic
nld,Netherlands,2012,dtp3,97,177881,172545,5336,eur,hic
nld,Netherlands,2012,mcv1,96,177881,170766,7115,eur,hic
nld,Netherlands,2012,dtp1,99,177881,176102,1779,eur,hic
nld,Netherlands,2012,mcv2,93,202948,188742,14206,eur,hic
nld,Netherlands,2013,dtp3,97,177498,172173,5325,eur,hic
nld,Netherlands,2013,mcv1,96,177498,170398,7100,eur,hic
nld,Netherlands,2013,dtp1,99,177498,175723,1775,eur,hic
nld,Netherlands,2013,mcv2,92,201658,185525,16133,eur,hic
nld,Netherlands,2014,dtp3,96,177569,170466,7103,eur,hic
nld,Netherlands,2014,dtp1,98,177569,174018,3551,eur,hic
nld,Netherlands,2014,mcv1,96,177569,170466,7103,eur,hic
nld,Netherlands,2014,mcv2,93,198042,184179,13863,eur,hic
nld,Netherlands,2015,dtp3,95,178036,169134,8902,eur,hic
nld,Netherlands,2015,mcv1,95,178036,169134,8902,eur,hic
nld,Netherlands,2015,dtp1,98,178036,174475,3561,eur,hic
nld,Netherlands,2015,mcv2,92,193821,178315,15506,eur,hic
nld,Netherlands,2016,dtp3,95,178807,169867,8940,eur,hic
nld,Netherlands,2016,mcv1,94,178807,168079,10728,eur,hic
nld,Netherlands,2016,dtp1,98,178807,175231,3576,eur,hic
nld,Netherlands,2016,mcv2,91,190332,173202,17130,eur,hic
nor,Norway,2000,dtp1,99,57593,57017,576,eur,hic
nor,Norway,2000,dtp3,90,57593,51834,5759,eur,hic
nor,Norway,2000,mcv1,88,57593,50682,6911,eur,hic
nor,Norway,2000,mcv2,90,57835,52052,5783,eur,hic
nor,Norway,2001,dtp1,99,57194,56622,572,eur,hic
nor,Norway,2001,dtp3,91,57194,52047,5147,eur,hic
nor,Norway,2001,mcv1,90,57194,51475,5719,eur,hic
nor,Norway,2001,mcv2,90,59063,53157,5906,eur,hic
nor,Norway,2002,dtp1,99,57023,56453,570,eur,hic
nor,Norway,2002,mcv1,87,57023,49610,7413,eur,hic
nor,Norway,2002,dtp3,93,57023,53031,3992,eur,hic
nor,Norway,2002,mcv2,90,60137,54123,6014,eur,hic
nor,Norway,2003,dtp1,99,57107,56536,571,eur,hic
nor,Norway,2003,dtp3,92,57107,52538,4569,eur,hic
nor,Norway,2003,mcv1,86,57107,49112,7995,eur,hic
nor,Norway,2003,mcv2,89,61193,54462,6731,eur,hic
nor,Norway,2004,dtp3,92,57441,52846,4595,eur,hic
nor,Norway,2004,mcv1,89,57441,51122,6319,eur,hic
nor,Norway,2004,dtp1,99,57441,56867,574,eur,hic
nor,Norway,2004,mcv2,90,62294,56065,6229,eur,hic
nor,Norway,2005,dtp3,91,57948,52733,5215,eur,hic
nor,Norway,2005,dtp1,99,57948,57369,579,eur,hic
nor,Norway,2005,mcv1,90,57948,52153,5795,eur,hic
nor,Norway,2005,mcv2,91,63166,57481,5685,eur,hic
nor,Norway,2006,dtp1,99,58510,57925,585,eur,hic
nor,Norway,2006,mcv1,92,58510,53829,4681,eur,hic
nor,Norway,2006,dtp3,94,58510,54999,3511,eur,hic
nor,Norway,2006,mcv2,91,63575,57853,5722,eur,hic
nor,Norway,2007,dtp1,99,59006,58416,590,eur,hic
nor,Norway,2007,dtp3,93,59006,54876,4130,eur,hic
nor,Norway,2007,mcv1,92,59006,54286,4720,eur,hic
nor,Norway,2007,mcv2,93,63550,59102,4448,eur,hic
nor,Norway,2008,dtp1,99,59358,58764,594,eur,hic
nor,Norway,2008,dtp3,94,59358,55797,3561,eur,hic
nor,Norway,2008,mcv1,93,59358,55203,4155,eur,hic
nor,Norway,2008,mcv2,95,63501,60326,3175,eur,hic
nor,Norway,2009,dtp3,94,59555,55982,3573,eur,hic
nor,Norway,2009,dtp1,99,59555,58959,596,eur,hic
nor,Norway,2009,mcv1,93,59555,55386,4169,eur,hic
nor,Norway,2009,mcv2,96,63460,60922,2538,eur,hic
nor,Norway,2010,dtp1,99,59647,59051,596,eur,hic
nor,Norway,2010,dtp3,93,59647,55472,4175,eur,hic
nor,Norway,2010,mcv1,93,59647,55472,4175,eur,hic
nor,Norway,2010,mcv2,97,63278,61380,1898,eur,hic
nor,Norway,2011,dtp1,99,59726,59129,597,eur,hic
nor,Norway,2011,dtp3,94,59726,56142,3584,eur,hic
nor,Norway,2011,mcv1,93,59726,55545,4181,eur,hic
nor,Norway,2011,mcv2,94,61792,58084,3708,eur,hic
nor,Norway,2012,mcv1,94,59905,56311,3594,eur,hic
nor,Norway,2012,dtp3,95,59905,56910,2995,eur,hic
nor,Norway,2012,dtp1,99,59905,59306,599,eur,hic
nor,Norway,2012,mcv2,91,61264,55750,5514,eur,hic
nor,Norway,2013,dtp3,94,60259,56643,3616,eur,hic
nor,Norway,2013,mcv1,93,60259,56041,4218,eur,hic
nor,Norway,2013,dtp1,99,60259,59656,603,eur,hic
nor,Norway,2013,mcv2,91,60677,55216,5461,eur,hic
nor,Norway,2014,dtp3,93,60800,56544,4256,eur,hic
nor,Norway,2014,mcv1,94,60800,57152,3648,eur,hic
nor,Norway,2014,dtp1,99,60800,60192,608,eur,hic
nor,Norway,2014,mcv2,92,60386,55555,4831,eur,hic
nor,Norway,2015,dtp3,95,61507,58432,3075,eur,hic
nor,Norway,2015,dtp1,99,61507,60892,615,eur,hic
nor,Norway,2015,mcv1,95,61507,58432,3075,eur,hic
nor,Norway,2015,mcv2,91,60938,55454,5484,eur,hic
nor,Norway,2016,dtp1,99,62328,61705,623,eur,hic
nor,Norway,2016,mcv1,96,62328,59835,2493,eur,hic
nor,Norway,2016,dtp3,96,62328,59835,2493,eur,hic
nor,Norway,2016,mcv2,91,62399,56783,5616,eur,hic
npl,Nepal,2000,dtp1,84,714985,600587,114398,sear,gavi
npl,Nepal,2000,dtp3,74,714985,529089,185896,sear,gavi
npl,Nepal,2000,mcv1,71,714985,507639,207346,sear,gavi
npl,Nepal,2001,dtp3,72,708687,510255,198432,sear,gavi
npl,Nepal,2001,dtp1,84,708687,595297,113390,sear,gavi
npl,Nepal,2001,mcv1,71,708687,503168,205519,sear,gavi
npl,Nepal,2002,dtp1,84,700555,588466,112089,sear,gavi
npl,Nepal,2002,dtp3,72,700555,504400,196155,sear,gavi
npl,Nepal,2002,mcv1,71,700555,497394,203161,sear,gavi
npl,Nepal,2003,dtp1,82,691095,566698,124397,sear,gavi
npl,Nepal,2003,dtp3,78,691095,539054,152041,sear,gavi
npl,Nepal,2003,mcv1,75,691095,518321,172774,sear,gavi
npl,Nepal,2004,dtp1,88,680612,598939,81673,sear,gavi
npl,Nepal,2004,dtp3,80,680612,544490,136122,sear,gavi
npl,Nepal,2004,mcv1,73,680612,496847,183765,sear,gavi
npl,Nepal,2005,dtp1,81,669056,541935,127121,sear,gavi
npl,Nepal,2005,mcv1,74,669056,495101,173955,sear,gavi
npl,Nepal,2005,dtp3,75,669056,501792,167264,sear,gavi
npl,Nepal,2006,mcv1,85,656167,557742,98425,sear,gavi
npl,Nepal,2006,dtp1,93,656167,610235,45932,sear,gavi
npl,Nepal,2006,dtp3,89,656167,583989,72178,sear,gavi
npl,Nepal,2007,dtp3,82,641918,526373,115545,sear,gavi
npl,Nepal,2007,mcv1,81,641918,519954,121964,sear,gavi
npl,Nepal,2007,dtp1,85,641918,545630,96288,sear,gavi
npl,Nepal,2008,dtp1,84,626621,526362,100259,sear,gavi
npl,Nepal,2008,dtp3,82,626621,513829,112792,sear,gavi
npl,Nepal,2008,mcv1,79,626621,495031,131590,sear,gavi
npl,Nepal,2009,dtp3,89,610909,543709,67200,sear,gavi
npl,Nepal,2009,dtp1,94,610909,574254,36655,sear,gavi
npl,Nepal,2009,mcv1,90,610909,549818,61091,sear,gavi
npl,Nepal,2010,dtp3,82,595810,488564,107246,sear,gavi
npl,Nepal,2010,dtp1,85,595810,506438,89372,sear,gavi
npl,Nepal,2010,mcv1,86,595810,512397,83413,sear,gavi
npl,Nepal,2011,dtp1,96,582463,559164,23299,sear,gavi
npl,Nepal,2011,dtp3,92,582463,535866,46597,sear,gavi
npl,Nepal,2011,mcv1,88,582463,512567,69896,sear,gavi
npl,Nepal,2012,dtp3,90,571596,514436,57160,sear,gavi
npl,Nepal,2012,mcv1,86,571596,491573,80023,sear,gavi
npl,Nepal,2012,dtp1,90,571596,514436,57160,sear,gavi
npl,Nepal,2013,mcv1,88,563608,495975,67633,sear,gavi
npl,Nepal,2013,dtp3,92,563608,518519,45089,sear,gavi
npl,Nepal,2013,dtp1,94,563608,529792,33816,sear,gavi
npl,Nepal,2014,mcv1,88,558560,491533,67027,sear,gavi
npl,Nepal,2014,dtp3,92,558560,513875,44685,sear,gavi
npl,Nepal,2014,dtp1,94,558560,525046,33514,sear,gavi
npl,Nepal,2015,dtp3,91,556169,506114,50055,sear,gavi
npl,Nepal,2015,dtp1,94,556169,522799,33370,sear,gavi
npl,Nepal,2015,mcv1,85,556169,472744,83425,sear,gavi
npl,Nepal,2016,dtp1,92,555790,511327,44463,sear,gavi
npl,Nepal,2016,mcv1,83,555790,461306,94484,sear,gavi
npl,Nepal,2016,dtp3,87,555790,483537,72253,sear,gavi
npl,Nepal,2016,mcv2,25,546989,136747,410242,sear,gavi
nru,Nauru,2000,dtp1,85,267.8488112219,228,39.8488112219,wpr,hic
nru,Nauru,2000,dtp3,44,267.8488112219,118,149.8488112219,wpr,hic
nru,Nauru,2000,mcv1,8,267.8488112219,21,246.8488112219,wpr,hic
nru,Nauru,2001,dtp1,98,262.4364565958,257,5.4364565958,wpr,hic
nru,Nauru,2001,dtp3,95,262.4364565958,249,13.4364565958,wpr,hic
nru,Nauru,2001,mcv1,95,262.4364565958,249,13.4364565958,wpr,hic
nru,Nauru,2001,mcv2,95,262.4364565958,249,13.4364565958,wpr,hic
nru,Nauru,2002,dtp1,99,257.2375371474,255,2.2375371474,wpr,hic
nru,Nauru,2002,dtp3,80,257.2375371474,206,51.2375371474,wpr,hic
nru,Nauru,2002,mcv1,40,257.2375371474,103,154.2375371474,wpr,hic
nru,Nauru,2002,mcv2,83,257.2375371474,214,43.2375371474,wpr,hic
nru,Nauru,2003,dtp1,97,252.1197094399,245,7.1197094399,wpr,hic
nru,Nauru,2003,dtp3,80,252.1197094399,202,50.1197094399,wpr,hic
nru,Nauru,2003,mcv1,53,252.1197094399,134,118.1197094399,wpr,hic
nru,Nauru,2003,mcv2,72,252.1197094399,182,70.1197094399,wpr,hic
nru,Nauru,2004,dtp3,80,246.9622905288,198,48.9622905288,wpr,hic
nru,Nauru,2004,dtp1,93,246.9622905288,230,16.9622905288,wpr,hic
nru,Nauru,2004,mcv1,67,246.9622905288,165,81.9622905288,wpr,hic
nru,Nauru,2004,mcv2,60,246.9622905288,148,98.9622905288,wpr,hic
nru,Nauru,2005,dtp1,90,241.2538814405,217,24.2538814405,wpr,hic
nru,Nauru,2005,dtp3,80,241.2538814405,193,48.2538814405,wpr,hic
nru,Nauru,2005,mcv1,80,241.2538814405,193,48.2538814405,wpr,hic
nru,Nauru,2005,mcv2,50,241.2538814405,121,120.2538814405,wpr,hic
nru,Nauru,2006,mcv1,99,235.2698443558,233,2.2698443558,wpr,hic
nru,Nauru,2006,dtp3,72,235.2698443558,169,66.2698443558,wpr,hic
nru,Nauru,2006,dtp1,98,235.2698443558,231,4.2698443558,wpr,hic
nru,Nauru,2006,mcv2,97,235.2698443558,228,7.2698443558,wpr,hic
nru,Nauru,2007,mcv1,99,229.1783071897,227,2.1783071897,wpr,hic
nru,Nauru,2007,dtp3,99,229.1783071897,227,2.1783071897,wpr,hic
nru,Nauru,2007,dtp1,99,229.1783071897,227,2.1783071897,wpr,hic
nru,Nauru,2007,mcv2,99,229.1783071897,227,2.1783071897,wpr,hic
nru,Nauru,2008,mcv1,99,223.876663646,222,1.876663646,wpr,hic
nru,Nauru,2008,dtp1,99,223.876663646,222,1.876663646,wpr,hic
nru,Nauru,2008,dtp3,99,223.876663646,222,1.876663646,wpr,hic
nru,Nauru,2008,mcv2,99,223.876663646,222,1.876663646,wpr,hic
nru,Nauru,2009,mcv1,99,220.1896838293,218,2.1896838293,wpr,hic
nru,Nauru,2009,dtp3,99,220.1896838293,218,2.1896838293,wpr,hic
nru,Nauru,2009,dtp1,99,220.1896838293,218,2.1896838293,wpr,hic
nru,Nauru,2009,mcv2,92,220.1896838293,203,17.1896838293,wpr,hic
nru,Nauru,2010,dtp1,99,218.6489706571,216,2.6489706571,wpr,hic
nru,Nauru,2010,mcv1,99,218.6489706571,216,2.6489706571,wpr,hic
nru,Nauru,2010,dtp3,99,218.6489706571,216,2.6489706571,wpr,hic
nru,Nauru,2010,mcv2,99,218.6489706571,216,2.6489706571,wpr,hic
nru,Nauru,2011,mcv1,99,219.4939406871,217,2.4939406871,wpr,hic
nru,Nauru,2011,dtp1,99,219.4939406871,217,2.4939406871,wpr,hic
nru,Nauru,2011,dtp3,99,219.4939406871,217,2.4939406871,wpr,hic
nru,Nauru,2011,mcv2,99,219.4939406871,217,2.4939406871,wpr,hic
nru,Nauru,2012,mcv1,96,222.3071713231,213,9.3071713231,wpr,hic
nru,Nauru,2012,dtp1,98,222.3071713231,218,4.3071713231,wpr,hic
nru,Nauru,2012,dtp3,79,222.3071713231,176,46.3071713231,wpr,hic
nru,Nauru,2012,mcv2,81,222.3071713231,180,42.3071713231,wpr,hic
nru,Nauru,2013,mcv1,97,225.9463189412,219,6.9463189412,wpr,hic
nru,Nauru,2013,dtp3,87,225.9463189412,197,28.9463189412,wpr,hic
nru,Nauru,2013,dtp1,99,225.9463189412,224,1.9463189412,wpr,hic
nru,Nauru,2013,mcv2,88,225.9463189412,199,26.9463189412,wpr,hic
nru,Nauru,2014,mcv1,98,228.9351124959,224,4.9351124959,wpr,hic
nru,Nauru,2014,dtp1,99,228.9351124959,227,1.9351124959,wpr,hic
nru,Nauru,2014,dtp3,95,228.9351124959,217,11.9351124959,wpr,hic
nru,Nauru,2014,mcv2,94,228.9351124959,215,13.9351124959,wpr,hic
nru,Nauru,2015,mcv1,98,230.2054480097,226,4.2054480097,wpr,hic
nru,Nauru,2015,dtp3,91,230.2054480097,209,21.2054480097,wpr,hic
nru,Nauru,2015,dtp1,98,230.2054480097,226,4.2054480097,wpr,hic
nru,Nauru,2015,mcv2,96,230.2054480097,221,9.2054480097,wpr,hic
nru,Nauru,2016,mcv1,98,229.6198902028,225,4.6198902028,wpr,hic
nru,Nauru,2016,dtp1,98,229.6198902028,225,4.6198902028,wpr,hic
nru,Nauru,2016,dtp3,91,229.6198902028,209,20.6198902028,wpr,hic
nru,Nauru,2016,mcv2,96,NA,NA,#VALUE!,wpr,hic
nzl,New Zealand,2000,dtp3,90,55479,49931,5548,wpr,hic
nzl,New Zealand,2000,dtp1,96,55479,53260,2219,wpr,hic
nzl,New Zealand,2000,mcv1,85,55479,47157,8322,wpr,hic
nzl,New Zealand,2001,dtp1,96,55813,53580,2233,wpr,hic
nzl,New Zealand,2001,mcv1,85,55813,47441,8372,wpr,hic
nzl,New Zealand,2001,dtp3,90,55813,50232,5581,wpr,hic
nzl,New Zealand,2002,mcv1,84,56499,47459,9040,wpr,hic
nzl,New Zealand,2002,dtp3,90,56499,50849,5650,wpr,hic
nzl,New Zealand,2002,dtp1,90,56499,50849,5650,wpr,hic
nzl,New Zealand,2003,dtp1,91,57479,52306,5173,wpr,hic
nzl,New Zealand,2003,mcv1,84,57479,48282,9197,wpr,hic
nzl,New Zealand,2003,dtp3,90,57479,51731,5748,wpr,hic
nzl,New Zealand,2004,dtp3,89,58683,52228,6455,wpr,hic
nzl,New Zealand,2004,mcv1,83,58683,48707,9976,wpr,hic
nzl,New Zealand,2004,dtp1,91,58683,53402,5281,wpr,hic
nzl,New Zealand,2005,dtp1,92,59963,55166,4797,wpr,hic
nzl,New Zealand,2005,dtp3,89,59963,53367,6596,wpr,hic
nzl,New Zealand,2005,mcv1,82,59963,49170,10793,wpr,hic
nzl,New Zealand,2006,dtp3,89,61138,54413,6725,wpr,hic
nzl,New Zealand,2006,dtp1,92,61138,56247,4891,wpr,hic
nzl,New Zealand,2006,mcv1,82,61138,50133,11005,wpr,hic
nzl,New Zealand,2007,dtp3,88,62060,54613,7447,wpr,hic
nzl,New Zealand,2007,dtp1,91,62060,56475,5585,wpr,hic
nzl,New Zealand,2007,mcv1,79,62060,49027,13033,wpr,hic
nzl,New Zealand,2008,dtp1,91,62635,56998,5637,wpr,hic
nzl,New Zealand,2008,dtp3,89,62635,55745,6890,wpr,hic
nzl,New Zealand,2008,mcv1,86,62635,53866,8769,wpr,hic
nzl,New Zealand,2009,dtp1,94,62838,59068,3770,wpr,hic
nzl,New Zealand,2009,mcv1,89,62838,55926,6912,wpr,hic
nzl,New Zealand,2009,dtp3,92,62838,57811,5027,wpr,hic
nzl,New Zealand,2010,dtp1,95,62711,59575,3136,wpr,hic
nzl,New Zealand,2010,dtp3,93,62711,58321,4390,wpr,hic
nzl,New Zealand,2010,mcv1,91,62711,57067,5644,wpr,hic
nzl,New Zealand,2011,dtp1,95,62360,59242,3118,wpr,hic
nzl,New Zealand,2011,mcv1,93,62360,57995,4365,wpr,hic
nzl,New Zealand,2011,dtp3,95,62360,59242,3118,wpr,hic
nzl,New Zealand,2011,mcv2,86,60656,52164,8492,wpr,hic
nzl,New Zealand,2012,dtp3,93,61949,57613,4336,wpr,hic
nzl,New Zealand,2012,dtp1,94,61949,58232,3717,wpr,hic
nzl,New Zealand,2012,mcv1,92,61949,56993,4956,wpr,hic
nzl,New Zealand,2012,mcv2,85,62494,53120,9374,wpr,hic
nzl,New Zealand,2013,dtp3,92,61608,56679,4929,wpr,hic
nzl,New Zealand,2013,mcv1,92,61608,56679,4929,wpr,hic
nzl,New Zealand,2013,dtp1,93,61608,57295,4313,wpr,hic
nzl,New Zealand,2013,mcv2,86,64070,55100,8970,wpr,hic
nzl,New Zealand,2014,mcv1,93,61393,57095,4298,wpr,hic
nzl,New Zealand,2014,dtp3,93,61393,57095,4298,wpr,hic
nzl,New Zealand,2014,dtp1,93,61393,57095,4298,wpr,hic
nzl,New Zealand,2014,mcv2,86,64859,55779,9080,wpr,hic
nzl,New Zealand,2015,dtp3,92,61333,56426,4907,wpr,hic
nzl,New Zealand,2015,dtp1,93,61333,57040,4293,wpr,hic
nzl,New Zealand,2015,mcv1,93,61333,57040,4293,wpr,hic
nzl,New Zealand,2015,mcv2,87,64254,55901,8353,wpr,hic
nzl,New Zealand,2016,dtp1,92,61413,56500,4913,wpr,hic
nzl,New Zealand,2016,dtp3,92,61413,56500,4913,wpr,hic
nzl,New Zealand,2016,mcv1,92,61413,56500,4913,wpr,hic
nzl,New Zealand,2016,mcv2,89,63676,56672,7004,wpr,hic
omn,Oman,2000,dtp3,99,54641,54095,546,emr,hic
omn,Oman,2000,mcv1,99,54641,54095,546,emr,hic
omn,Oman,2000,dtp1,99,54641,54095,546,emr,hic
omn,Oman,2000,mcv2,99,56853,56284,569,emr,hic
omn,Oman,2001,dtp1,99,53641,53105,536,emr,hic
omn,Oman,2001,mcv1,99,53641,53105,536,emr,hic
omn,Oman,2001,dtp3,99,53641,53105,536,emr,hic
omn,Oman,2001,mcv2,99,54630,54084,546,emr,hic
omn,Oman,2002,dtp1,99,53074,52543,531,emr,hic
omn,Oman,2002,mcv1,99,53074,52543,531,emr,hic
omn,Oman,2002,dtp3,99,53074,52543,531,emr,hic
omn,Oman,2002,mcv2,98,52626,51573,1053,emr,hic
omn,Oman,2003,dtp1,99,53020,52490,530,emr,hic
omn,Oman,2003,mcv1,98,53020,51960,1060,emr,hic
omn,Oman,2003,dtp3,99,53020,52490,530,emr,hic
omn,Oman,2003,mcv2,98,51602,50570,1032,emr,hic
omn,Oman,2004,mcv1,98,53538,52467,1071,emr,hic
omn,Oman,2004,dtp1,99,53538,53003,535,emr,hic
omn,Oman,2004,dtp3,99,53538,53003,535,emr,hic
omn,Oman,2004,mcv2,98,50777,49761,1016,emr,hic
omn,Oman,2005,dtp3,99,54722,54175,547,emr,hic
omn,Oman,2005,mcv1,98,54722,53628,1094,emr,hic
omn,Oman,2005,dtp1,99,54722,54175,547,emr,hic
omn,Oman,2005,mcv2,97,50674,49154,1520,emr,hic
omn,Oman,2006,dtp1,98,56644,55511,1133,emr,hic
omn,Oman,2006,mcv1,96,56644,54378,2266,emr,hic
omn,Oman,2006,dtp3,98,56644,55511,1133,emr,hic
omn,Oman,2006,mcv2,97,50164,48659,1505,emr,hic
omn,Oman,2007,dtp3,99,59207,58615,592,emr,hic
omn,Oman,2007,mcv1,97,59207,57431,1776,emr,hic
omn,Oman,2007,dtp1,99,59207,58615,592,emr,hic
omn,Oman,2007,mcv2,95,50412,47891,2521,emr,hic
omn,Oman,2008,dtp3,99,62250,61628,622,emr,hic
omn,Oman,2008,mcv1,98,62250,61005,1245,emr,hic
omn,Oman,2008,dtp1,99,62250,61628,622,emr,hic
omn,Oman,2008,mcv2,98,51748,50713,1035,emr,hic
omn,Oman,2009,dtp1,99,65598,64942,656,emr,hic
omn,Oman,2009,mcv1,99,65598,64942,656,emr,hic
omn,Oman,2009,dtp3,98,65598,64286,1312,emr,hic
omn,Oman,2009,mcv2,99,54124,53583,541,emr,hic
omn,Oman,2010,dtp1,99,69019,68329,690,emr,hic
omn,Oman,2010,mcv1,99,69019,68329,690,emr,hic
omn,Oman,2010,dtp3,99,69019,68329,690,emr,hic
omn,Oman,2010,mcv2,99,57779,57201,578,emr,hic
omn,Oman,2011,mcv1,99,72265,71542,723,emr,hic
omn,Oman,2011,dtp1,99,72265,71542,723,emr,hic
omn,Oman,2011,dtp3,99,72265,71542,723,emr,hic
omn,Oman,2011,mcv2,99,61688,61071,617,emr,hic
omn,Oman,2012,dtp3,98,75142,73639,1503,emr,hic
omn,Oman,2012,dtp1,99,75142,74391,751,emr,hic
omn,Oman,2012,mcv1,99,75142,74391,751,emr,hic
omn,Oman,2012,mcv2,99,66284,65621,663,emr,hic
omn,Oman,2013,dtp3,98,77486,75936,1550,emr,hic
omn,Oman,2013,mcv1,99,77486,76711,775,emr,hic
omn,Oman,2013,dtp1,99,77486,76711,775,emr,hic
omn,Oman,2013,mcv2,99,69443,68749,694,emr,hic
omn,Oman,2014,dtp3,99,79195,78403,792,emr,hic
omn,Oman,2014,mcv1,99,79195,78403,792,emr,hic
omn,Oman,2014,dtp1,99,79195,78403,792,emr,hic
omn,Oman,2014,mcv2,99,73655,72918,737,emr,hic
omn,Oman,2015,dtp3,99,80218,79416,802,emr,hic
omn,Oman,2015,mcv1,99,80218,79416,802,emr,hic
omn,Oman,2015,dtp1,99,80218,79416,802,emr,hic
omn,Oman,2015,mcv2,98,76849,75312,1537,emr,hic
omn,Oman,2016,dtp3,99,80589,79783,806,emr,hic
omn,Oman,2016,mcv1,99,80589,79783,806,emr,hic
omn,Oman,2016,dtp1,99,80589,79783,806,emr,hic
omn,Oman,2016,mcv2,99,80737,79930,807,emr,hic
pak,Pakistan,2000,dtp3,62,4038971,2504162,1534809,emr,gavi
pak,Pakistan,2000,mcv1,59,4038971,2382993,1655978,emr,gavi
pak,Pakistan,2000,dtp1,72,4038971,2908059,1130912,emr,gavi
pak,Pakistan,2001,dtp3,65,4047243,2630708,1416535,emr,gavi
pak,Pakistan,2001,dtp1,75,4047243,3035432,1011811,emr,gavi
pak,Pakistan,2001,mcv1,61,4047243,2468818,1578425,emr,gavi
pak,Pakistan,2002,dtp1,77,4071851,3135325,936526,emr,gavi
pak,Pakistan,2002,mcv1,63,4071851,2565266,1506585,emr,gavi
pak,Pakistan,2002,dtp3,68,4071851,2768859,1302992,emr,gavi
pak,Pakistan,2003,dtp1,77,4115945,3169278,946667,emr,gavi
pak,Pakistan,2003,mcv1,61,4115945,2510726,1605219,emr,gavi
pak,Pakistan,2003,dtp3,67,4115945,2757683,1358262,emr,gavi
pak,Pakistan,2004,dtp1,75,4180133,3135100,1045033,emr,gavi
pak,Pakistan,2004,dtp3,65,4180133,2717086,1463047,emr,gavi
pak,Pakistan,2004,mcv1,67,4180133,2800689,1379444,emr,gavi
pak,Pakistan,2005,dtp3,77,4263462,3282866,980596,emr,gavi
pak,Pakistan,2005,dtp1,81,4263462,3453404,810058,emr,gavi
pak,Pakistan,2005,mcv1,73,4263462,3112327,1151135,emr,gavi
pak,Pakistan,2006,mcv1,71,4362758,3097558,1265200,emr,gavi
pak,Pakistan,2006,dtp3,78,4362758,3402951,959807,emr,gavi
pak,Pakistan,2006,dtp1,89,4362758,3882855,479903,emr,gavi
pak,Pakistan,2007,dtp1,89,4470754,3978971,491783,emr,gavi
pak,Pakistan,2007,dtp3,75,4470754,3353066,1117688,emr,gavi
pak,Pakistan,2007,mcv1,67,4470754,2995405,1475349,emr,gavi
pak,Pakistan,2008,dtp3,62,4580123,2839676,1740447,emr,gavi
pak,Pakistan,2008,dtp1,84,4580123,3847303,732820,emr,gavi
pak,Pakistan,2008,mcv1,67,4580123,3068682,1511441,emr,gavi
pak,Pakistan,2009,dtp1,88,4685784,4123490,562294,emr,gavi
pak,Pakistan,2009,mcv1,57,4685784,2670897,2014887,emr,gavi
pak,Pakistan,2009,dtp3,71,4685784,3326907,1358877,emr,gavi
pak,Pakistan,2009,mcv2,30,4338896,1301669,3037227,emr,gavi
pak,Pakistan,2010,dtp1,88,4782755,4208824,573931,emr,gavi
pak,Pakistan,2010,dtp3,82,4782755,3921859,860896,emr,gavi
pak,Pakistan,2010,mcv1,69,4782755,3300101,1482654,emr,gavi
pak,Pakistan,2010,mcv2,51,4446344,2267635,2178709,emr,gavi
pak,Pakistan,2011,mcv1,63,4867438,3066486,1800952,emr,gavi
pak,Pakistan,2011,dtp3,74,4867438,3601904,1265534,emr,gavi
pak,Pakistan,2011,dtp1,84,4867438,4088648,778790,emr,gavi
pak,Pakistan,2011,mcv2,53,4639479,2458924,2180555,emr,gavi
pak,Pakistan,2012,mcv1,61,4939341,3012998,1926343,emr,gavi
pak,Pakistan,2012,dtp3,72,4939341,3556326,1383015,emr,gavi
pak,Pakistan,2012,dtp1,79,4939341,3902079,1037262,emr,gavi
pak,Pakistan,2012,mcv2,53,4827141,2558385,2268756,emr,gavi
pak,Pakistan,2013,dtp3,72,4998313,3598785,1399528,emr,gavi
pak,Pakistan,2013,mcv1,61,4998313,3048971,1949342,emr,gavi
pak,Pakistan,2013,dtp1,79,4998313,3948667,1049646,emr,gavi
pak,Pakistan,2013,mcv2,53,4777625,2532141,2245484,emr,gavi
pak,Pakistan,2014,dtp3,72,5043584,3631380,1412204,emr,gavi
pak,Pakistan,2014,mcv1,61,5043584,3076586,1966998,emr,gavi
pak,Pakistan,2014,dtp1,79,5043584,3984431,1059153,emr,gavi
pak,Pakistan,2014,mcv2,53,4878420,2585563,2292857,emr,gavi
pak,Pakistan,2015,mcv1,61,5075096,3095809,1979287,emr,gavi
pak,Pakistan,2015,dtp3,72,5075096,3654069,1421027,emr,gavi
pak,Pakistan,2015,dtp1,79,5075096,4009326,1065770,emr,gavi
pak,Pakistan,2015,mcv2,53,4958425,2627965,2330460,emr,gavi
pak,Pakistan,2016,dtp3,72,5093857,3667577,1426280,emr,gavi
pak,Pakistan,2016,dtp1,79,5093857,4024147,1069710,emr,gavi
pak,Pakistan,2016,mcv1,61,5093857,3107253,1986604,emr,gavi
pak,Pakistan,2016,mcv2,53,5016239,2658607,2357632,emr,gavi
pan,Panama,2000,dtp3,98,69533,68142,1391,amr,mic_nongavi
pan,Panama,2000,mcv1,97,69533,67447,2086,amr,mic_nongavi
pan,Panama,2000,dtp1,99,69533,68838,695,amr,mic_nongavi
pan,Panama,2000,mcv2,88,62431,54939,7492,amr,mic_nongavi
pan,Panama,2001,mcv1,95,69996,66496,3500,amr,mic_nongavi
pan,Panama,2001,dtp3,99,69996,69296,700,amr,mic_nongavi
pan,Panama,2001,dtp1,99,69996,69296,700,amr,mic_nongavi
pan,Panama,2001,mcv2,88,62820,55282,7538,amr,mic_nongavi
pan,Panama,2002,dtp1,99,70460,69755,705,amr,mic_nongavi
pan,Panama,2002,dtp3,99,70460,69755,705,amr,mic_nongavi
pan,Panama,2002,mcv1,95,70460,66937,3523,amr,mic_nongavi
pan,Panama,2002,mcv2,88,63249,55659,7590,amr,mic_nongavi
pan,Panama,2003,dtp3,98,70962,69543,1419,amr,mic_nongavi
pan,Panama,2003,mcv1,95,70962,67414,3548,amr,mic_nongavi
pan,Panama,2003,dtp1,99,70962,70252,710,amr,mic_nongavi
pan,Panama,2003,mcv2,89,63773,56758,7015,amr,mic_nongavi
pan,Panama,2004,dtp1,98,71512,70082,1430,amr,mic_nongavi
pan,Panama,2004,dtp3,95,71512,67936,3576,amr,mic_nongavi
pan,Panama,2004,mcv1,97,71512,69367,2145,amr,mic_nongavi
pan,Panama,2004,mcv2,89,70303,62570,7733,amr,mic_nongavi
pan,Panama,2005,dtp3,92,72125,66355,5770,amr,mic_nongavi
pan,Panama,2005,dtp1,95,72125,68519,3606,amr,mic_nongavi
pan,Panama,2005,mcv1,99,72125,71404,721,amr,mic_nongavi
pan,Panama,2005,mcv2,89,70782,62996,7786,amr,mic_nongavi
pan,Panama,2006,dtp3,88,72808,64071,8737,amr,mic_nongavi
pan,Panama,2006,dtp1,96,72808,69896,2912,amr,mic_nongavi
pan,Panama,2006,mcv1,95,72808,69168,3640,amr,mic_nongavi
pan,Panama,2006,mcv2,86,70458,60594,9864,amr,mic_nongavi
pan,Panama,2007,dtp1,97,73541,71335,2206,amr,mic_nongavi
pan,Panama,2007,dtp3,85,73541,62510,11031,amr,mic_nongavi
pan,Panama,2007,mcv1,95,73541,69864,3677,amr,mic_nongavi
pan,Panama,2007,mcv2,83,70600,58598,12002,amr,mic_nongavi
pan,Panama,2008,dtp1,93,74296,69095,5201,amr,mic_nongavi
pan,Panama,2008,dtp3,86,74296,63895,10401,amr,mic_nongavi
pan,Panama,2008,mcv1,96,74296,71324,2972,amr,mic_nongavi
pan,Panama,2008,mcv2,79,70744,55888,14856,amr,mic_nongavi
pan,Panama,2009,mcv1,96,75046,72044,3002,amr,mic_nongavi
pan,Panama,2009,dtp3,85,75046,63789,11257,amr,mic_nongavi
pan,Panama,2009,dtp1,95,75046,71294,3752,amr,mic_nongavi
pan,Panama,2009,mcv2,76,71088,54027,17061,amr,mic_nongavi
pan,Panama,2010,mcv1,97,75751,73478,2273,amr,mic_nongavi
pan,Panama,2010,dtp3,94,75751,71206,4545,amr,mic_nongavi
pan,Panama,2010,dtp1,96,75751,72721,3030,amr,mic_nongavi
pan,Panama,2010,mcv2,73,71855,52454,19401,amr,mic_nongavi
pan,Panama,2011,dtp1,98,76367,74840,1527,amr,mic_nongavi
pan,Panama,2011,dtp3,87,76367,66439,9928,amr,mic_nongavi
pan,Panama,2011,mcv1,97,76367,74076,2291,amr,mic_nongavi
pan,Panama,2011,mcv2,81,72658,58853,13805,amr,mic_nongavi
pan,Panama,2012,mcv1,98,76871,75334,1537,amr,mic_nongavi
pan,Panama,2012,dtp3,85,76871,65340,11531,amr,mic_nongavi
pan,Panama,2012,dtp1,99,76871,76102,769,amr,mic_nongavi
pan,Panama,2012,mcv2,72,72696,52341,20355,amr,mic_nongavi
pan,Panama,2013,mcv1,92,77246,71066,6180,amr,mic_nongavi
pan,Panama,2013,dtp1,93,77246,71839,5407,amr,mic_nongavi
pan,Panama,2013,dtp3,80,77246,61797,15449,amr,mic_nongavi
pan,Panama,2013,mcv2,68,73522,49995,23527,amr,mic_nongavi
pan,Panama,2014,dtp1,96,77494,74394,3100,amr,mic_nongavi
pan,Panama,2014,mcv1,90,77494,69745,7749,amr,mic_nongavi
pan,Panama,2014,dtp3,80,77494,61995,15499,amr,mic_nongavi
pan,Panama,2014,mcv2,90,74300,66870,7430,amr,mic_nongavi
pan,Panama,2015,mcv1,90,77628,69865,7763,amr,mic_nongavi
pan,Panama,2015,dtp1,96,77628,74523,3105,amr,mic_nongavi
pan,Panama,2015,dtp3,73,77628,56668,20960,amr,mic_nongavi
pan,Panama,2015,mcv2,92,74921,68927,5994,amr,mic_nongavi
pan,Panama,2016,dtp1,96,77675,74568,3107,amr,mic_nongavi
pan,Panama,2016,mcv1,90,77675,69908,7767,amr,mic_nongavi
pan,Panama,2016,dtp3,73,77675,56703,20972,amr,mic_nongavi
pan,Panama,2016,mcv2,92,75701,69645,6056,amr,mic_nongavi
per,Peru,2000,mcv1,97,603600,585492,18108,amr,mic_nongavi
per,Peru,2000,dtp3,98,603600,591528,12072,amr,mic_nongavi
per,Peru,2000,dtp1,99,603600,597564,6036,amr,mic_nongavi
per,Peru,2001,mcv1,97,601397,583355,18042,amr,mic_nongavi
per,Peru,2001,dtp1,91,601397,547271,54126,amr,mic_nongavi
per,Peru,2001,dtp3,90,601397,541257,60140,amr,mic_nongavi
per,Peru,2002,dtp3,95,599455,569482,29973,amr,mic_nongavi
per,Peru,2002,dtp1,98,599455,587466,11989,amr,mic_nongavi
per,Peru,2002,mcv1,95,599455,569482,29973,amr,mic_nongavi
per,Peru,2003,dtp1,98,597766,585811,11955,amr,mic_nongavi
per,Peru,2003,dtp3,94,597766,561900,35866,amr,mic_nongavi
per,Peru,2003,mcv1,95,597766,567878,29888,amr,mic_nongavi
per,Peru,2004,dtp1,93,596419,554670,41749,amr,mic_nongavi
per,Peru,2004,dtp3,86,596419,512920,83499,amr,mic_nongavi
per,Peru,2004,mcv1,85,596419,506956,89463,amr,mic_nongavi
per,Peru,2005,dtp1,94,595628,559890,35738,amr,mic_nongavi
per,Peru,2005,dtp3,77,595628,458634,136994,amr,mic_nongavi
per,Peru,2005,mcv1,77,595628,458634,136994,amr,mic_nongavi
per,Peru,2006,dtp3,94,595637,559899,35738,amr,mic_nongavi
per,Peru,2006,mcv1,93,595637,553942,41695,amr,mic_nongavi
per,Peru,2006,dtp1,96,595637,571812,23825,amr,mic_nongavi
per,Peru,2007,dtp1,93,596484,554730,41754,amr,mic_nongavi
per,Peru,2007,mcv1,92,596484,548765,47719,amr,mic_nongavi
per,Peru,2007,dtp3,93,596484,554730,41754,amr,mic_nongavi
per,Peru,2007,mcv2,9,582520,52427,530093,amr,mic_nongavi
per,Peru,2008,dtp3,93,598070,556205,41865,amr,mic_nongavi
per,Peru,2008,dtp1,97,598070,580128,17942,amr,mic_nongavi
per,Peru,2008,mcv1,92,598070,550224,47846,amr,mic_nongavi
per,Peru,2008,mcv2,17,584204,99315,484889,amr,mic_nongavi
per,Peru,2009,dtp1,97,600200,582194,18006,amr,mic_nongavi
per,Peru,2009,dtp3,93,600200,558186,42014,amr,mic_nongavi
per,Peru,2009,mcv1,91,600200,546182,54018,amr,mic_nongavi
per,Peru,2009,mcv2,42,585084,245735,339349,amr,mic_nongavi
per,Peru,2010,dtp3,93,602523,560346,42177,amr,mic_nongavi
per,Peru,2010,mcv1,94,602523,566372,36151,amr,mic_nongavi
per,Peru,2010,dtp1,97,602523,584447,18076,amr,mic_nongavi
per,Peru,2010,mcv2,56,583734,326891,256843,amr,mic_nongavi
per,Peru,2011,dtp1,94,604612,568335,36277,amr,mic_nongavi
per,Peru,2011,mcv1,96,604612,580428,24184,amr,mic_nongavi
per,Peru,2011,dtp3,91,604612,550197,54415,amr,mic_nongavi
per,Peru,2011,mcv2,70,585001,409501,175500,amr,mic_nongavi
per,Peru,2012,dtp1,99,606079,600018,6061,amr,mic_nongavi
per,Peru,2012,dtp3,95,606079,575775,30304,amr,mic_nongavi
per,Peru,2012,mcv1,94,606079,569714,36365,amr,mic_nongavi
per,Peru,2012,mcv2,63,586238,369330,216908,amr,mic_nongavi
per,Peru,2013,dtp3,88,606643,533846,72797,amr,mic_nongavi
per,Peru,2013,mcv1,85,606643,515647,90996,amr,mic_nongavi
per,Peru,2013,dtp1,97,606643,588444,18199,amr,mic_nongavi
per,Peru,2013,mcv2,54,587702,317359,270343,amr,mic_nongavi
per,Peru,2014,dtp3,88,606167,533427,72740,amr,mic_nongavi
per,Peru,2014,dtp1,98,606167,594044,12123,amr,mic_nongavi
per,Peru,2014,mcv1,89,606167,539489,66678,amr,mic_nongavi
per,Peru,2014,mcv2,44,589820,259521,330299,amr,mic_nongavi
per,Peru,2015,mcv1,92,604634,556263,48371,amr,mic_nongavi
per,Peru,2015,dtp3,90,604634,544171,60463,amr,mic_nongavi
per,Peru,2015,dtp1,97,604634,586495,18139,amr,mic_nongavi
per,Peru,2015,mcv2,63,593108,373658,219450,amr,mic_nongavi
per,Peru,2016,dtp1,94,602173,566043,36130,amr,mic_nongavi
per,Peru,2016,dtp3,89,602173,535934,66239,amr,mic_nongavi
per,Peru,2016,mcv1,88,602173,529912,72261,amr,mic_nongavi
per,Peru,2016,mcv2,66,597423,394299,203124,amr,mic_nongavi
phl,Philippines,2000,dtp3,78,2243375,1749832,493543,wpr,mic_nongavi
phl,Philippines,2000,dtp1,92,2243375,2063905,179470,wpr,mic_nongavi
phl,Philippines,2000,mcv1,78,2243375,1749832,493543,wpr,mic_nongavi
phl,Philippines,2001,dtp3,79,2266238,1790328,475910,wpr,mic_nongavi
phl,Philippines,2001,dtp1,92,2266238,2084939,181299,wpr,mic_nongavi
phl,Philippines,2001,mcv1,81,2266238,1835653,430585,wpr,mic_nongavi
phl,Philippines,2002,dtp1,84,2282568,1917357,365211,wpr,mic_nongavi
phl,Philippines,2002,dtp3,79,2282568,1803229,479339,wpr,mic_nongavi
phl,Philippines,2002,mcv1,82,2282568,1871706,410862,wpr,mic_nongavi
phl,Philippines,2003,dtp1,86,2291883,1971019,320864,wpr,mic_nongavi
phl,Philippines,2003,mcv1,87,2291883,1993938,297945,wpr,mic_nongavi
phl,Philippines,2003,dtp3,84,2291883,1925182,366701,wpr,mic_nongavi
phl,Philippines,2004,dtp1,92,2294569,2111003,183566,wpr,mic_nongavi
phl,Philippines,2004,dtp3,88,2294569,2019221,275348,wpr,mic_nongavi
phl,Philippines,2004,mcv1,92,2294569,2111003,183566,wpr,mic_nongavi
phl,Philippines,2005,dtp1,91,2291973,2085695,206278,wpr,mic_nongavi
phl,Philippines,2005,dtp3,89,2291973,2039856,252117,wpr,mic_nongavi
phl,Philippines,2005,mcv1,92,2291973,2108615,183358,wpr,mic_nongavi
phl,Philippines,2006,dtp3,88,2286224,2011877,274347,wpr,mic_nongavi
phl,Philippines,2006,mcv1,92,2286224,2103326,182898,wpr,mic_nongavi
phl,Philippines,2006,dtp1,90,2286224,2057602,228622,wpr,mic_nongavi
phl,Philippines,2007,dtp3,87,2280098,1983685,296413,wpr,mic_nongavi
phl,Philippines,2007,dtp1,90,2280098,2052088,228010,wpr,mic_nongavi
phl,Philippines,2007,mcv1,92,2280098,2097690,182408,wpr,mic_nongavi
phl,Philippines,2008,dtp3,91,2275938,2071104,204834,wpr,mic_nongavi
phl,Philippines,2008,dtp1,94,2275938,2139382,136556,wpr,mic_nongavi
phl,Philippines,2008,mcv1,92,2275938,2093863,182075,wpr,mic_nongavi
phl,Philippines,2009,dtp1,89,2275026,2024773,250253,wpr,mic_nongavi
phl,Philippines,2009,mcv1,88,2275026,2002023,273003,wpr,mic_nongavi
phl,Philippines,2009,dtp3,87,2275026,1979273,295753,wpr,mic_nongavi
phl,Philippines,2009,mcv2,19,2194979,417046,1777933,wpr,mic_nongavi
phl,Philippines,2010,dtp1,81,2278240,1845374,432866,wpr,mic_nongavi
phl,Philippines,2010,mcv1,80,2278240,1822592,455648,wpr,mic_nongavi
phl,Philippines,2010,dtp3,79,2278240,1799810,478430,wpr,mic_nongavi
phl,Philippines,2010,mcv2,10,2186050,218605,1967445,wpr,mic_nongavi
phl,Philippines,2011,mcv1,87,2285702,1988561,297141,wpr,mic_nongavi
phl,Philippines,2011,dtp1,92,2285702,2102846,182856,wpr,mic_nongavi
phl,Philippines,2011,dtp3,87,2285702,1988561,297141,wpr,mic_nongavi
phl,Philippines,2011,mcv2,36,2215754,797671,1418083,wpr,mic_nongavi
phl,Philippines,2012,dtp3,88,2296197,2020653,275544,wpr,mic_nongavi
phl,Philippines,2012,dtp1,91,2296197,2089539,206658,wpr,mic_nongavi
phl,Philippines,2012,mcv1,87,2296197,1997691,298506,wpr,mic_nongavi
phl,Philippines,2012,mcv2,42,2245999,943320,1302679,wpr,mic_nongavi
phl,Philippines,2013,dtp3,89,2308518,2054581,253937,wpr,mic_nongavi
phl,Philippines,2013,dtp1,93,2308518,2146922,161596,wpr,mic_nongavi
phl,Philippines,2013,mcv1,87,2308518,2008411,300107,wpr,mic_nongavi
phl,Philippines,2013,mcv2,54,2234904,1206848,1028056,wpr,mic_nongavi
phl,Philippines,2014,dtp3,67,2322086,1555798,766288,wpr,mic_nongavi
phl,Philippines,2014,mcv1,79,2322086,1834448,487638,wpr,mic_nongavi
phl,Philippines,2014,dtp1,78,2322086,1811227,510859,wpr,mic_nongavi
phl,Philippines,2014,mcv2,59,2262803,1335054,927749,wpr,mic_nongavi
phl,Philippines,2015,dtp3,60,2336205,1401723,934482,wpr,mic_nongavi
phl,Philippines,2015,mcv1,82,2336205,1915688,420517,wpr,mic_nongavi
phl,Philippines,2015,dtp1,69,2336205,1611981,724224,wpr,mic_nongavi
phl,Philippines,2015,mcv2,67,2286498,1531954,754544,wpr,mic_nongavi
phl,Philippines,2016,dtp3,86,2350202,2021174,329028,wpr,mic_nongavi
phl,Philippines,2016,mcv1,80,2350202,1880162,470040,wpr,mic_nongavi
phl,Philippines,2016,dtp1,87,2350202,2044676,305526,wpr,mic_nongavi
phl,Philippines,2016,mcv2,66,2306914,1522563,784351,wpr,mic_nongavi
plw,Palau,2000,mcv1,83,511.7287999311,425,86.7287999311,wpr,mic_nongavi
plw,Palau,2000,dtp3,96,511.7287999311,491,20.7287999311,wpr,mic_nongavi
plw,Palau,2000,dtp1,98,511.7287999311,501,10.7287999311,wpr,mic_nongavi
plw,Palau,2000,mcv2,75,511.7287999311,384,127.7287999311,wpr,mic_nongavi
plw,Palau,2001,dtp3,98,506.5947010456,496,10.5947010456,wpr,mic_nongavi
plw,Palau,2001,mcv1,91,506.5947010456,461,45.5947010456,wpr,mic_nongavi
plw,Palau,2001,dtp1,98,506.5947010456,496,10.5947010456,wpr,mic_nongavi
plw,Palau,2001,mcv2,83,506.5947010456,420,86.5947010456,wpr,mic_nongavi
plw,Palau,2002,mcv1,99,499.5523227384,495,4.5523227383,wpr,mic_nongavi
plw,Palau,2002,dtp3,99,499.5523227384,495,4.5523227383,wpr,mic_nongavi
plw,Palau,2002,dtp1,99,499.5523227384,495,4.5523227383,wpr,mic_nongavi
plw,Palau,2002,mcv2,90,499.5523227384,450,49.5523227384,wpr,mic_nongavi
plw,Palau,2003,dtp1,99,491.4626743447,487,4.4626743447,wpr,mic_nongavi
plw,Palau,2003,mcv1,99,491.4626743447,487,4.4626743447,wpr,mic_nongavi
plw,Palau,2003,dtp3,99,491.4626743447,487,4.4626743447,wpr,mic_nongavi
plw,Palau,2003,mcv2,94,491.4626743447,462,29.4626743447,wpr,mic_nongavi
plw,Palau,2004,dtp1,99,483.0438576836,478,5.0438576836,wpr,mic_nongavi
plw,Palau,2004,dtp3,98,483.0438576836,473,10.0438576836,wpr,mic_nongavi
plw,Palau,2004,mcv1,99,483.0438576836,478,5.0438576836,wpr,mic_nongavi
plw,Palau,2004,mcv2,98,483.0438576836,473,10.0438576836,wpr,mic_nongavi
plw,Palau,2005,dtp3,98,474.847862536,465,9.847862536,wpr,mic_nongavi
plw,Palau,2005,mcv1,98,474.847862536,465,9.847862536,wpr,mic_nongavi
plw,Palau,2005,dtp1,98,474.847862536,465,9.847862536,wpr,mic_nongavi
plw,Palau,2005,mcv2,95,474.847862536,451,23.847862536,wpr,mic_nongavi
plw,Palau,2006,dtp1,98,467.4968972099,458,9.4968972099,wpr,mic_nongavi
plw,Palau,2006,dtp3,98,467.4968972099,458,9.4968972099,wpr,mic_nongavi
plw,Palau,2006,mcv1,98,467.4968972099,458,9.4968972099,wpr,mic_nongavi
plw,Palau,2006,mcv2,98,467.4968972099,458,9.4968972099,wpr,mic_nongavi
plw,Palau,2007,dtp1,99,460.9140674798,456,4.9140674798,wpr,mic_nongavi
plw,Palau,2007,dtp3,94,460.9140674798,433,27.9140674798,wpr,mic_nongavi
plw,Palau,2007,mcv1,91,460.9140674798,419,41.9140674798,wpr,mic_nongavi
plw,Palau,2007,mcv2,83,460.9140674798,383,77.9140674798,wpr,mic_nongavi
plw,Palau,2008,dtp1,99,455.2882220836,451,4.2882220836,wpr,mic_nongavi
plw,Palau,2008,mcv1,97,455.2882220836,442,13.2882220836,wpr,mic_nongavi
plw,Palau,2008,dtp3,92,455.2882220836,419,36.2882220836,wpr,mic_nongavi
plw,Palau,2008,mcv2,77,455.2882220836,351,104.2882220836,wpr,mic_nongavi
plw,Palau,2009,mcv1,75,450.3890240892,338,112.3890240892,wpr,mic_nongavi
plw,Palau,2009,dtp3,49,450.3890240892,221,229.3890240892,wpr,mic_nongavi
plw,Palau,2009,dtp1,99,450.3890240892,446,4.3890240892,wpr,mic_nongavi
plw,Palau,2009,mcv2,79,450.3890240892,356,94.3890240892,wpr,mic_nongavi
plw,Palau,2010,mcv1,39,446.452648415,174,272.452648415,wpr,mic_nongavi
plw,Palau,2010,dtp3,69,446.452648415,308,138.452648415,wpr,mic_nongavi
plw,Palau,2010,dtp1,99,446.452648415,442,4.452648415,wpr,mic_nongavi
plw,Palau,2010,mcv2,39,446.452648415,174,272.452648415,wpr,mic_nongavi
plw,Palau,2011,dtp3,84,442.9450964696,372,70.9450964696,wpr,mic_nongavi
plw,Palau,2011,dtp1,99,442.9450964696,439,3.9450964696,wpr,mic_nongavi
plw,Palau,2011,mcv1,85,442.9450964696,377,65.9450964696,wpr,mic_nongavi
plw,Palau,2011,mcv2,83,442.9450964696,368,74.9450964696,wpr,mic_nongavi
plw,Palau,2012,dtp3,89,440.4176019477,392,48.4176019477,wpr,mic_nongavi
plw,Palau,2012,mcv1,91,440.4176019477,401,39.4176019477,wpr,mic_nongavi
plw,Palau,2012,dtp1,99,440.4176019477,436,4.4176019477,wpr,mic_nongavi
plw,Palau,2012,mcv2,86,440.4176019477,379,61.4176019477,wpr,mic_nongavi
plw,Palau,2013,dtp1,99,438.0841403139,434,4.0841403139,wpr,mic_nongavi
plw,Palau,2013,dtp3,99,438.0841403139,434,4.0841403139,wpr,mic_nongavi
plw,Palau,2013,mcv1,99,438.0841403139,434,4.0841403139,wpr,mic_nongavi
plw,Palau,2013,mcv2,98,438.0841403139,429,9.0841403139,wpr,mic_nongavi
plw,Palau,2014,dtp1,99,436.2377577063,432,4.2377577063,wpr,mic_nongavi
plw,Palau,2014,mcv1,83,436.2377577063,362,74.2377577063,wpr,mic_nongavi
plw,Palau,2014,dtp3,95,436.2377577063,414,22.2377577063,wpr,mic_nongavi
plw,Palau,2014,mcv2,81,436.2377577063,353,83.2377577063,wpr,mic_nongavi
plw,Palau,2015,dtp1,99,435.2269175588,431,4.2269175588,wpr,mic_nongavi
plw,Palau,2015,mcv1,95,435.2269175588,413,22.2269175588,wpr,mic_nongavi
plw,Palau,2015,dtp3,90,435.2269175588,392,43.2269175588,wpr,mic_nongavi
plw,Palau,2015,mcv2,82,435.2269175588,357,78.2269175588,wpr,mic_nongavi
plw,Palau,2016,dtp1,99,435.1403462738,431,4.1403462738,wpr,mic_nongavi
plw,Palau,2016,dtp3,98,435.1403462738,426,9.1403462738,wpr,mic_nongavi
plw,Palau,2016,mcv1,96,435.1403462738,418,17.1403462738,wpr,mic_nongavi
plw,Palau,2016,mcv2,95,NA,NA,#VALUE!,wpr,mic_nongavi
png,Papua New Guinea,2000,dtp3,59,178626,105389,73237,wpr,gavi
png,Papua New Guinea,2000,mcv1,69,178626,123252,55374,wpr,gavi
png,Papua New Guinea,2000,dtp1,84,178626,150046,28580,wpr,gavi
png,Papua New Guinea,2001,dtp3,55,181595,99877,81718,wpr,gavi
png,Papua New Guinea,2001,mcv1,65,181595,118037,63558,wpr,gavi
png,Papua New Guinea,2001,dtp1,77,181595,139828,41767,wpr,gavi
png,Papua New Guinea,2002,dtp1,81,184386,149353,35033,wpr,gavi
png,Papua New Guinea,2002,dtp3,61,184386,112475,71911,wpr,gavi
png,Papua New Guinea,2002,mcv1,73,184386,134602,49784,wpr,gavi
png,Papua New Guinea,2003,dtp1,88,187071,164622,22449,wpr,gavi
png,Papua New Guinea,2003,mcv1,77,187071,144045,43026,wpr,gavi
png,Papua New Guinea,2003,dtp3,68,187071,127208,59863,wpr,gavi
png,Papua New Guinea,2004,dtp1,81,189666,153629,36037,wpr,gavi
png,Papua New Guinea,2004,mcv1,77,189666,146043,43623,wpr,gavi
png,Papua New Guinea,2004,dtp3,62,189666,117593,72073,wpr,gavi
png,Papua New Guinea,2005,dtp1,80,192150,153720,38430,wpr,gavi
png,Papua New Guinea,2005,dtp3,72,192150,138348,53802,wpr,gavi
png,Papua New Guinea,2005,mcv1,82,192150,157563,34587,wpr,gavi
png,Papua New Guinea,2006,dtp3,72,194484,140028,54456,wpr,gavi
png,Papua New Guinea,2006,mcv1,84,194484,163367,31117,wpr,gavi
png,Papua New Guinea,2006,dtp1,85,194484,165311,29173,wpr,gavi
png,Papua New Guinea,2007,dtp1,76,196635,149443,47192,wpr,gavi
png,Papua New Guinea,2007,mcv1,77,196635,151409,45226,wpr,gavi
png,Papua New Guinea,2007,dtp3,71,196635,139611,57024,wpr,gavi
png,Papua New Guinea,2008,dtp3,63,198602,125119,73483,wpr,gavi
png,Papua New Guinea,2008,dtp1,70,198602,139021,59581,wpr,gavi
png,Papua New Guinea,2008,mcv1,73,198602,144979,53623,wpr,gavi
png,Papua New Guinea,2009,dtp1,80,200411,160329,40082,wpr,gavi
png,Papua New Guinea,2009,dtp3,73,200411,146300,54111,wpr,gavi
png,Papua New Guinea,2009,mcv1,74,200411,148304,52107,wpr,gavi
png,Papua New Guinea,2010,dtp1,80,202114,161691,40423,wpr,gavi
png,Papua New Guinea,2010,dtp3,67,202114,135416,66698,wpr,gavi
png,Papua New Guinea,2010,mcv1,74,202114,149564,52550,wpr,gavi
png,Papua New Guinea,2011,mcv1,79,203773,160981,42792,wpr,gavi
png,Papua New Guinea,2011,dtp1,83,203773,169132,34641,wpr,gavi
png,Papua New Guinea,2011,dtp3,72,203773,146717,57056,wpr,gavi
png,Papua New Guinea,2012,mcv1,86,205449,176686,28763,wpr,gavi
png,Papua New Guinea,2012,dtp1,85,205449,174632,30817,wpr,gavi
png,Papua New Guinea,2012,dtp3,74,205449,152032,53417,wpr,gavi
png,Papua New Guinea,2013,dtp3,79,207196,163685,43511,wpr,gavi
png,Papua New Guinea,2013,dtp1,88,207196,182332,24864,wpr,gavi
png,Papua New Guinea,2013,mcv1,89,207196,184404,22792,wpr,gavi
png,Papua New Guinea,2014,dtp3,73,209040,152599,56441,wpr,gavi
png,Papua New Guinea,2014,mcv1,84,209040,175594,33446,wpr,gavi
png,Papua New Guinea,2014,dtp1,87,209040,181865,27175,wpr,gavi
png,Papua New Guinea,2015,mcv1,79,211000,166690,44310,wpr,gavi
png,Papua New Guinea,2015,dtp3,73,211000,154030,56970,wpr,gavi
png,Papua New Guinea,2015,dtp1,83,211000,175130,35870,wpr,gavi
png,Papua New Guinea,2016,dtp1,87,213069,185370,27699,wpr,gavi
png,Papua New Guinea,2016,mcv1,70,213069,149148,63921,wpr,gavi
png,Papua New Guinea,2016,dtp3,72,213069,153410,59659,wpr,gavi
pol,Poland,2000,dtp1,99,374939,371190,3749,eur,hic
pol,Poland,2000,mcv1,97,374939,363691,11248,eur,hic
pol,Poland,2000,dtp3,98,374939,367440,7499,eur,hic
pol,Poland,2000,mcv2,96,413789,397237,16552,eur,hic
pol,Poland,2001,mcv1,97,367284,356265,11019,eur,hic
pol,Poland,2001,dtp1,99,367284,363611,3673,eur,hic
pol,Poland,2001,dtp3,98,367284,359938,7346,eur,hic
pol,Poland,2001,mcv2,96,495164,475357,19807,eur,hic
pol,Poland,2002,dtp3,99,364261,360618,3643,eur,hic
pol,Poland,2002,dtp1,99,364261,360618,3643,eur,hic
pol,Poland,2002,mcv1,98,364261,356976,7285,eur,hic
pol,Poland,2002,mcv2,97,474217,459990,14227,eur,hic
pol,Poland,2003,dtp3,99,365428,361774,3654,eur,hic
pol,Poland,2003,dtp1,99,365428,361774,3654,eur,hic
pol,Poland,2003,mcv1,97,365428,354465,10963,eur,hic
pol,Poland,2003,mcv2,97,451129,437595,13534,eur,hic
pol,Poland,2004,dtp3,99,370106,366405,3701,eur,hic
pol,Poland,2004,mcv1,97,370106,359003,11103,eur,hic
pol,Poland,2004,dtp1,99,370106,366405,3701,eur,hic
pol,Poland,2004,mcv2,96,427894,410778,17116,eur,hic
pol,Poland,2005,dtp1,99,377048,373278,3770,eur,hic
pol,Poland,2005,mcv1,98,377048,369507,7541,eur,hic
pol,Poland,2005,dtp3,99,377048,373278,3770,eur,hic
pol,Poland,2005,mcv2,90,406374,365737,40637,eur,hic
pol,Poland,2006,mcv1,99,384690,380843,3847,eur,hic
pol,Poland,2006,dtp3,99,384690,380843,3847,eur,hic
pol,Poland,2006,dtp1,99,384690,380843,3847,eur,hic
pol,Poland,2006,mcv2,99,445279,440826,4453,eur,hic
pol,Poland,2007,mcv1,98,391456,383627,7829,eur,hic
pol,Poland,2007,dtp3,99,391456,387541,3915,eur,hic
pol,Poland,2007,dtp1,99,391456,387541,3915,eur,hic
pol,Poland,2007,mcv2,98,423969,415490,8479,eur,hic
pol,Poland,2008,dtp3,99,396076,392115,3961,eur,hic
pol,Poland,2008,mcv1,98,396076,388154,7922,eur,hic
pol,Poland,2008,dtp1,99,396076,392115,3961,eur,hic
pol,Poland,2008,mcv2,97,404441,392308,12133,eur,hic
pol,Poland,2009,dtp3,99,397848,393870,3978,eur,hic
pol,Poland,2009,dtp1,99,397848,393870,3978,eur,hic
pol,Poland,2009,mcv1,98,397848,389891,7957,eur,hic
pol,Poland,2009,mcv2,95,388296,368881,19415,eur,hic
pol,Poland,2010,dtp1,99,396473,392508,3965,eur,hic
pol,Poland,2010,dtp3,99,396473,392508,3965,eur,hic
pol,Poland,2010,mcv1,98,396473,388544,7929,eur,hic
pol,Poland,2010,mcv2,94,376175,353604,22571,eur,hic
pol,Poland,2011,dtp3,99,392206,388284,3922,eur,hic
pol,Poland,2011,dtp1,99,392206,388284,3922,eur,hic
pol,Poland,2011,mcv1,98,392206,384362,7844,eur,hic
pol,Poland,2011,mcv2,95,365353,347085,18268,eur,hic
pol,Poland,2012,mcv1,98,386093,378371,7722,eur,hic
pol,Poland,2012,dtp3,99,386093,382232,3861,eur,hic
pol,Poland,2012,dtp1,99,386093,382232,3861,eur,hic
pol,Poland,2012,mcv2,95,355913,338117,17796,eur,hic
pol,Poland,2013,dtp3,99,379065,375274,3791,eur,hic
pol,Poland,2013,mcv1,98,379065,371484,7581,eur,hic
pol,Poland,2013,dtp1,99,379065,375274,3791,eur,hic
pol,Poland,2013,mcv2,93,350911,326347,24564,eur,hic
pol,Poland,2014,mcv1,97,371516,360371,11145,eur,hic
pol,Poland,2014,dtp3,98,371516,364086,7430,eur,hic
pol,Poland,2014,dtp1,99,371516,367801,3715,eur,hic
pol,Poland,2014,mcv2,95,355592,337812,17780,eur,hic
pol,Poland,2015,dtp3,98,363750,356475,7275,eur,hic
pol,Poland,2015,dtp1,99,363750,360112,3638,eur,hic
pol,Poland,2015,mcv1,96,363750,349200,14550,eur,hic
pol,Poland,2015,mcv2,94,370122,347915,22207,eur,hic
pol,Poland,2016,mcv1,96,355930,341693,14237,eur,hic
pol,Poland,2016,dtp1,99,355930,352371,3559,eur,hic
pol,Poland,2016,dtp3,98,355930,348811,7119,eur,hic
pol,Poland,2016,mcv2,94,383239,360245,22994,eur,hic
prk,Democratic People’s Republic of Korea,2000,mcv1,78,393348,306811,86537,sear,gavi
prk,Democratic People’s Republic of Korea,2000,dtp3,56,393348,220275,173073,sear,gavi
prk,Democratic People’s Republic of Korea,2000,dtp1,61,393348,239942,153406,sear,gavi
prk,Democratic People’s Republic of Korea,2001,dtp1,63,388841,244970,143871,sear,gavi
prk,Democratic People’s Republic of Korea,2001,dtp3,62,388841,241081,147760,sear,gavi
prk,Democratic People’s Republic of Korea,2001,mcv1,92,388841,357734,31107,sear,gavi
prk,Democratic People’s Republic of Korea,2002,dtp1,65,383747,249436,134311,sear,gavi
prk,Democratic People’s Republic of Korea,2002,mcv1,98,383747,376072,7675,sear,gavi
prk,Democratic People’s Republic of Korea,2002,dtp3,64,383747,245598,138149,sear,gavi
prk,Democratic People’s Republic of Korea,2003,dtp1,70,377988,264592,113396,sear,gavi
prk,Democratic People’s Republic of Korea,2003,mcv1,95,377988,359089,18899,sear,gavi
prk,Democratic People’s Republic of Korea,2003,dtp3,68,377988,257032,120956,sear,gavi
prk,Democratic People’s Republic of Korea,2004,dtp1,75,371745,278809,92936,sear,gavi
prk,Democratic People’s Republic of Korea,2004,dtp3,72,371745,267656,104089,sear,gavi
prk,Democratic People’s Republic of Korea,2004,mcv1,95,371745,353158,18587,sear,gavi
prk,Democratic People’s Republic of Korea,2005,dtp1,83,365348,303239,62109,sear,gavi
prk,Democratic People’s Republic of Korea,2005,dtp3,79,365348,288625,76723,sear,gavi
prk,Democratic People’s Republic of Korea,2005,mcv1,96,365348,350734,14614,sear,gavi
prk,Democratic People’s Republic of Korea,2006,dtp3,89,359215,319701,39514,sear,gavi
prk,Democratic People’s Republic of Korea,2006,mcv1,96,359215,344846,14369,sear,gavi
prk,Democratic People’s Republic of Korea,2006,dtp1,91,359215,326886,32329,sear,gavi
prk,Democratic People’s Republic of Korea,2007,dtp3,92,353751,325451,28300,sear,gavi
prk,Democratic People’s Republic of Korea,2007,dtp1,93,353751,328988,24763,sear,gavi
prk,Democratic People’s Republic of Korea,2007,mcv1,99,353751,350213,3538,sear,gavi
prk,Democratic People’s Republic of Korea,2008,dtp3,92,349261,321320,27941,sear,gavi
prk,Democratic People’s Republic of Korea,2008,dtp1,93,349261,324813,24448,sear,gavi
prk,Democratic People’s Republic of Korea,2008,mcv1,98,349261,342276,6985,sear,gavi
prk,Democratic People’s Republic of Korea,2008,mcv2,98,360976,353756,7220,sear,gavi
prk,Democratic People’s Republic of Korea,2009,dtp1,94,345906,325152,20754,sear,gavi
prk,Democratic People’s Republic of Korea,2009,mcv1,98,345906,338988,6918,sear,gavi
prk,Democratic People’s Republic of Korea,2009,dtp3,93,345906,321693,24213,sear,gavi
prk,Democratic People’s Republic of Korea,2009,mcv2,98,354958,347859,7099,sear,gavi
prk,Democratic People’s Republic of Korea,2010,dtp1,94,343759,323133,20626,sear,gavi
prk,Democratic People’s Republic of Korea,2010,mcv1,99,343759,340321,3438,sear,gavi
prk,Democratic People’s Republic of Korea,2010,dtp3,93,343759,319696,24063,sear,gavi
prk,Democratic People’s Republic of Korea,2010,mcv2,99,349807,346309,3498,sear,gavi
prk,Democratic People’s Republic of Korea,2011,dtp1,95,342762,325624,17138,sear,gavi
prk,Democratic People’s Republic of Korea,2011,mcv1,99,342762,339334,3428,sear,gavi
prk,Democratic People’s Republic of Korea,2011,dtp3,94,342762,322196,20566,sear,gavi
prk,Democratic People’s Republic of Korea,2011,mcv2,99,341111,337700,3411,sear,gavi
prk,Democratic People’s Republic of Korea,2012,mcv1,99,342610,339184,3426,sear,gavi
prk,Democratic People’s Republic of Korea,2012,dtp3,96,342610,328906,13704,sear,gavi
prk,Democratic People’s Republic of Korea,2012,dtp1,97,342610,332332,10278,sear,gavi
prk,Democratic People’s Republic of Korea,2012,mcv2,99,333729,330392,3337,sear,gavi
prk,Democratic People’s Republic of Korea,2013,dtp3,93,342995,318985,24010,sear,gavi
prk,Democratic People’s Republic of Korea,2013,mcv1,99,342995,339565,3430,sear,gavi
prk,Democratic People’s Republic of Korea,2013,dtp1,94,342995,322415,20580,sear,gavi
prk,Democratic People’s Republic of Korea,2013,mcv2,99,340705,337298,3407,sear,gavi
prk,Democratic People’s Republic of Korea,2014,dtp3,93,343729,319668,24061,sear,gavi
prk,Democratic People’s Republic of Korea,2014,mcv1,99,343729,340292,3437,sear,gavi
prk,Democratic People’s Republic of Korea,2014,dtp1,94,343729,323105,20624,sear,gavi
prk,Democratic People’s Republic of Korea,2014,mcv2,99,339506,336111,3395,sear,gavi
prk,Democratic People’s Republic of Korea,2015,mcv1,98,344650,337757,6893,sear,gavi
prk,Democratic People’s Republic of Korea,2015,dtp3,96,344650,330864,13786,sear,gavi
prk,Democratic People’s Republic of Korea,2015,dtp1,97,344650,334310,10340,sear,gavi
prk,Democratic People’s Republic of Korea,2015,mcv2,97,339209,329033,10176,sear,gavi
prk,Democratic People’s Republic of Korea,2016,dtp3,96,345644,331818,13826,sear,gavi
prk,Democratic People’s Republic of Korea,2016,dtp1,97,345644,335275,10369,sear,gavi
prk,Democratic People’s Republic of Korea,2016,mcv1,99,345644,342188,3456,sear,gavi
prk,Democratic People’s Republic of Korea,2016,mcv2,98,343909,337031,6878,sear,gavi
prt,Portugal,2000,dtp1,99,112828,111700,1128,eur,hic
prt,Portugal,2000,dtp3,96,112828,108315,4513,eur,hic
prt,Portugal,2000,mcv1,87,112828,98160,14668,eur,hic
prt,Portugal,2000,mcv2,48,106004,50882,55122,eur,hic
prt,Portugal,2001,dtp1,99,112752,111624,1128,eur,hic
prt,Portugal,2001,dtp3,97,112752,109369,3383,eur,hic
prt,Portugal,2001,mcv1,90,112752,101477,11275,eur,hic
prt,Portugal,2001,mcv2,56,106069,59399,46670,eur,hic
prt,Portugal,2002,dtp3,98,112322,110076,2246,eur,hic
prt,Portugal,2002,dtp1,98,112322,110076,2246,eur,hic
prt,Portugal,2002,mcv1,93,112322,104459,7863,eur,hic
prt,Portugal,2002,mcv2,64,106230,67987,38243,eur,hic
prt,Portugal,2003,dtp3,99,111516,110401,1115,eur,hic
prt,Portugal,2003,dtp1,99,111516,110401,1115,eur,hic
prt,Portugal,2003,mcv1,96,111516,107055,4461,eur,hic
prt,Portugal,2003,mcv2,72,106459,76650,29809,eur,hic
prt,Portugal,2004,dtp3,95,110308,104793,5515,eur,hic
prt,Portugal,2004,dtp1,98,110308,108102,2206,eur,hic
prt,Portugal,2004,mcv1,95,110308,104793,5515,eur,hic
prt,Portugal,2004,mcv2,79,106777,84354,22423,eur,hic
prt,Portugal,2005,dtp1,94,108685,102164,6521,eur,hic
prt,Portugal,2005,mcv1,93,108685,101077,7608,eur,hic
prt,Portugal,2005,dtp3,93,108685,101077,7608,eur,hic
prt,Portugal,2005,mcv2,87,107216,93278,13938,eur,hic
prt,Portugal,2006,dtp3,97,106656,103456,3200,eur,hic
prt,Portugal,2006,mcv1,97,106656,103456,3200,eur,hic
prt,Portugal,2006,dtp1,99,106656,105589,1067,eur,hic
prt,Portugal,2006,mcv2,95,108470,103046,5424,eur,hic
prt,Portugal,2007,dtp3,97,104306,101177,3129,eur,hic
prt,Portugal,2007,dtp1,99,104306,103263,1043,eur,hic
prt,Portugal,2007,mcv1,95,104306,99091,5215,eur,hic
prt,Portugal,2007,mcv2,95,108968,103520,5448,eur,hic
prt,Portugal,2008,dtp1,99,101731,100714,1017,eur,hic
prt,Portugal,2008,dtp3,97,101731,98679,3052,eur,hic
prt,Portugal,2008,mcv1,97,101731,98679,3052,eur,hic
prt,Portugal,2008,mcv2,95,108471,103047,5424,eur,hic
prt,Portugal,2009,dtp3,96,99006,95046,3960,eur,hic
prt,Portugal,2009,mcv1,95,99006,94056,4950,eur,hic
prt,Portugal,2009,dtp1,97,99006,96036,2970,eur,hic
prt,Portugal,2009,mcv2,95,106732,101395,5337,eur,hic
prt,Portugal,2010,mcv1,96,96201,92353,3848,eur,hic
prt,Portugal,2010,dtp3,98,96201,94277,1924,eur,hic
prt,Portugal,2010,dtp1,99,96201,95239,962,eur,hic
prt,Portugal,2010,mcv2,95,103557,98379,5178,eur,hic
prt,Portugal,2011,mcv1,97,93365,90564,2801,eur,hic
prt,Portugal,2011,dtp3,97,93365,90564,2801,eur,hic
prt,Portugal,2011,dtp1,97,93365,90564,2801,eur,hic
prt,Portugal,2011,mcv2,96,102148,98062,4086,eur,hic
prt,Portugal,2012,dtp3,98,90546,88735,1811,eur,hic
prt,Portugal,2012,mcv1,97,90546,87830,2716,eur,hic
prt,Portugal,2012,dtp1,99,90546,89641,905,eur,hic
prt,Portugal,2012,mcv2,96,100590,96566,4024,eur,hic
prt,Portugal,2013,dtp3,98,87795,86039,1756,eur,hic
prt,Portugal,2013,mcv1,98,87795,86039,1756,eur,hic
prt,Portugal,2013,dtp1,99,87795,86917,878,eur,hic
prt,Portugal,2013,mcv2,96,98856,94902,3954,eur,hic
prt,Portugal,2014,mcv1,98,85179,83475,1704,eur,hic
prt,Portugal,2014,dtp3,98,85179,83475,1704,eur,hic
prt,Portugal,2014,dtp1,99,85179,84327,852,eur,hic
prt,Portugal,2014,mcv2,96,96945,93067,3878,eur,hic
prt,Portugal,2015,mcv1,98,82746,81091,1655,eur,hic
prt,Portugal,2015,dtp1,99,82746,81919,827,eur,hic
prt,Portugal,2015,dtp3,98,82746,81091,1655,eur,hic
prt,Portugal,2015,mcv2,95,94828,90087,4741,eur,hic
prt,Portugal,2016,dtp1,99,80521,79716,805,eur,hic
prt,Portugal,2016,mcv1,98,80521,78911,1610,eur,hic
prt,Portugal,2016,dtp3,98,80521,78911,1610,eur,hic
prt,Portugal,2016,mcv2,95,92672,88038,4634,eur,hic
pry,Paraguay,2000,dtp3,86,137992,118673,19319,amr,mic_nongavi
pry,Paraguay,2000,mcv1,92,137992,126953,11039,amr,mic_nongavi
pry,Paraguay,2000,dtp1,95,137992,131092,6900,amr,mic_nongavi
pry,Paraguay,2001,dtp3,89,136695,121659,15036,amr,mic_nongavi
pry,Paraguay,2001,mcv1,90,136695,123026,13669,amr,mic_nongavi
pry,Paraguay,2001,dtp1,96,136695,131227,5468,amr,mic_nongavi
pry,Paraguay,2002,dtp1,95,135570,128792,6778,amr,mic_nongavi
pry,Paraguay,2002,mcv1,86,135570,116590,18980,amr,mic_nongavi
pry,Paraguay,2002,dtp3,87,135570,117946,17624,amr,mic_nongavi
pry,Paraguay,2003,dtp1,95,134771,128032,6739,amr,mic_nongavi
pry,Paraguay,2003,mcv1,91,134771,122642,12129,amr,mic_nongavi
pry,Paraguay,2003,dtp3,86,134771,115903,18868,amr,mic_nongavi
pry,Paraguay,2004,dtp1,94,134357,126296,8061,amr,mic_nongavi
pry,Paraguay,2004,dtp3,92,134357,123608,10749,amr,mic_nongavi
pry,Paraguay,2004,mcv1,91,134357,122265,12092,amr,mic_nongavi
pry,Paraguay,2005,dtp3,96,134304,128932,5372,amr,mic_nongavi
pry,Paraguay,2005,dtp1,97,134304,130275,4029,amr,mic_nongavi
pry,Paraguay,2005,mcv1,91,134304,122217,12087,amr,mic_nongavi
pry,Paraguay,2005,mcv2,31,138801,43028,95773,amr,mic_nongavi
pry,Paraguay,2006,mcv1,91,134503,122398,12105,amr,mic_nongavi
pry,Paraguay,2006,dtp1,99,134503,133158,1345,amr,mic_nongavi
pry,Paraguay,2006,dtp3,98,134503,131813,2690,amr,mic_nongavi
pry,Paraguay,2006,mcv2,61,136602,83327,53275,amr,mic_nongavi
pry,Paraguay,2007,mcv1,91,134779,122649,12130,amr,mic_nongavi
pry,Paraguay,2007,dtp3,95,134779,128040,6739,amr,mic_nongavi
pry,Paraguay,2007,dtp1,99,134779,133431,1348,amr,mic_nongavi
pry,Paraguay,2007,mcv2,74,133860,99056,34804,amr,mic_nongavi
pry,Paraguay,2008,dtp3,89,134999,120149,14850,amr,mic_nongavi
pry,Paraguay,2008,dtp1,96,134999,129599,5400,amr,mic_nongavi
pry,Paraguay,2008,mcv1,91,134999,122849,12150,amr,mic_nongavi
pry,Paraguay,2008,mcv2,84,131326,110314,21012,amr,mic_nongavi
pry,Paraguay,2009,dtp1,94,135130,127022,8108,amr,mic_nongavi
pry,Paraguay,2009,mcv1,91,135130,122968,12162,amr,mic_nongavi
pry,Paraguay,2009,dtp3,85,135130,114861,20269,amr,mic_nongavi
pry,Paraguay,2009,mcv2,80,129971,103977,25994,amr,mic_nongavi
pry,Paraguay,2010,dtp1,96,135192,129784,5408,amr,mic_nongavi
pry,Paraguay,2010,mcv1,94,135192,127080,8112,amr,mic_nongavi
pry,Paraguay,2010,dtp3,89,135192,120321,14871,amr,mic_nongavi
pry,Paraguay,2010,mcv2,81,130850,105988,24862,amr,mic_nongavi
pry,Paraguay,2011,dtp3,89,135251,120373,14878,amr,mic_nongavi
pry,Paraguay,2011,mcv1,93,135251,125783,9468,amr,mic_nongavi
pry,Paraguay,2011,dtp1,96,135251,129841,5410,amr,mic_nongavi
pry,Paraguay,2011,mcv2,82,131963,108210,23753,amr,mic_nongavi
pry,Paraguay,2012,dtp3,87,135394,117793,17601,amr,mic_nongavi
pry,Paraguay,2012,mcv1,91,135394,123209,12185,amr,mic_nongavi
pry,Paraguay,2012,dtp1,96,135394,129978,5416,amr,mic_nongavi
pry,Paraguay,2012,mcv2,79,133743,105657,28086,amr,mic_nongavi
pry,Paraguay,2013,dtp3,86,135666,116673,18993,amr,mic_nongavi
pry,Paraguay,2013,mcv1,92,135666,124813,10853,amr,mic_nongavi
pry,Paraguay,2013,dtp1,93,135666,126169,9497,amr,mic_nongavi
pry,Paraguay,2013,mcv2,81,135544,109791,25753,amr,mic_nongavi
pry,Paraguay,2014,dtp3,87,136058,118370,17688,amr,mic_nongavi
pry,Paraguay,2014,mcv1,89,136058,121092,14966,amr,mic_nongavi
pry,Paraguay,2014,dtp1,98,136058,133337,2721,amr,mic_nongavi
pry,Paraguay,2014,mcv2,81,136482,110550,25932,amr,mic_nongavi
pry,Paraguay,2015,mcv1,83,136532,113322,23210,amr,mic_nongavi
pry,Paraguay,2015,dtp1,99,136532,135167,1365,amr,mic_nongavi
pry,Paraguay,2015,dtp3,93,136532,126975,9557,amr,mic_nongavi
pry,Paraguay,2015,mcv2,77,135540,104366,31174,amr,mic_nongavi
pry,Paraguay,2016,mcv1,99,137026,135656,1370,amr,mic_nongavi
pry,Paraguay,2016,dtp3,93,137026,127434,9592,amr,mic_nongavi
pry,Paraguay,2016,dtp1,99,137026,135656,1370,amr,mic_nongavi
pry,Paraguay,2016,mcv2,92,135227,124409,10818,amr,mic_nongavi
pse,State of Palestine,2000,dtp3,93,117429,109209,8220,emr,mic_nongavi
pse,State of Palestine,2000,dtp1,95,117429,111558,5871,emr,mic_nongavi
pse,State of Palestine,2000,mcv1,93,117429,109209,8220,emr,mic_nongavi
pse,State of Palestine,2000,mcv2,95,117967,112069,5898,emr,mic_nongavi
pse,State of Palestine,2001,dtp3,97,117988,114448,3540,emr,mic_nongavi
pse,State of Palestine,2001,mcv1,98,117988,115628,2360,emr,mic_nongavi
pse,State of Palestine,2001,dtp1,97,117988,114448,3540,emr,mic_nongavi
pse,State of Palestine,2001,mcv2,94,116800,109792,7008,emr,mic_nongavi
pse,State of Palestine,2002,dtp3,97,118628,115069,3559,emr,mic_nongavi
pse,State of Palestine,2002,dtp1,99,118628,117442,1186,emr,mic_nongavi
pse,State of Palestine,2002,mcv1,94,118628,111510,7118,emr,mic_nongavi
pse,State of Palestine,2002,mcv2,93,114907,106864,8043,emr,mic_nongavi
pse,State of Palestine,2003,mcv1,99,119468,118273,1195,emr,mic_nongavi
pse,State of Palestine,2003,dtp3,98,119468,117079,2389,emr,mic_nongavi
pse,State of Palestine,2003,dtp1,99,119468,118273,1195,emr,mic_nongavi
pse,State of Palestine,2003,mcv2,94,116286,109309,6977,emr,mic_nongavi
pse,State of Palestine,2004,mcv1,96,120595,115771,4824,emr,mic_nongavi
pse,State of Palestine,2004,dtp1,99,120595,119389,1206,emr,mic_nongavi
pse,State of Palestine,2004,dtp3,96,120595,115771,4824,emr,mic_nongavi
pse,State of Palestine,2004,mcv2,94,115135,108227,6908,emr,mic_nongavi
pse,State of Palestine,2005,dtp3,96,122073,117190,4883,emr,mic_nongavi
pse,State of Palestine,2005,dtp1,99,122073,120852,1221,emr,mic_nongavi
pse,State of Palestine,2005,mcv1,98,122073,119632,2441,emr,mic_nongavi
pse,State of Palestine,2005,mcv2,97,115008,111558,3450,emr,mic_nongavi
pse,State of Palestine,2006,mcv1,99,123921,122682,1239,emr,mic_nongavi
pse,State of Palestine,2006,dtp1,99,123921,122682,1239,emr,mic_nongavi
pse,State of Palestine,2006,dtp3,96,123921,118964,4957,emr,mic_nongavi
pse,State of Palestine,2006,mcv2,92,115079,105873,9206,emr,mic_nongavi
pse,State of Palestine,2007,dtp1,99,126064,124803,1261,emr,mic_nongavi
pse,State of Palestine,2007,mcv1,98,126064,123543,2521,emr,mic_nongavi
pse,State of Palestine,2007,dtp3,99,126064,124803,1261,emr,mic_nongavi
pse,State of Palestine,2007,mcv2,87,115786,100734,15052,emr,mic_nongavi
pse,State of Palestine,2008,dtp1,99,128422,127138,1284,emr,mic_nongavi
pse,State of Palestine,2008,mcv1,96,128422,123285,5137,emr,mic_nongavi
pse,State of Palestine,2008,dtp3,96,128422,123285,5137,emr,mic_nongavi
pse,State of Palestine,2008,mcv2,99,119029,117839,1190,emr,mic_nongavi
pse,State of Palestine,2009,dtp1,99,130953,129643,1310,emr,mic_nongavi
pse,State of Palestine,2009,mcv1,97,130953,127024,3929,emr,mic_nongavi
pse,State of Palestine,2009,dtp3,97,130953,127024,3929,emr,mic_nongavi
pse,State of Palestine,2009,mcv2,97,121717,118065,3652,emr,mic_nongavi
pse,State of Palestine,2010,dtp1,99,133611,132275,1336,emr,mic_nongavi
pse,State of Palestine,2010,dtp3,99,133611,132275,1336,emr,mic_nongavi
pse,State of Palestine,2010,mcv1,98,133611,130939,2672,emr,mic_nongavi
pse,State of Palestine,2010,mcv2,94,124651,117172,7479,emr,mic_nongavi
pse,State of Palestine,2011,dtp1,99,136359,134995,1364,emr,mic_nongavi
pse,State of Palestine,2011,dtp3,99,136359,134995,1364,emr,mic_nongavi
pse,State of Palestine,2011,mcv1,99,136359,134995,1364,emr,mic_nongavi
pse,State of Palestine,2011,mcv2,95,128901,122456,6445,emr,mic_nongavi
pse,State of Palestine,2012,dtp1,98,139148,136365,2783,emr,mic_nongavi
pse,State of Palestine,2012,mcv1,98,139148,136365,2783,emr,mic_nongavi
pse,State of Palestine,2012,dtp3,97,139148,134974,4174,emr,mic_nongavi
pse,State of Palestine,2012,mcv2,97,133259,129261,3998,emr,mic_nongavi
pse,State of Palestine,2013,dtp1,99,141922,140503,1419,emr,mic_nongavi
pse,State of Palestine,2013,mcv1,99,141922,140503,1419,emr,mic_nongavi
pse,State of Palestine,2013,dtp3,99,141922,140503,1419,emr,mic_nongavi
pse,State of Palestine,2013,mcv2,98,133623,130951,2672,emr,mic_nongavi
pse,State of Palestine,2014,dtp3,99,144630,143184,1446,emr,mic_nongavi
pse,State of Palestine,2014,dtp1,99,144630,143184,1446,emr,mic_nongavi
pse,State of Palestine,2014,mcv1,99,144630,143184,1446,emr,mic_nongavi
pse,State of Palestine,2014,mcv2,99,136842,135474,1368,emr,mic_nongavi
pse,State of Palestine,2015,dtp1,99,147221,145749,1472,emr,mic_nongavi
pse,State of Palestine,2015,dtp3,99,147221,145749,1472,emr,mic_nongavi
pse,State of Palestine,2015,mcv1,99,147221,145749,1472,emr,mic_nongavi
pse,State of Palestine,2015,mcv2,99,139928,138529,1399,emr,mic_nongavi
pse,State of Palestine,2016,dtp1,99,149663,148166,1497,emr,mic_nongavi
pse,State of Palestine,2016,dtp3,99,149663,148166,1497,emr,mic_nongavi
pse,State of Palestine,2016,mcv1,99,149663,148166,1497,emr,mic_nongavi
pse,State of Palestine,2016,mcv2,99,142664,141237,1427,emr,mic_nongavi
qat,Qatar,2000,dtp1,92,11693,10758,935,emr,hic
qat,Qatar,2000,mcv1,91,11693,10641,1052,emr,hic
qat,Qatar,2000,dtp3,80,11693,9354,2339,emr,hic
qat,Qatar,2001,mcv1,92,12136,11165,971,emr,hic
qat,Qatar,2001,dtp1,95,12136,11529,607,emr,hic
qat,Qatar,2001,dtp3,93,12136,11286,850,emr,hic
qat,Qatar,2002,dtp1,96,12640,12134,506,emr,hic
qat,Qatar,2002,dtp3,96,12640,12134,506,emr,hic
qat,Qatar,2002,mcv1,99,12640,12514,126,emr,hic
qat,Qatar,2002,mcv2,91,10652,9693,959,emr,hic
qat,Qatar,2003,dtp3,92,13204,12148,1056,emr,hic
qat,Qatar,2003,dtp1,96,13204,12676,528,emr,hic
qat,Qatar,2003,mcv1,93,13204,12280,924,emr,hic
qat,Qatar,2003,mcv2,91,10909,9927,982,emr,hic
qat,Qatar,2004,dtp3,96,13833,13280,553,emr,hic
qat,Qatar,2004,dtp1,99,13833,13695,138,emr,hic
qat,Qatar,2004,mcv1,99,13833,13695,138,emr,hic
qat,Qatar,2004,mcv2,95,11621,11040,581,emr,hic
qat,Qatar,2005,dtp3,97,14557,14120,437,emr,hic
qat,Qatar,2005,mcv1,99,14557,14411,146,emr,hic
qat,Qatar,2005,dtp1,99,14557,14411,146,emr,hic
qat,Qatar,2005,mcv2,98,12919,12661,258,emr,hic
qat,Qatar,2006,mcv1,99,15405,15251,154,emr,hic
qat,Qatar,2006,dtp3,96,15405,14789,616,emr,hic
qat,Qatar,2006,dtp1,99,15405,15251,154,emr,hic
qat,Qatar,2006,mcv2,87,12495,10871,1624,emr,hic
qat,Qatar,2007,mcv1,92,16387,15076,1311,emr,hic
qat,Qatar,2007,dtp3,94,16387,15404,983,emr,hic
qat,Qatar,2007,dtp1,96,16387,15732,655,emr,hic
qat,Qatar,2007,mcv2,91,14037,12774,1263,emr,hic
qat,Qatar,2008,dtp3,97,17489,16964,525,emr,hic
qat,Qatar,2008,mcv1,96,17489,16789,700,emr,hic
qat,Qatar,2008,dtp1,97,17489,16964,525,emr,hic
qat,Qatar,2008,mcv2,95,15281,14517,764,emr,hic
qat,Qatar,2009,dtp3,99,18679,18492,187,emr,hic
qat,Qatar,2009,dtp1,99,18679,18492,187,emr,hic
qat,Qatar,2009,mcv1,99,18679,18492,187,emr,hic
qat,Qatar,2009,mcv2,99,16554,16388,166,emr,hic
qat,Qatar,2010,dtp1,98,19913,19515,398,emr,hic
qat,Qatar,2010,dtp3,97,19913,19316,597,emr,hic
qat,Qatar,2010,mcv1,99,19913,19714,199,emr,hic
qat,Qatar,2010,mcv2,98,18207,17843,364,emr,hic
qat,Qatar,2011,dtp1,94,21137,19869,1268,emr,hic
qat,Qatar,2011,dtp3,93,21137,19657,1480,emr,hic
qat,Qatar,2011,mcv1,98,21137,20714,423,emr,hic
qat,Qatar,2011,mcv2,99,19857,19658,199,emr,hic
qat,Qatar,2012,dtp3,92,22295,20511,1784,emr,hic
qat,Qatar,2012,mcv1,97,22295,21626,669,emr,hic
qat,Qatar,2012,dtp1,95,22295,21180,1115,emr,hic
qat,Qatar,2012,mcv2,99,21442,21228,214,emr,hic
qat,Qatar,2013,mcv1,97,23339,22639,700,emr,hic
qat,Qatar,2013,dtp3,97,23339,22639,700,emr,hic
qat,Qatar,2013,dtp1,99,23339,23106,233,emr,hic
qat,Qatar,2013,mcv2,99,23723,23486,237,emr,hic
qat,Qatar,2014,mcv1,99,24237,23995,242,emr,hic
qat,Qatar,2014,dtp1,99,24237,23995,242,emr,hic
qat,Qatar,2014,dtp3,89,24237,21571,2666,emr,hic
qat,Qatar,2014,mcv2,95,25036,23784,1252,emr,hic
qat,Qatar,2015,dtp1,99,24966,24716,250,emr,hic
qat,Qatar,2015,dtp3,99,24966,24716,250,emr,hic
qat,Qatar,2015,mcv1,99,24966,24716,250,emr,hic
qat,Qatar,2015,mcv2,91,25808,23485,2323,emr,hic
qat,Qatar,2016,mcv1,99,25522,25267,255,emr,hic
qat,Qatar,2016,dtp1,99,25522,25267,255,emr,hic
qat,Qatar,2016,dtp3,98,25522,25012,510,emr,hic
qat,Qatar,2016,mcv2,92,26113,24024,2089,emr,hic
rou,Romania,2000,dtp3,99,218029,215849,2180,eur,mic_nongavi
rou,Romania,2000,mcv1,98,218029,213668,4361,eur,mic_nongavi
rou,Romania,2000,dtp1,99,218029,215849,2180,eur,mic_nongavi
rou,Romania,2000,mcv2,96,245471,235652,9819,eur,mic_nongavi
rou,Romania,2001,dtp1,99,216317,214154,2163,eur,mic_nongavi
rou,Romania,2001,mcv1,98,216317,211991,4326,eur,mic_nongavi
rou,Romania,2001,dtp3,99,216317,214154,2163,eur,mic_nongavi
rou,Romania,2001,mcv2,97,227025,220214,6811,eur,mic_nongavi
rou,Romania,2002,dtp3,98,215267,210962,4305,eur,mic_nongavi
rou,Romania,2002,dtp1,99,215267,213114,2153,eur,mic_nongavi
rou,Romania,2002,mcv1,98,215267,210962,4305,eur,mic_nongavi
rou,Romania,2002,mcv2,97,219003,212433,6570,eur,mic_nongavi
rou,Romania,2003,dtp1,99,214900,212751,2149,eur,mic_nongavi
rou,Romania,2003,dtp3,97,214900,208453,6447,eur,mic_nongavi
rou,Romania,2003,mcv1,97,214900,208453,6447,eur,mic_nongavi
rou,Romania,2003,mcv2,97,217823,211288,6535,eur,mic_nongavi
rou,Romania,2004,dtp3,97,214983,208534,6449,eur,mic_nongavi
rou,Romania,2004,dtp1,99,214983,212833,2150,eur,mic_nongavi
rou,Romania,2004,mcv1,97,214983,208534,6449,eur,mic_nongavi
rou,Romania,2004,mcv2,96,219842,211048,8794,eur,mic_nongavi
rou,Romania,2005,dtp3,97,215128,208674,6454,eur,mic_nongavi
rou,Romania,2005,mcv1,97,215128,208674,6454,eur,mic_nongavi
rou,Romania,2005,dtp1,99,215128,212977,2151,eur,mic_nongavi
rou,Romania,2005,mcv2,96,221710,212842,8868,eur,mic_nongavi
rou,Romania,2006,dtp3,97,214905,208458,6447,eur,mic_nongavi
rou,Romania,2006,dtp1,99,214905,212756,2149,eur,mic_nongavi
rou,Romania,2006,mcv1,95,214905,204160,10745,eur,mic_nongavi
rou,Romania,2006,mcv2,96,220929,212092,8837,eur,mic_nongavi
rou,Romania,2007,mcv1,97,214029,207608,6421,eur,mic_nongavi
rou,Romania,2007,dtp3,96,214029,205468,8561,eur,mic_nongavi
rou,Romania,2007,dtp1,98,214029,209748,4281,eur,mic_nongavi
rou,Romania,2007,mcv2,96,218723,209974,8749,eur,mic_nongavi
rou,Romania,2008,dtp3,96,212342,203848,8494,eur,mic_nongavi
rou,Romania,2008,dtp1,98,212342,208095,4247,eur,mic_nongavi
rou,Romania,2008,mcv1,96,212342,203848,8494,eur,mic_nongavi
rou,Romania,2008,mcv2,95,215620,204839,10781,eur,mic_nongavi
rou,Romania,2009,mcv1,96,209810,201418,8392,eur,mic_nongavi
rou,Romania,2009,dtp3,95,209810,199320,10490,eur,mic_nongavi
rou,Romania,2009,dtp1,98,209810,205614,4196,eur,mic_nongavi
rou,Romania,2009,mcv2,94,212445,199698,12747,eur,mic_nongavi
rou,Romania,2010,dtp1,98,206570,202439,4131,eur,mic_nongavi
rou,Romania,2010,mcv1,95,206570,196242,10328,eur,mic_nongavi
rou,Romania,2010,dtp3,94,206570,194176,12394,eur,mic_nongavi
rou,Romania,2010,mcv2,93,210004,195304,14700,eur,mic_nongavi
rou,Romania,2011,mcv1,93,202908,188704,14204,eur,mic_nongavi
rou,Romania,2011,dtp1,96,202908,194792,8116,eur,mic_nongavi
rou,Romania,2011,dtp3,89,202908,180588,22320,eur,mic_nongavi
rou,Romania,2011,mcv2,91,208309,189561,18748,eur,mic_nongavi
rou,Romania,2012,dtp3,91,199228,181297,17931,eur,mic_nongavi
rou,Romania,2012,mcv1,94,199228,187274,11954,eur,mic_nongavi
rou,Romania,2012,dtp1,97,199228,193251,5977,eur,mic_nongavi
rou,Romania,2012,mcv2,90,208314,187483,20831,eur,mic_nongavi
rou,Romania,2013,dtp3,92,195849,180181,15668,eur,mic_nongavi
rou,Romania,2013,dtp1,97,195849,189974,5875,eur,mic_nongavi
rou,Romania,2013,mcv1,92,195849,180181,15668,eur,mic_nongavi
rou,Romania,2013,mcv2,88,209235,184127,25108,eur,mic_nongavi
rou,Romania,2014,mcv1,89,192903,171684,21219,eur,mic_nongavi
rou,Romania,2014,dtp3,94,192903,181329,11574,eur,mic_nongavi
rou,Romania,2014,dtp1,98,192903,189045,3858,eur,mic_nongavi
rou,Romania,2014,mcv2,84,210191,176560,33631,eur,mic_nongavi
rou,Romania,2015,mcv1,86,190436,163775,26661,eur,mic_nongavi
rou,Romania,2015,dtp3,89,190436,169488,20948,eur,mic_nongavi
rou,Romania,2015,dtp1,96,190436,182819,7617,eur,mic_nongavi
rou,Romania,2015,mcv2,80,210377,168302,42075,eur,mic_nongavi
rou,Romania,2016,dtp3,89,188387,167664,20723,eur,mic_nongavi
rou,Romania,2016,dtp1,96,188387,180852,7535,eur,mic_nongavi
rou,Romania,2016,mcv1,86,188387,162013,26374,eur,mic_nongavi
rou,Romania,2016,mcv2,76,209441,159175,50266,eur,mic_nongavi
rus,Russian Federation,2000,dtp1,97,1303548,1264442,39106,eur,mic_nongavi
rus,Russian Federation,2000,mcv1,97,1303548,1264442,39106,eur,mic_nongavi
rus,Russian Federation,2000,dtp3,96,1303548,1251406,52142,eur,mic_nongavi
rus,Russian Federation,2000,mcv2,86,1465738,1260535,205203,eur,mic_nongavi
rus,Russian Federation,2001,mcv1,97,1331105,1291172,39933,eur,mic_nongavi
rus,Russian Federation,2001,dtp3,96,1331105,1277861,53244,eur,mic_nongavi
rus,Russian Federation,2001,dtp1,97,1331105,1291172,39933,eur,mic_nongavi
rus,Russian Federation,2001,mcv2,88,1359180,1196078,163102,eur,mic_nongavi
rus,Russian Federation,2002,dtp3,97,1365758,1324785,40973,eur,mic_nongavi
rus,Russian Federation,2002,dtp1,97,1365758,1324785,40973,eur,mic_nongavi
rus,Russian Federation,2002,mcv1,98,1365758,1338443,27315,eur,mic_nongavi
rus,Russian Federation,2002,mcv2,93,1300522,1209485,91037,eur,mic_nongavi
rus,Russian Federation,2003,dtp1,97,1404916,1362769,42147,eur,mic_nongavi
rus,Russian Federation,2003,mcv1,98,1404916,1376818,28098,eur,mic_nongavi
rus,Russian Federation,2003,dtp3,96,1404916,1348719,56197,eur,mic_nongavi
rus,Russian Federation,2003,mcv2,96,1276242,1225192,51050,eur,mic_nongavi
rus,Russian Federation,2004,dtp1,97,1446370,1402979,43391,eur,mic_nongavi
rus,Russian Federation,2004,mcv1,98,1446370,1417443,28927,eur,mic_nongavi
rus,Russian Federation,2004,dtp3,97,1446370,1402979,43391,eur,mic_nongavi
rus,Russian Federation,2004,mcv2,97,1272369,1234198,38171,eur,mic_nongavi
rus,Russian Federation,2005,dtp3,98,1489800,1460004,29796,eur,mic_nongavi
rus,Russian Federation,2005,dtp1,99,1489800,1474902,14898,eur,mic_nongavi
rus,Russian Federation,2005,mcv1,99,1489800,1474902,14898,eur,mic_nongavi
rus,Russian Federation,2005,mcv2,97,1266083,1228101,37982,eur,mic_nongavi
rus,Russian Federation,2006,dtp1,99,1536318,1520955,15363,eur,mic_nongavi
rus,Russian Federation,2006,mcv1,99,1536318,1520955,15363,eur,mic_nongavi
rus,Russian Federation,2006,dtp3,98,1536318,1505592,30726,eur,mic_nongavi
rus,Russian Federation,2006,mcv2,97,1262359,1224488,37871,eur,mic_nongavi
rus,Russian Federation,2007,mcv1,99,1586764,1570896,15868,eur,mic_nongavi
rus,Russian Federation,2007,dtp1,99,1586764,1570896,15868,eur,mic_nongavi
rus,Russian Federation,2007,dtp3,98,1586764,1555029,31735,eur,mic_nongavi
rus,Russian Federation,2007,mcv2,97,1284941,1246393,38548,eur,mic_nongavi
rus,Russian Federation,2008,dtp1,99,1640408,1624004,16404,eur,mic_nongavi
rus,Russian Federation,2008,mcv1,99,1640408,1624004,16404,eur,mic_nongavi
rus,Russian Federation,2008,dtp3,98,1640408,1607600,32808,eur,mic_nongavi
rus,Russian Federation,2008,mcv2,97,1325544,1285778,39766,eur,mic_nongavi
rus,Russian Federation,2009,mcv1,98,1694671,1660778,33893,eur,mic_nongavi
rus,Russian Federation,2009,dtp3,98,1694671,1660778,33893,eur,mic_nongavi
rus,Russian Federation,2009,dtp1,99,1694671,1677724,16947,eur,mic_nongavi
rus,Russian Federation,2009,mcv2,97,1377657,1336327,41330,eur,mic_nongavi
rus,Russian Federation,2010,dtp3,97,1745517,1693151,52366,eur,mic_nongavi
rus,Russian Federation,2010,mcv1,98,1745517,1710607,34910,eur,mic_nongavi
rus,Russian Federation,2010,dtp1,97,1745517,1693151,52366,eur,mic_nongavi
rus,Russian Federation,2010,mcv2,98,1430630,1402017,28613,eur,mic_nongavi
rus,Russian Federation,2011,mcv1,98,1788531,1752760,35771,eur,mic_nongavi
rus,Russian Federation,2011,dtp1,97,1788531,1734875,53656,eur,mic_nongavi
rus,Russian Federation,2011,dtp3,97,1788531,1734875,53656,eur,mic_nongavi
rus,Russian Federation,2011,mcv2,97,1478850,1434484,44366,eur,mic_nongavi
rus,Russian Federation,2012,dtp1,97,1820627,1766008,54619,eur,mic_nongavi
rus,Russian Federation,2012,mcv1,98,1820627,1784214,36413,eur,mic_nongavi
rus,Russian Federation,2012,dtp3,97,1820627,1766008,54619,eur,mic_nongavi
rus,Russian Federation,2012,mcv2,97,1517775,1472242,45533,eur,mic_nongavi
rus,Russian Federation,2013,mcv1,98,1839845,1803048,36797,eur,mic_nongavi
rus,Russian Federation,2013,dtp3,97,1839845,1784650,55195,eur,mic_nongavi
rus,Russian Federation,2013,dtp1,97,1839845,1784650,55195,eur,mic_nongavi
rus,Russian Federation,2013,mcv2,97,1552707,1506126,46581,eur,mic_nongavi
rus,Russian Federation,2014,dtp3,97,1845458,1790094,55364,eur,mic_nongavi
rus,Russian Federation,2014,mcv1,98,1845458,1808549,36909,eur,mic_nongavi
rus,Russian Federation,2014,dtp1,97,1845458,1790094,55364,eur,mic_nongavi
rus,Russian Federation,2014,mcv2,97,1588800,1541136,47664,eur,mic_nongavi
rus,Russian Federation,2015,dtp1,97,1838022,1782881,55141,eur,mic_nongavi
rus,Russian Federation,2015,mcv1,98,1838022,1801262,36760,eur,mic_nongavi
rus,Russian Federation,2015,dtp3,97,1838022,1782881,55141,eur,mic_nongavi
rus,Russian Federation,2015,mcv2,97,1634584,1585546,49038,eur,mic_nongavi
rus,Russian Federation,2016,dtp1,97,1819539,1764953,54586,eur,mic_nongavi
rus,Russian Federation,2016,dtp3,97,1819539,1764953,54586,eur,mic_nongavi
rus,Russian Federation,2016,mcv1,98,1819539,1783148,36391,eur,mic_nongavi
rus,Russian Federation,2016,mcv2,97,1692848,1642063,50785,eur,mic_nongavi
rwa,Rwanda,2000,mcv1,74,277715,205509,72206,afr,gavi
rwa,Rwanda,2000,dtp1,93,277715,258275,19440,afr,gavi
rwa,Rwanda,2000,dtp3,90,277715,249944,27771,afr,gavi
rwa,Rwanda,2001,dtp1,94,286646,269447,17199,afr,gavi
rwa,Rwanda,2001,mcv1,69,286646,197786,88860,afr,gavi
rwa,Rwanda,2001,dtp3,77,286646,220717,65929,afr,gavi
rwa,Rwanda,2002,dtp1,95,294970,280221,14749,afr,gavi
rwa,Rwanda,2002,dtp3,88,294970,259574,35396,afr,gavi
rwa,Rwanda,2002,mcv1,69,294970,203529,91441,afr,gavi
rwa,Rwanda,2003,dtp3,96,303040,290918,12122,afr,gavi
rwa,Rwanda,2003,dtp1,97,303040,293949,9091,afr,gavi
rwa,Rwanda,2003,mcv1,90,303040,272736,30304,afr,gavi
rwa,Rwanda,2004,dtp1,94,310768,292122,18646,afr,gavi
rwa,Rwanda,2004,dtp3,89,310768,276584,34184,afr,gavi
rwa,Rwanda,2004,mcv1,84,310768,261045,49723,afr,gavi
rwa,Rwanda,2005,dtp1,95,318017,302116,15901,afr,gavi
rwa,Rwanda,2005,dtp3,95,318017,302116,15901,afr,gavi
rwa,Rwanda,2005,mcv1,89,318017,283035,34982,afr,gavi
rwa,Rwanda,2006,dtp3,99,324650,321404,3246,afr,gavi
rwa,Rwanda,2006,dtp1,99,324650,321404,3246,afr,gavi
rwa,Rwanda,2006,mcv1,95,324650,308418,16232,afr,gavi
rwa,Rwanda,2007,dtp3,97,330595,320677,9918,afr,gavi
rwa,Rwanda,2007,mcv1,94,330595,310759,19836,afr,gavi
rwa,Rwanda,2007,dtp1,99,330595,327289,3306,afr,gavi
rwa,Rwanda,2008,mcv1,92,335810,308945,26865,afr,gavi
rwa,Rwanda,2008,dtp1,97,335810,325736,10074,afr,gavi
rwa,Rwanda,2008,dtp3,97,335810,325736,10074,afr,gavi
rwa,Rwanda,2009,dtp1,98,340289,333483,6806,afr,gavi
rwa,Rwanda,2009,mcv1,95,340289,323275,17014,afr,gavi
rwa,Rwanda,2009,dtp3,97,340289,330080,10209,afr,gavi
rwa,Rwanda,2010,dtp1,98,344051,337170,6881,afr,gavi
rwa,Rwanda,2010,dtp3,97,344051,333729,10322,afr,gavi
rwa,Rwanda,2010,mcv1,95,344051,326848,17203,afr,gavi
rwa,Rwanda,2011,mcv1,95,347154,329796,17358,afr,gavi
rwa,Rwanda,2011,dtp1,98,347154,340211,6943,afr,gavi
rwa,Rwanda,2011,dtp3,97,347154,336739,10415,afr,gavi
rwa,Rwanda,2012,dtp3,98,349729,342734,6995,afr,gavi
rwa,Rwanda,2012,mcv1,97,349729,339237,10492,afr,gavi
rwa,Rwanda,2012,dtp1,99,349729,346232,3497,afr,gavi
rwa,Rwanda,2013,dtp3,98,351911,344873,7038,afr,gavi
rwa,Rwanda,2013,mcv1,95,351911,334315,17596,afr,gavi
rwa,Rwanda,2013,dtp1,99,351911,348392,3519,afr,gavi
rwa,Rwanda,2014,dtp3,98,353792,346716,7076,afr,gavi
rwa,Rwanda,2014,mcv1,97,353792,343178,10614,afr,gavi
rwa,Rwanda,2014,dtp1,99,353792,350254,3538,afr,gavi
rwa,Rwanda,2015,dtp1,99,355426,351872,3554,afr,gavi
rwa,Rwanda,2015,dtp3,98,355426,348317,7109,afr,gavi
rwa,Rwanda,2015,mcv1,96,355426,341209,14217,afr,gavi
rwa,Rwanda,2015,mcv2,87,348486,303183,45303,afr,gavi
rwa,Rwanda,2016,dtp3,98,356828,349691,7137,afr,gavi
rwa,Rwanda,2016,dtp1,99,356828,353260,3568,afr,gavi
rwa,Rwanda,2016,mcv1,95,356828,338987,17841,afr,gavi
rwa,Rwanda,2016,mcv2,90,348824,313942,34882,afr,gavi
sau,Saudi Arabia,2000,mcv1,94,542651,510092,32559,emr,hic
sau,Saudi Arabia,2000,dtp1,95,542651,515518,27133,emr,hic
sau,Saudi Arabia,2000,dtp3,95,542651,515518,27133,emr,hic
sau,Saudi Arabia,2001,mcv1,94,546001,513241,32760,emr,hic
sau,Saudi Arabia,2001,dtp1,99,546001,540541,5460,emr,hic
sau,Saudi Arabia,2001,dtp3,97,546001,529621,16380,emr,hic
sau,Saudi Arabia,2001,mcv2,96,545421,523604,21817,emr,hic
sau,Saudi Arabia,2002,dtp1,97,551031,534500,16531,emr,hic
sau,Saudi Arabia,2002,dtp3,95,551031,523479,27552,emr,hic
sau,Saudi Arabia,2002,mcv1,97,551031,534500,16531,emr,hic
sau,Saudi Arabia,2002,mcv2,96,535662,514236,21426,emr,hic
sau,Saudi Arabia,2003,dtp1,96,557156,534870,22286,emr,hic
sau,Saudi Arabia,2003,dtp3,95,557156,529298,27858,emr,hic
sau,Saudi Arabia,2003,mcv1,96,557156,534870,22286,emr,hic
sau,Saudi Arabia,2003,mcv2,97,527706,511875,15831,emr,hic
sau,Saudi Arabia,2004,dtp1,96,564012,541452,22560,emr,hic
sau,Saudi Arabia,2004,dtp3,96,564012,541452,22560,emr,hic
sau,Saudi Arabia,2004,mcv1,97,564012,547092,16920,emr,hic
sau,Saudi Arabia,2004,mcv2,97,524230,508503,15727,emr,hic
sau,Saudi Arabia,2005,dtp1,97,571103,553970,17133,emr,hic
sau,Saudi Arabia,2005,dtp3,96,571103,548259,22844,emr,hic
sau,Saudi Arabia,2005,mcv1,97,571103,553970,17133,emr,hic
sau,Saudi Arabia,2005,mcv2,97,528594,512736,15858,emr,hic
sau,Saudi Arabia,2006,dtp3,96,577932,554815,23117,emr,hic
sau,Saudi Arabia,2006,mcv1,95,577932,549035,28897,emr,hic
sau,Saudi Arabia,2006,dtp1,97,577932,560594,17338,emr,hic
sau,Saudi Arabia,2006,mcv2,97,532033,516072,15961,emr,hic
sau,Saudi Arabia,2007,mcv1,96,584190,560822,23368,emr,hic
sau,Saudi Arabia,2007,dtp3,96,584190,560822,23368,emr,hic
sau,Saudi Arabia,2007,dtp1,97,584190,566664,17526,emr,hic
sau,Saudi Arabia,2007,mcv2,98,538612,527840,10772,emr,hic
sau,Saudi Arabia,2008,dtp3,98,589668,577875,11793,emr,hic
sau,Saudi Arabia,2008,dtp1,98,589668,577875,11793,emr,hic
sau,Saudi Arabia,2008,mcv1,97,589668,571978,17690,emr,hic
sau,Saudi Arabia,2008,mcv2,98,546915,535977,10938,emr,hic
sau,Saudi Arabia,2009,dtp3,98,594255,582370,11885,emr,hic
sau,Saudi Arabia,2009,dtp1,98,594255,582370,11885,emr,hic
sau,Saudi Arabia,2009,mcv1,98,594255,582370,11885,emr,hic
sau,Saudi Arabia,2009,mcv2,98,555001,543901,11100,emr,hic
sau,Saudi Arabia,2010,dtp1,98,598196,586232,11964,emr,hic
sau,Saudi Arabia,2010,mcv1,98,598196,586232,11964,emr,hic
sau,Saudi Arabia,2010,dtp3,98,598196,586232,11964,emr,hic
sau,Saudi Arabia,2010,mcv2,98,560187,548983,11204,emr,hic
sau,Saudi Arabia,2011,dtp1,99,601959,595939,6020,emr,hic
sau,Saudi Arabia,2011,mcv1,98,601959,589920,12039,emr,hic
sau,Saudi Arabia,2011,dtp3,98,601959,589920,12039,emr,hic
sau,Saudi Arabia,2011,mcv2,97,564536,547600,16936,emr,hic
sau,Saudi Arabia,2012,dtp3,98,605940,593821,12119,emr,hic
sau,Saudi Arabia,2012,mcv1,98,605940,593821,12119,emr,hic
sau,Saudi Arabia,2012,dtp1,98,605940,593821,12119,emr,hic
sau,Saudi Arabia,2012,mcv2,98,547831,536874,10957,emr,hic
sau,Saudi Arabia,2013,mcv1,98,610260,598055,12205,emr,hic
sau,Saudi Arabia,2013,dtp3,98,610260,598055,12205,emr,hic
sau,Saudi Arabia,2013,dtp1,98,610260,598055,12205,emr,hic
sau,Saudi Arabia,2013,mcv2,99,554084,548543,5541,emr,hic
sau,Saudi Arabia,2014,dtp3,98,614702,602408,12294,emr,hic
sau,Saudi Arabia,2014,mcv1,98,614702,602408,12294,emr,hic
sau,Saudi Arabia,2014,dtp1,99,614702,608555,6147,emr,hic
sau,Saudi Arabia,2014,mcv2,98,560324,549118,11206,emr,hic
sau,Saudi Arabia,2015,mcv1,98,618733,606358,12375,emr,hic
sau,Saudi Arabia,2015,dtp1,98,618733,606358,12375,emr,hic
sau,Saudi Arabia,2015,dtp3,98,618733,606358,12375,emr,hic
sau,Saudi Arabia,2015,mcv2,96,564851,542257,22594,emr,hic
sau,Saudi Arabia,2016,mcv1,98,621648,609215,12433,emr,hic
sau,Saudi Arabia,2016,dtp1,98,621648,609215,12433,emr,hic
sau,Saudi Arabia,2016,dtp3,98,621648,609215,12433,emr,hic
sau,Saudi Arabia,2016,mcv2,96,568575,545832,22743,emr,hic
sdn,Sudan,2000,mcv1,58,1266938,734824,532114,emr,gavi
sdn,Sudan,2000,dtp1,75,1266938,950204,316734,emr,gavi
sdn,Sudan,2000,dtp3,62,1266938,785502,481436,emr,gavi
sdn,Sudan,2001,dtp1,79,1293249,1021667,271582,emr,gavi
sdn,Sudan,2001,mcv1,58,1293249,750084,543165,emr,gavi
sdn,Sudan,2001,dtp3,66,1293249,853544,439705,emr,gavi
sdn,Sudan,2002,dtp1,75,1319446,989585,329861,emr,gavi
sdn,Sudan,2002,dtp3,60,1319446,791668,527778,emr,gavi
sdn,Sudan,2002,mcv1,58,1319446,765279,554167,emr,gavi
sdn,Sudan,2003,dtp1,83,1345400,1116682,228718,emr,gavi
sdn,Sudan,2003,dtp3,69,1345400,928326,417074,emr,gavi
sdn,Sudan,2003,mcv1,65,1345400,874510,470890,emr,gavi
sdn,Sudan,2004,dtp1,82,1371017,1124234,246783,emr,gavi
sdn,Sudan,2004,dtp3,74,1371017,1014553,356464,emr,gavi
sdn,Sudan,2004,mcv1,67,1371017,918581,452436,emr,gavi
sdn,Sudan,2005,mcv1,69,1396157,963348,432809,emr,gavi
sdn,Sudan,2005,dtp1,88,1396157,1228618,167539,emr,gavi
sdn,Sudan,2005,dtp3,78,1396157,1089002,307155,emr,gavi
sdn,Sudan,2006,dtp3,78,1420710,1108154,312556,emr,gavi
sdn,Sudan,2006,dtp1,91,1420710,1292846,127864,emr,gavi
sdn,Sudan,2006,mcv1,73,1420710,1037118,383592,emr,gavi
sdn,Sudan,2007,dtp3,84,1444704,1213551,231153,emr,gavi
sdn,Sudan,2007,dtp1,95,1444704,1372469,72235,emr,gavi
sdn,Sudan,2007,mcv1,79,1444704,1141316,303388,emr,gavi
sdn,Sudan,2008,mcv1,79,1468218,1159892,308326,emr,gavi
sdn,Sudan,2008,dtp3,86,1468218,1262667,205551,emr,gavi
sdn,Sudan,2008,dtp1,96,1468218,1409489,58729,emr,gavi
sdn,Sudan,2009,mcv1,82,1491350,1222907,268443,emr,gavi
sdn,Sudan,2009,dtp1,92,1491350,1372042,119308,emr,gavi
sdn,Sudan,2009,dtp3,81,1491350,1207994,283356,emr,gavi
sdn,Sudan,2010,dtp3,90,1514235,1362812,151423,emr,gavi
sdn,Sudan,2010,dtp1,99,1514235,1499093,15142,emr,gavi
sdn,Sudan,2010,mcv1,90,1514235,1362812,151423,emr,gavi
sdn,Sudan,2011,dtp3,93,1174528,1092311,82217,emr,gavi
sdn,Sudan,2011,mcv1,87,1174528,1021839,152689,emr,gavi
sdn,Sudan,2011,dtp1,97,1174528,1139292,35236,emr,gavi
sdn,Sudan,2012,dtp1,97,1187480,1151856,35624,emr,gavi
sdn,Sudan,2012,dtp3,92,1187480,1092482,94998,emr,gavi
sdn,Sudan,2012,mcv1,85,1187480,1009358,178122,emr,gavi
sdn,Sudan,2012,mcv2,24,1131993,271678,860315,emr,gavi
sdn,Sudan,2013,dtp3,93,1200956,1116889,84067,emr,gavi
sdn,Sudan,2013,dtp1,97,1200956,1164927,36029,emr,gavi
sdn,Sudan,2013,mcv1,85,1200956,1020813,180143,emr,gavi
sdn,Sudan,2013,mcv2,57,1141711,650775,490936,emr,gavi
sdn,Sudan,2014,mcv1,86,1215144,1045024,170120,emr,gavi
sdn,Sudan,2014,dtp3,94,1215144,1142235,72909,emr,gavi
sdn,Sudan,2014,dtp1,98,1215144,1190841,24303,emr,gavi
sdn,Sudan,2014,mcv2,61,1155625,704931,450694,emr,gavi
sdn,Sudan,2015,dtp1,97,1230209,1193303,36906,emr,gavi
sdn,Sudan,2015,dtp3,93,1230209,1144094,86115,emr,gavi
sdn,Sudan,2015,mcv1,87,1230209,1070282,159927,emr,gavi
sdn,Sudan,2015,mcv2,69,1170836,807877,362959,emr,gavi
sdn,Sudan,2016,mcv1,86,1246235,1071762,174473,emr,gavi
sdn,Sudan,2016,dtp1,97,1246235,1208848,37387,emr,gavi
sdn,Sudan,2016,dtp3,93,1246235,1158999,87236,emr,gavi
sdn,Sudan,2016,mcv2,69,1187259,819209,368050,emr,gavi
sen,Senegal,2000,dtp3,52,364048,189305,174743,afr,gavi
sen,Senegal,2000,dtp1,79,364048,287598,76450,afr,gavi
sen,Senegal,2000,mcv1,48,364048,174743,189305,afr,gavi
sen,Senegal,2001,dtp1,79,371872,293779,78093,afr,gavi
sen,Senegal,2001,mcv1,48,371872,178499,193373,afr,gavi
sen,Senegal,2001,dtp3,52,371872,193373,178499,afr,gavi
sen,Senegal,2002,dtp1,70,380501,266351,114150,afr,gavi
sen,Senegal,2002,mcv1,54,380501,205471,175030,afr,gavi
sen,Senegal,2002,dtp3,60,380501,228301,152200,afr,gavi
sen,Senegal,2003,dtp3,73,389952,284665,105287,afr,gavi
sen,Senegal,2003,dtp1,81,389952,315861,74091,afr,gavi
sen,Senegal,2003,mcv1,60,389952,233971,155981,afr,gavi
sen,Senegal,2004,dtp1,95,400199,380189,20010,afr,gavi
sen,Senegal,2004,dtp3,87,400199,348173,52026,afr,gavi
sen,Senegal,2004,mcv1,57,400199,228113,172086,afr,gavi
sen,Senegal,2005,dtp1,97,411238,398901,12337,afr,gavi
sen,Senegal,2005,dtp3,84,411238,345440,65798,afr,gavi
sen,Senegal,2005,mcv1,74,411238,304316,106922,afr,gavi
sen,Senegal,2006,dtp3,89,423030,376497,46533,afr,gavi
sen,Senegal,2006,dtp1,99,423030,418800,4230,afr,gavi
sen,Senegal,2006,mcv1,80,423030,338424,84606,afr,gavi
sen,Senegal,2007,dtp3,94,435363,409241,26122,afr,gavi
sen,Senegal,2007,mcv1,84,435363,365705,69658,afr,gavi
sen,Senegal,2007,dtp1,97,435363,422302,13061,afr,gavi
sen,Senegal,2008,dtp1,94,447957,421080,26877,afr,gavi
sen,Senegal,2008,mcv1,77,447957,344927,103030,afr,gavi
sen,Senegal,2008,dtp3,88,447957,394202,53755,afr,gavi
sen,Senegal,2009,dtp1,94,460540,432908,27632,afr,gavi
sen,Senegal,2009,mcv1,79,460540,363827,96713,afr,gavi
sen,Senegal,2009,dtp3,86,460540,396064,64476,afr,gavi
sen,Senegal,2010,dtp1,96,472755,453845,18910,afr,gavi
sen,Senegal,2010,mcv1,81,472755,382932,89823,afr,gavi
sen,Senegal,2010,dtp3,89,472755,420752,52003,afr,gavi
sen,Senegal,2011,mcv1,84,484263,406781,77482,afr,gavi
sen,Senegal,2011,dtp1,97,484263,469735,14528,afr,gavi
sen,Senegal,2011,dtp3,92,484263,445522,38741,afr,gavi
sen,Senegal,2012,dtp1,96,494902,475106,19796,afr,gavi
sen,Senegal,2012,dtp3,91,494902,450361,44541,afr,gavi
sen,Senegal,2012,mcv1,83,494902,410769,84133,afr,gavi
sen,Senegal,2013,dtp3,92,504595,464227,40368,afr,gavi
sen,Senegal,2013,mcv1,84,504595,423860,80735,afr,gavi
sen,Senegal,2013,dtp1,96,504595,484411,20184,afr,gavi
sen,Senegal,2014,dtp3,89,513319,456854,56465,afr,gavi
sen,Senegal,2014,mcv1,80,513319,410655,102664,afr,gavi
sen,Senegal,2014,dtp1,94,513319,482520,30799,afr,gavi
sen,Senegal,2014,mcv2,13,487735,63406,424329,afr,gavi
sen,Senegal,2015,dtp1,94,521142,489873,31269,afr,gavi
sen,Senegal,2015,dtp3,89,521142,463816,57326,afr,gavi
sen,Senegal,2015,mcv1,80,521142,416914,104228,afr,gavi
sen,Senegal,2015,mcv2,54,499207,269572,229635,afr,gavi
sen,Senegal,2016,dtp1,96,528240,507110,21130,afr,gavi
sen,Senegal,2016,mcv1,93,528240,491263,36977,afr,gavi
sen,Senegal,2016,dtp3,93,528240,491263,36977,afr,gavi
sen,Senegal,2016,mcv2,75,510520,382890,127630,afr,gavi
sgp,Singapore,2000,dtp1,98,49555,48564,991,wpr,hic
sgp,Singapore,2000,dtp3,98,49555,48564,991,wpr,hic
sgp,Singapore,2000,mcv1,96,49555,47573,1982,wpr,hic
sgp,Singapore,2000,mcv2,98,57787,56631,1156,wpr,hic
sgp,Singapore,2001,dtp1,98,48579,47607,972,wpr,hic
sgp,Singapore,2001,mcv1,95,48579,46150,2429,wpr,hic
sgp,Singapore,2001,dtp3,96,48579,46636,1943,wpr,hic
sgp,Singapore,2001,mcv2,96,59557,57175,2382,wpr,hic
sgp,Singapore,2002,dtp3,94,47851,44980,2871,wpr,hic
sgp,Singapore,2002,mcv1,94,47851,44980,2871,wpr,hic
sgp,Singapore,2002,dtp1,98,47851,46894,957,wpr,hic
sgp,Singapore,2002,mcv2,96,60597,58173,2424,wpr,hic
sgp,Singapore,2003,dtp1,96,47378,45483,1895,wpr,hic
sgp,Singapore,2003,dtp3,96,47378,45483,1895,wpr,hic
sgp,Singapore,2003,mcv1,93,47378,44062,3316,wpr,hic
sgp,Singapore,2003,mcv2,96,61017,58576,2441,wpr,hic
sgp,Singapore,2004,dtp3,95,47166,44808,2358,wpr,hic
sgp,Singapore,2004,dtp1,96,47166,45279,1887,wpr,hic
sgp,Singapore,2004,mcv1,95,47166,44808,2358,wpr,hic
sgp,Singapore,2004,mcv2,96,61034,58593,2441,wpr,hic
sgp,Singapore,2005,dtp3,96,47197,45309,1888,wpr,hic
sgp,Singapore,2005,mcv1,96,47197,45309,1888,wpr,hic
sgp,Singapore,2005,dtp1,96,47197,45309,1888,wpr,hic
sgp,Singapore,2005,mcv2,95,60973,57924,3049,wpr,hic
sgp,Singapore,2006,dtp3,95,47416,45045,2371,wpr,hic
sgp,Singapore,2006,dtp1,96,47416,45519,1897,wpr,hic
sgp,Singapore,2006,mcv1,95,47416,45045,2371,wpr,hic
sgp,Singapore,2006,mcv2,96,62834,60321,2513,wpr,hic
sgp,Singapore,2007,dtp3,97,47737,46305,1432,wpr,hic
sgp,Singapore,2007,dtp1,98,47737,46782,955,wpr,hic
sgp,Singapore,2007,mcv1,95,47737,45350,2387,wpr,hic
sgp,Singapore,2007,mcv2,96,63999,61439,2560,wpr,hic
sgp,Singapore,2008,dtp1,98,48081,47119,962,wpr,hic
sgp,Singapore,2008,dtp3,97,48081,46639,1442,wpr,hic
sgp,Singapore,2008,mcv1,95,48081,45677,2404,wpr,hic
sgp,Singapore,2008,mcv2,96,57521,55220,2301,wpr,hic
sgp,Singapore,2009,dtp3,97,48406,46954,1452,wpr,hic
sgp,Singapore,2009,mcv1,95,48406,45986,2420,wpr,hic
sgp,Singapore,2009,dtp1,98,48406,47438,968,wpr,hic
sgp,Singapore,2009,mcv2,95,56870,54026,2844,wpr,hic
sgp,Singapore,2010,dtp3,96,48681,46734,1947,wpr,hic
sgp,Singapore,2010,dtp1,98,48681,47707,974,wpr,hic
sgp,Singapore,2010,mcv1,95,48681,46247,2434,wpr,hic
sgp,Singapore,2010,mcv2,95,56444,53622,2822,wpr,hic
sgp,Singapore,2011,dtp1,97,48899,47432,1467,wpr,hic
sgp,Singapore,2011,mcv1,95,48899,46454,2445,wpr,hic
sgp,Singapore,2011,dtp3,96,48899,46943,1956,wpr,hic
sgp,Singapore,2011,mcv2,96,56116,53871,2245,wpr,hic
sgp,Singapore,2012,dtp3,97,49080,47608,1472,wpr,hic
sgp,Singapore,2012,mcv1,95,49080,46626,2454,wpr,hic
sgp,Singapore,2012,dtp1,98,49080,48098,982,wpr,hic
sgp,Singapore,2012,mcv2,90,55844,50260,5584,wpr,hic
sgp,Singapore,2013,dtp3,97,49242,47765,1477,wpr,hic
sgp,Singapore,2013,mcv1,95,49242,46780,2462,wpr,hic
sgp,Singapore,2013,dtp1,98,49242,48257,985,wpr,hic
sgp,Singapore,2013,mcv2,90,55615,50054,5561,wpr,hic
sgp,Singapore,2014,mcv1,95,49382,46913,2469,wpr,hic
sgp,Singapore,2014,dtp1,98,49382,48394,988,wpr,hic
sgp,Singapore,2014,dtp3,96,49382,47407,1975,wpr,hic
sgp,Singapore,2014,mcv2,90,55423,49881,5542,wpr,hic
sgp,Singapore,2015,mcv1,95,49502,47027,2475,wpr,hic
sgp,Singapore,2015,dtp1,98,49502,48512,990,wpr,hic
sgp,Singapore,2015,dtp3,96,49502,47522,1980,wpr,hic
sgp,Singapore,2015,mcv2,90,55221,49699,5522,wpr,hic
sgp,Singapore,2016,dtp3,97,49606,48118,1488,wpr,hic
sgp,Singapore,2016,dtp1,98,49606,48614,992,wpr,hic
sgp,Singapore,2016,mcv1,95,49606,47126,2480,wpr,hic
sgp,Singapore,2016,mcv2,88,55266,48634,6632,wpr,hic
slb,Solomon Islands,2000,mcv1,91,13880,12631,1249,wpr,gavi
slb,Solomon Islands,2000,dtp3,86,13880,11937,1943,wpr,gavi
slb,Solomon Islands,2000,dtp1,95,13880,13186,694,wpr,gavi
slb,Solomon Islands,2001,dtp1,84,14212,11938,2274,wpr,gavi
slb,Solomon Islands,2001,dtp3,84,14212,11938,2274,wpr,gavi
slb,Solomon Islands,2001,mcv1,83,14212,11796,2416,wpr,gavi
slb,Solomon Islands,2002,dtp1,82,14558,11938,2620,wpr,gavi
slb,Solomon Islands,2002,mcv1,78,14558,11355,3203,wpr,gavi
slb,Solomon Islands,2002,dtp3,78,14558,11355,3203,wpr,gavi
slb,Solomon Islands,2003,dtp1,86,14907,12820,2087,wpr,gavi
slb,Solomon Islands,2003,mcv1,82,14907,12224,2683,wpr,gavi
slb,Solomon Islands,2003,dtp3,84,14907,12522,2385,wpr,gavi
slb,Solomon Islands,2004,dtp1,91,15252,13879,1373,wpr,gavi
slb,Solomon Islands,2004,mcv1,87,15252,13269,1983,wpr,gavi
slb,Solomon Islands,2004,dtp3,90,15252,13727,1525,wpr,gavi
slb,Solomon Islands,2005,dtp1,93,15574,14484,1090,wpr,gavi
slb,Solomon Islands,2005,dtp3,89,15574,13861,1713,wpr,gavi
slb,Solomon Islands,2005,mcv1,87,15574,13549,2025,wpr,gavi
slb,Solomon Islands,2006,dtp3,99,15862,15703,159,wpr,gavi
slb,Solomon Islands,2006,dtp1,99,15862,15703,159,wpr,gavi
slb,Solomon Islands,2006,mcv1,99,15862,15703,159,wpr,gavi
slb,Solomon Islands,2007,dtp3,90,16107,14496,1611,wpr,gavi
slb,Solomon Islands,2007,dtp1,96,16107,15463,644,wpr,gavi
slb,Solomon Islands,2007,mcv1,95,16107,15302,805,wpr,gavi
slb,Solomon Islands,2008,dtp3,89,16305,14511,1794,wpr,gavi
slb,Solomon Islands,2008,mcv1,77,16305,12555,3750,wpr,gavi
slb,Solomon Islands,2008,dtp1,90,16305,14674,1631,wpr,gavi
slb,Solomon Islands,2009,dtp1,94,16456,15469,987,wpr,gavi
slb,Solomon Islands,2009,mcv1,77,16456,12671,3785,wpr,gavi
slb,Solomon Islands,2009,dtp3,92,16456,15140,1316,wpr,gavi
slb,Solomon Islands,2010,dtp1,97,16560,16063,497,wpr,gavi
slb,Solomon Islands,2010,mcv1,85,16560,14076,2484,wpr,gavi
slb,Solomon Islands,2010,dtp3,90,16560,14904,1656,wpr,gavi
slb,Solomon Islands,2011,mcv1,90,16624,14962,1662,wpr,gavi
slb,Solomon Islands,2011,dtp1,99,16624,16458,166,wpr,gavi
slb,Solomon Islands,2011,dtp3,99,16624,16458,166,wpr,gavi
slb,Solomon Islands,2012,mcv1,99,16661,16494,167,wpr,gavi
slb,Solomon Islands,2012,dtp3,99,16661,16494,167,wpr,gavi
slb,Solomon Islands,2012,dtp1,99,16661,16494,167,wpr,gavi
slb,Solomon Islands,2013,dtp3,94,16686,15685,1001,wpr,gavi
slb,Solomon Islands,2013,mcv1,93,16686,15518,1168,wpr,gavi
slb,Solomon Islands,2013,dtp1,99,16686,16519,167,wpr,gavi
slb,Solomon Islands,2014,dtp3,88,16706,14701,2005,wpr,gavi
slb,Solomon Islands,2014,mcv1,93,16706,15537,1169,wpr,gavi
slb,Solomon Islands,2014,dtp1,95,16706,15871,835,wpr,gavi
slb,Solomon Islands,2015,mcv1,92,16731,15393,1338,wpr,gavi
slb,Solomon Islands,2015,dtp3,98,16731,16396,335,wpr,gavi
slb,Solomon Islands,2015,dtp1,99,16731,16564,167,wpr,gavi
slb,Solomon Islands,2016,dtp1,99,16766,16598,168,wpr,gavi
slb,Solomon Islands,2016,dtp3,99,16766,16598,168,wpr,gavi
slb,Solomon Islands,2016,mcv1,99,16766,16598,168,wpr,gavi
sle,Sierra Leone,2000,mcv1,37,183703,67970,115733,afr,gavi
sle,Sierra Leone,2000,dtp3,44,183703,80829,102874,afr,gavi
sle,Sierra Leone,2000,dtp1,64,183703,117570,66133,afr,gavi
sle,Sierra Leone,2001,dtp1,58,188857,109537,79320,afr,gavi
sle,Sierra Leone,2001,mcv1,50,188857,94428,94429,afr,gavi
sle,Sierra Leone,2001,dtp3,38,188857,71766,117091,afr,gavi
sle,Sierra Leone,2002,dtp1,89,194511,173115,21396,afr,gavi
sle,Sierra Leone,2002,mcv1,62,194511,120597,73914,afr,gavi
sle,Sierra Leone,2002,dtp3,53,194511,103091,91420,afr,gavi
sle,Sierra Leone,2003,dtp1,90,200373,180336,20037,afr,gavi
sle,Sierra Leone,2003,dtp3,73,200373,146272,54101,afr,gavi
sle,Sierra Leone,2003,mcv1,73,200373,146272,54101,afr,gavi
sle,Sierra Leone,2004,dtp1,82,206207,169090,37117,afr,gavi
sle,Sierra Leone,2004,dtp3,65,206207,134035,72172,afr,gavi
sle,Sierra Leone,2004,mcv1,76,206207,156717,49490,afr,gavi
sle,Sierra Leone,2005,mcv1,71,211708,150313,61395,afr,gavi
sle,Sierra Leone,2005,dtp1,80,211708,169366,42342,afr,gavi
sle,Sierra Leone,2005,dtp3,65,211708,137610,74098,afr,gavi
sle,Sierra Leone,2006,dtp3,64,216593,138620,77973,afr,gavi
sle,Sierra Leone,2006,dtp1,79,216593,171108,45485,afr,gavi
sle,Sierra Leone,2006,mcv1,65,216593,140785,75808,afr,gavi
sle,Sierra Leone,2007,dtp3,64,220750,141280,79470,afr,gavi
sle,Sierra Leone,2007,mcv1,60,220750,132450,88300,afr,gavi
sle,Sierra Leone,2007,dtp1,77,220750,169978,50772,afr,gavi
sle,Sierra Leone,2008,mcv1,73,224139,163621,60518,afr,gavi
sle,Sierra Leone,2008,dtp3,77,224139,172587,51552,afr,gavi
sle,Sierra Leone,2008,dtp1,84,224139,188277,35862,afr,gavi
sle,Sierra Leone,2009,dtp1,94,226759,213153,13606,afr,gavi
sle,Sierra Leone,2009,dtp3,84,226759,190478,36281,afr,gavi
sle,Sierra Leone,2009,mcv1,80,226759,181407,45352,afr,gavi
sle,Sierra Leone,2010,dtp3,86,228713,196693,32020,afr,gavi
sle,Sierra Leone,2010,dtp1,95,228713,217277,11436,afr,gavi
sle,Sierra Leone,2010,mcv1,81,228713,185258,43455,afr,gavi
sle,Sierra Leone,2011,dtp1,97,230195,223289,6906,afr,gavi
sle,Sierra Leone,2011,dtp3,89,230195,204874,25321,afr,gavi
sle,Sierra Leone,2011,mcv1,83,230195,191062,39133,afr,gavi
sle,Sierra Leone,2012,dtp1,98,231482,226852,4630,afr,gavi
sle,Sierra Leone,2012,mcv1,84,231482,194445,37037,afr,gavi
sle,Sierra Leone,2012,dtp3,91,231482,210649,20833,afr,gavi
sle,Sierra Leone,2013,dtp1,98,232803,228147,4656,afr,gavi
sle,Sierra Leone,2013,dtp3,92,232803,214179,18624,afr,gavi
sle,Sierra Leone,2013,mcv1,83,232803,193226,39577,afr,gavi
sle,Sierra Leone,2014,mcv1,78,234267,182728,51539,afr,gavi
sle,Sierra Leone,2014,dtp1,88,234267,206155,28112,afr,gavi
sle,Sierra Leone,2014,dtp3,83,234267,194442,39825,afr,gavi
sle,Sierra Leone,2015,dtp3,86,235928,202898,33030,afr,gavi
sle,Sierra Leone,2015,dtp1,95,235928,224132,11796,afr,gavi
sle,Sierra Leone,2015,mcv1,76,235928,179305,56623,afr,gavi
sle,Sierra Leone,2015,mcv2,60,227579,136547,91032,afr,gavi
sle,Sierra Leone,2016,mcv1,83,237764,197344,40420,afr,gavi
sle,Sierra Leone,2016,dtp1,97,237764,230631,7133,afr,gavi
sle,Sierra Leone,2016,dtp3,84,237764,199722,38042,afr,gavi
sle,Sierra Leone,2016,mcv2,50,228179,114090,114089,afr,gavi
slv,El Salvador,2000,dtp3,99,142109,140688,1421,amr,mic_nongavi
slv,El Salvador,2000,mcv1,97,142109,137846,4263,amr,mic_nongavi
slv,El Salvador,2000,dtp1,99,142109,140688,1421,amr,mic_nongavi
slv,El Salvador,2001,dtp1,97,138114,133971,4143,amr,mic_nongavi
slv,El Salvador,2001,dtp3,92,138114,127065,11049,amr,mic_nongavi
slv,El Salvador,2001,mcv1,95,138114,131208,6906,amr,mic_nongavi
slv,El Salvador,2002,dtp1,93,134296,124895,9401,amr,mic_nongavi
slv,El Salvador,2002,mcv1,93,134296,124895,9401,amr,mic_nongavi
slv,El Salvador,2002,dtp3,81,134296,108780,25516,amr,mic_nongavi
slv,El Salvador,2003,dtp1,98,130861,128244,2617,amr,mic_nongavi
slv,El Salvador,2003,dtp3,94,130861,123009,7852,amr,mic_nongavi
slv,El Salvador,2003,mcv1,90,130861,117775,13086,amr,mic_nongavi
slv,El Salvador,2003,mcv2,77,146273,112630,33643,amr,mic_nongavi
slv,El Salvador,2004,dtp1,96,127932,122815,5117,amr,mic_nongavi
slv,El Salvador,2004,mcv1,93,127932,118977,8955,amr,mic_nongavi
slv,El Salvador,2004,dtp3,90,127932,115139,12793,amr,mic_nongavi
slv,El Salvador,2004,mcv2,80,142814,114251,28563,amr,mic_nongavi
slv,El Salvador,2005,dtp3,89,125558,111747,13811,amr,mic_nongavi
slv,El Salvador,2005,dtp1,96,125558,120536,5022,amr,mic_nongavi
slv,El Salvador,2005,mcv1,99,125558,124302,1256,amr,mic_nongavi
slv,El Salvador,2005,mcv2,85,139469,118549,20920,amr,mic_nongavi
slv,El Salvador,2006,mcv1,98,123695,121221,2474,amr,mic_nongavi
slv,El Salvador,2006,dtp3,96,123695,118747,4948,amr,mic_nongavi
slv,El Salvador,2006,dtp1,98,123695,121221,2474,amr,mic_nongavi
slv,El Salvador,2006,mcv2,89,134456,119666,14790,amr,mic_nongavi
slv,El Salvador,2007,dtp3,99,122178,120956,1222,amr,mic_nongavi
slv,El Salvador,2007,dtp1,99,122178,120956,1222,amr,mic_nongavi
slv,El Salvador,2007,mcv1,99,122178,120956,1222,amr,mic_nongavi
slv,El Salvador,2007,mcv2,86,128992,110933,18059,amr,mic_nongavi
slv,El Salvador,2008,dtp3,98,120871,118454,2417,amr,mic_nongavi
slv,El Salvador,2008,dtp1,99,120871,119662,1209,amr,mic_nongavi
slv,El Salvador,2008,mcv1,95,120871,114827,6044,amr,mic_nongavi
slv,El Salvador,2008,mcv2,79,123871,97858,26013,amr,mic_nongavi
slv,El Salvador,2009,dtp1,97,119728,116136,3592,amr,mic_nongavi
slv,El Salvador,2009,mcv1,91,119728,108952,10776,amr,mic_nongavi
slv,El Salvador,2009,dtp3,91,119728,108952,10776,amr,mic_nongavi
slv,El Salvador,2009,mcv2,82,120092,98475,21617,amr,mic_nongavi
slv,El Salvador,2010,dtp1,90,118741,106867,11874,amr,mic_nongavi
slv,El Salvador,2010,mcv1,92,118741,109242,9499,amr,mic_nongavi
slv,El Salvador,2010,dtp3,89,118741,105679,13062,amr,mic_nongavi
slv,El Salvador,2010,mcv2,78,118789,92655,26134,amr,mic_nongavi
slv,El Salvador,2011,mcv1,89,117927,104955,12972,amr,mic_nongavi
slv,El Salvador,2011,dtp3,89,117927,104955,12972,amr,mic_nongavi
slv,El Salvador,2011,dtp1,90,117927,106134,11793,amr,mic_nongavi
slv,El Salvador,2011,mcv2,81,118112,95671,22441,amr,mic_nongavi
slv,El Salvador,2012,dtp3,92,117302,107918,9384,amr,mic_nongavi
slv,El Salvador,2012,mcv1,93,117302,109091,8211,amr,mic_nongavi
slv,El Salvador,2012,dtp1,92,117302,107918,9384,amr,mic_nongavi
slv,El Salvador,2012,mcv2,95,118403,112483,5920,amr,mic_nongavi
slv,El Salvador,2013,dtp3,92,116850,107502,9348,amr,mic_nongavi
slv,El Salvador,2013,mcv1,94,116850,109839,7011,amr,mic_nongavi
slv,El Salvador,2013,dtp1,97,116850,113345,3505,amr,mic_nongavi
slv,El Salvador,2013,mcv2,85,118927,101088,17839,amr,mic_nongavi
slv,El Salvador,2014,dtp3,94,116518,109527,6991,amr,mic_nongavi
slv,El Salvador,2014,mcv1,95,116518,110692,5826,amr,mic_nongavi
slv,El Salvador,2014,dtp1,96,116518,111857,4661,amr,mic_nongavi
slv,El Salvador,2014,mcv2,85,118694,100890,17804,amr,mic_nongavi
slv,El Salvador,2015,dtp3,91,116236,105775,10461,amr,mic_nongavi
slv,El Salvador,2015,mcv1,95,116236,110424,5812,amr,mic_nongavi
slv,El Salvador,2015,dtp1,93,116236,108099,8137,amr,mic_nongavi
slv,El Salvador,2015,mcv2,88,116534,102550,13984,amr,mic_nongavi
slv,El Salvador,2016,dtp3,93,115936,107820,8116,amr,mic_nongavi
slv,El Salvador,2016,mcv1,90,115936,104342,11594,amr,mic_nongavi
slv,El Salvador,2016,dtp1,97,115936,112458,3478,amr,mic_nongavi
slv,El Salvador,2016,mcv2,87,115714,100671,15043,amr,mic_nongavi
smr,San Marino,2000,dtp1,97,255.4063561557,248,7.4063561557,eur,hic
smr,San Marino,2000,mcv1,74,255.4063561557,189,66.4063561557,eur,hic
smr,San Marino,2000,dtp3,96,255.4063561557,245,10.4063561557,eur,hic
smr,San Marino,2001,dtp1,96,259.5364790623,249,10.5364790623,eur,hic
smr,San Marino,2001,mcv1,80,259.5364790623,208,51.5364790623,eur,hic
smr,San Marino,2001,dtp3,96,259.5364790623,249,10.5364790623,eur,hic
smr,San Marino,2002,dtp3,96,263.9722143693,253,10.9722143693,eur,hic
smr,San Marino,2002,dtp1,96,263.9722143693,253,10.9722143693,eur,hic
smr,San Marino,2002,mcv1,85,263.9722143693,224,39.9722143693,eur,hic
smr,San Marino,2003,dtp1,98,268.5108041679,263,5.5108041679,eur,hic
smr,San Marino,2003,mcv1,91,268.5108041679,244,24.5108041679,eur,hic
smr,San Marino,2003,dtp3,96,268.5108041679,258,10.5108041679,eur,hic
smr,San Marino,2003,mcv2,96,268.5108041679,258,10.5108041679,eur,hic
smr,San Marino,2004,dtp1,99,272.9092558482,270,2.9092558482,eur,hic
smr,San Marino,2004,dtp3,98,272.9092558482,267,5.9092558482,eur,hic
smr,San Marino,2004,mcv1,98,272.9092558482,267,5.9092558482,eur,hic
smr,San Marino,2004,mcv2,96,272.9092558482,262,10.9092558482,eur,hic
smr,San Marino,2005,dtp1,98,276.8924162945,271,5.8924162945,eur,hic
smr,San Marino,2005,mcv1,94,276.8924162945,260,16.8924162945,eur,hic
smr,San Marino,2005,dtp3,95,276.8924162945,263,13.8924162945,eur,hic
smr,San Marino,2005,mcv2,94,276.8924162945,260,16.8924162945,eur,hic
smr,San Marino,2006,dtp3,95,279.969712133,266,13.969712133,eur,hic
smr,San Marino,2006,dtp1,98,279.969712133,274,5.969712133,eur,hic
smr,San Marino,2006,mcv1,94,279.969712133,263,16.969712133,eur,hic
smr,San Marino,2006,mcv2,93,279.969712133,260,19.969712133,eur,hic
smr,San Marino,2007,dtp3,92,281.7936396642,259,22.7936396642,eur,hic
smr,San Marino,2007,dtp1,92,281.7936396642,259,22.7936396642,eur,hic
smr,San Marino,2007,mcv1,92,281.7936396642,259,22.7936396642,eur,hic
smr,San Marino,2007,mcv2,91,281.7936396642,256,25.7936396642,eur,hic
smr,San Marino,2008,dtp1,89,282.5030574957,251,31.5030574957,eur,hic
smr,San Marino,2008,dtp3,87,282.5030574957,246,36.5030574957,eur,hic
smr,San Marino,2008,mcv1,73,282.5030574957,206,76.5030574957,eur,hic
smr,San Marino,2008,mcv2,89,282.5030574957,251,31.5030574957,eur,hic
smr,San Marino,2009,dtp3,92,282.0474535222,259,23.0474535222,eur,hic
smr,San Marino,2009,dtp1,95,282.0474535222,268,14.0474535222,eur,hic
smr,San Marino,2009,mcv1,93,282.0474535222,262,20.0474535222,eur,hic
smr,San Marino,2009,mcv2,88,282.0474535222,248,34.0474535222,eur,hic
smr,San Marino,2010,dtp1,80,280.7884053429,225,55.7884053429,eur,hic
smr,San Marino,2010,dtp3,79,280.7884053429,222,58.7884053429,eur,hic
smr,San Marino,2010,mcv1,68,280.7884053429,191,89.7884053429,eur,hic
smr,San Marino,2010,mcv2,86,280.7884053429,241,39.7884053429,eur,hic
smr,San Marino,2011,dtp1,90,279.0659816797,251,28.0659816797,eur,hic
smr,San Marino,2011,dtp3,86,279.0659816797,240,39.0659816797,eur,hic
smr,San Marino,2011,mcv1,83,279.0659816797,232,47.0659816797,eur,hic
smr,San Marino,2011,mcv2,84,279.0659816797,234,45.0659816797,eur,hic
smr,San Marino,2012,dtp3,96,277.4916665593,266,11.4916665593,eur,hic
smr,San Marino,2012,mcv1,87,277.4916665593,241,36.4916665593,eur,hic
smr,San Marino,2012,dtp1,98,277.4916665593,272,5.4916665593,eur,hic
smr,San Marino,2012,mcv2,88,277.4916665593,244,33.4916665593,eur,hic
smr,San Marino,2013,dtp3,69,276.141358136,191,85.141358136,eur,hic
smr,San Marino,2013,mcv1,74,276.141358136,204,72.141358136,eur,hic
smr,San Marino,2013,dtp1,72,276.141358136,199,77.141358136,eur,hic
smr,San Marino,2013,mcv2,77,276.141358136,213,63.141358136,eur,hic
smr,San Marino,2014,mcv1,57,275.0840729226,157,118.0840729226,eur,hic
smr,San Marino,2014,dtp3,80,275.0840729226,220,55.0840729226,eur,hic
smr,San Marino,2014,dtp1,82,275.0840729226,226,49.0840729226,eur,hic
smr,San Marino,2014,mcv2,76,275.0840729226,209,66.0840729226,eur,hic
smr,San Marino,2015,dtp1,77,274.2680348574,211,63.2680348574,eur,hic
smr,San Marino,2015,dtp3,76,274.2680348574,208,66.2680348574,eur,hic
smr,San Marino,2015,mcv1,53,274.2680348574,145,129.2680348574,eur,hic
smr,San Marino,2015,mcv2,82,274.2680348574,225,49.2680348574,eur,hic
smr,San Marino,2016,dtp1,78,273.6115601762,213,60.6115601762,eur,hic
smr,San Marino,2016,dtp3,66,273.6115601762,181,92.6115601762,eur,hic
smr,San Marino,2016,mcv1,62,273.6115601762,170,103.6115601762,eur,hic
smr,San Marino,2016,mcv2,36,NA,NA,#VALUE!,eur,hic
som,Somalia,2000,dtp3,33,395015,130355,264660,emr,gavi
som,Somalia,2000,dtp1,57,395015,225159,169856,emr,gavi
som,Somalia,2000,mcv1,24,395015,94804,300211,emr,gavi
som,Somalia,2001,dtp1,57,403644,230077,173567,emr,gavi
som,Somalia,2001,mcv1,20,403644,80729,322915,emr,gavi
som,Somalia,2001,dtp3,33,403644,133203,270441,emr,gavi
som,Somalia,2002,dtp1,60,412599,247559,165040,emr,gavi
som,Somalia,2002,dtp3,40,412599,165040,247559,emr,gavi
som,Somalia,2002,mcv1,45,412599,185670,226929,emr,gavi
som,Somalia,2003,dtp1,65,422093,274360,147733,emr,gavi
som,Somalia,2003,dtp3,40,422093,168837,253256,emr,gavi
som,Somalia,2003,mcv1,40,422093,168837,253256,emr,gavi
som,Somalia,2004,dtp1,50,432192,216096,216096,emr,gavi
som,Somalia,2004,dtp3,30,432192,129658,302534,emr,gavi
som,Somalia,2004,mcv1,40,432192,172877,259315,emr,gavi
som,Somalia,2005,dtp1,50,442856,221428,221428,emr,gavi
som,Somalia,2005,mcv1,35,442856,155000,287856,emr,gavi
som,Somalia,2005,dtp3,35,442856,155000,287856,emr,gavi
som,Somalia,2006,dtp3,26,453956,118029,335927,emr,gavi
som,Somalia,2006,dtp1,40,453956,181582,272374,emr,gavi
som,Somalia,2006,mcv1,35,453956,158885,295071,emr,gavi
som,Somalia,2007,mcv1,35,465299,162855,302444,emr,gavi
som,Somalia,2007,dtp1,59,465299,274526,190773,emr,gavi
som,Somalia,2007,dtp3,40,465299,186120,279179,emr,gavi
som,Somalia,2008,dtp1,40,476754,190702,286052,emr,gavi
som,Somalia,2008,mcv1,34,476754,162096,314658,emr,gavi
som,Somalia,2008,dtp3,31,476754,147794,328960,emr,gavi
som,Somalia,2009,dtp1,52,488301,253917,234384,emr,gavi
som,Somalia,2009,mcv1,43,488301,209969,278332,emr,gavi
som,Somalia,2009,dtp3,42,488301,205086,283215,emr,gavi
som,Somalia,2010,mcv1,46,500001,230000,270001,emr,gavi
som,Somalia,2010,dtp1,55,500001,275001,225000,emr,gavi
som,Somalia,2010,dtp3,45,500001,225000,275001,emr,gavi
som,Somalia,2011,dtp1,52,511974,266226,245748,emr,gavi
som,Somalia,2011,mcv1,46,511974,235508,276466,emr,gavi
som,Somalia,2011,dtp3,41,511974,209909,302065,emr,gavi
som,Somalia,2012,dtp1,52,524339,272656,251683,emr,gavi
som,Somalia,2012,dtp3,42,524339,220222,304117,emr,gavi
som,Somalia,2012,mcv1,46,524339,241196,283143,emr,gavi
som,Somalia,2013,dtp3,42,537157,225606,311551,emr,gavi
som,Somalia,2013,dtp1,52,537157,279322,257835,emr,gavi
som,Somalia,2013,mcv1,46,537157,247092,290065,emr,gavi
som,Somalia,2014,dtp3,42,550411,231173,319238,emr,gavi
som,Somalia,2014,dtp1,52,550411,286214,264197,emr,gavi
som,Somalia,2014,mcv1,46,550411,253189,297222,emr,gavi
som,Somalia,2015,dtp3,42,564035,236895,327140,emr,gavi
som,Somalia,2015,dtp1,52,564035,293298,270737,emr,gavi
som,Somalia,2015,mcv1,46,564035,259456,304579,emr,gavi
som,Somalia,2016,dtp1,52,577926,300522,277404,emr,gavi
som,Somalia,2016,mcv1,46,577926,265846,312080,emr,gavi
som,Somalia,2016,dtp3,42,577926,242729,335197,emr,gavi
srb,Serbia,2000,mcv1,89,124189,110528,13661,eur,mic_nongavi
srb,Serbia,2000,dtp1,97,124189,120463,3726,eur,mic_nongavi
srb,Serbia,2000,dtp3,95,124189,117980,6209,eur,mic_nongavi
srb,Serbia,2000,mcv2,78,149875,116902,32973,eur,mic_nongavi
srb,Serbia,2001,mcv1,90,121494,109345,12149,eur,mic_nongavi
srb,Serbia,2001,dtp1,95,121494,115419,6075,eur,mic_nongavi
srb,Serbia,2001,dtp3,93,121494,112989,8505,eur,mic_nongavi
srb,Serbia,2001,mcv2,74,147045,108813,38232,eur,mic_nongavi
srb,Serbia,2002,dtp3,95,118767,112829,5938,eur,mic_nongavi
srb,Serbia,2002,dtp1,98,118767,116392,2375,eur,mic_nongavi
srb,Serbia,2002,mcv1,92,118767,109266,9501,eur,mic_nongavi
srb,Serbia,2002,mcv2,75,143196,107397,35799,eur,mic_nongavi
srb,Serbia,2003,dtp1,91,116085,105637,10448,eur,mic_nongavi
srb,Serbia,2003,mcv1,87,116085,100994,15091,eur,mic_nongavi
srb,Serbia,2003,dtp3,89,116085,103316,12769,eur,mic_nongavi
srb,Serbia,2003,mcv2,96,130733,125504,5229,eur,mic_nongavi
srb,Serbia,2004,dtp1,91,113509,103293,10216,eur,mic_nongavi
srb,Serbia,2004,mcv1,89,113509,101023,12486,eur,mic_nongavi
srb,Serbia,2004,dtp3,88,113509,99888,13621,eur,mic_nongavi
srb,Serbia,2004,mcv2,96,127183,122096,5087,eur,mic_nongavi
srb,Serbia,2005,dtp3,98,111115,108893,2222,eur,mic_nongavi
srb,Serbia,2005,dtp1,99,111115,110004,1111,eur,mic_nongavi
srb,Serbia,2005,mcv1,96,111115,106670,4445,eur,mic_nongavi
srb,Serbia,2005,mcv2,98,123563,121092,2471,eur,mic_nongavi
srb,Serbia,2006,mcv1,88,100880,88774,12106,eur,mic_nongavi
srb,Serbia,2006,dtp1,97,100880,97854,3026,eur,mic_nongavi
srb,Serbia,2006,dtp3,92,100880,92810,8070,eur,mic_nongavi
srb,Serbia,2006,mcv2,90,110243,99219,11024,eur,mic_nongavi
srb,Serbia,2007,mcv1,95,99076,94122,4954,eur,mic_nongavi
srb,Serbia,2007,dtp3,94,99076,93131,5945,eur,mic_nongavi
srb,Serbia,2007,dtp1,98,99076,97094,1982,eur,mic_nongavi
srb,Serbia,2007,mcv2,96,108473,104134,4339,eur,mic_nongavi
srb,Serbia,2008,dtp1,98,97581,95629,1952,eur,mic_nongavi
srb,Serbia,2008,mcv1,92,97581,89775,7806,eur,mic_nongavi
srb,Serbia,2008,dtp3,95,97581,92702,4879,eur,mic_nongavi
srb,Serbia,2008,mcv2,97,107270,104052,3218,eur,mic_nongavi
srb,Serbia,2009,dtp3,95,96390,91570,4820,eur,mic_nongavi
srb,Serbia,2009,dtp1,98,96390,94462,1928,eur,mic_nongavi
srb,Serbia,2009,mcv1,95,96390,91570,4820,eur,mic_nongavi
srb,Serbia,2009,mcv2,87,106369,92541,13828,eur,mic_nongavi
srb,Serbia,2010,mcv1,95,95480,90706,4774,eur,mic_nongavi
srb,Serbia,2010,dtp3,91,95480,86887,8593,eur,mic_nongavi
srb,Serbia,2010,dtp1,97,95480,92616,2864,eur,mic_nongavi
srb,Serbia,2010,mcv2,91,105545,96046,9499,eur,mic_nongavi
srb,Serbia,2011,dtp3,94,94803,89115,5688,eur,mic_nongavi
srb,Serbia,2011,mcv1,93,94803,88167,6636,eur,mic_nongavi
srb,Serbia,2011,dtp1,98,94803,92907,1896,eur,mic_nongavi
srb,Serbia,2011,mcv2,90,104572,94115,10457,eur,mic_nongavi
srb,Serbia,2012,dtp3,91,94274,85789,8485,eur,mic_nongavi
srb,Serbia,2012,dtp1,97,94274,91446,2828,eur,mic_nongavi
srb,Serbia,2012,mcv1,87,94274,82018,12256,eur,mic_nongavi
srb,Serbia,2012,mcv2,90,102866,92579,10287,eur,mic_nongavi
srb,Serbia,2013,dtp1,98,93818,91942,1876,eur,mic_nongavi
srb,Serbia,2013,dtp3,95,93818,89127,4691,eur,mic_nongavi
srb,Serbia,2013,mcv1,92,93818,86313,7505,eur,mic_nongavi
srb,Serbia,2013,mcv2,82,100735,82603,18132,eur,mic_nongavi
srb,Serbia,2014,dtp1,97,93383,90582,2801,eur,mic_nongavi
srb,Serbia,2014,dtp3,93,93383,86846,6537,eur,mic_nongavi
srb,Serbia,2014,mcv1,86,93383,80309,13074,eur,mic_nongavi
srb,Serbia,2014,mcv2,91,98496,89631,8865,eur,mic_nongavi
srb,Serbia,2015,dtp1,98,92931,91072,1859,eur,mic_nongavi
srb,Serbia,2015,dtp3,95,92931,88284,4647,eur,mic_nongavi
srb,Serbia,2015,mcv1,86,92931,79921,13010,eur,mic_nongavi
srb,Serbia,2015,mcv2,86,96432,82932,13500,eur,mic_nongavi
srb,Serbia,2016,dtp1,97,92447,89674,2773,eur,mic_nongavi
srb,Serbia,2016,dtp3,92,92447,85051,7396,eur,mic_nongavi
srb,Serbia,2016,mcv1,82,92447,75807,16640,eur,mic_nongavi
srb,Serbia,2016,mcv2,90,94908,85417,9491,eur,mic_nongavi
ssd,South Sudan,2011,dtp1,79,362500,286375,76125,afr,gavi
ssd,South Sudan,2011,dtp3,61,362500,221125,141375,afr,gavi
ssd,South Sudan,2011,mcv1,62,362500,224750,137750,afr,gavi
ssd,South Sudan,2012,dtp1,71,372435,264429,108006,afr,gavi
ssd,South Sudan,2012,dtp3,59,372435,219737,152698,afr,gavi
ssd,South Sudan,2012,mcv1,52,372435,193666,178769,afr,gavi
ssd,South Sudan,2013,dtp1,57,382112,217804,164308,afr,gavi
ssd,South Sudan,2013,mcv1,30,382112,114634,267478,afr,gavi
ssd,South Sudan,2013,dtp3,45,382112,171950,210162,afr,gavi
ssd,South Sudan,2014,dtp3,39,391474,152675,238799,afr,gavi
ssd,South Sudan,2014,mcv1,22,391474,86124,305350,afr,gavi
ssd,South Sudan,2014,dtp1,49,391474,191822,199652,afr,gavi
ssd,South Sudan,2015,dtp3,31,400480,124149,276331,afr,gavi
ssd,South Sudan,2015,mcv1,20,400480,80096,320384,afr,gavi
ssd,South Sudan,2015,dtp1,37,400480,148178,252302,afr,gavi
ssd,South Sudan,2016,dtp3,26,409113,106369,302744,afr,gavi
ssd,South Sudan,2016,dtp1,35,409113,143190,265923,afr,gavi
ssd,South Sudan,2016,mcv1,20,409113,81823,327290,afr,gavi
stp,Sao Tome and Principe,2000,mcv1,69,5271,3637,1634,afr,gavi
stp,Sao Tome and Principe,2000,dtp3,82,5271,4322,949,afr,gavi
stp,Sao Tome and Principe,2000,dtp1,89,5271,4691,580,afr,gavi
stp,Sao Tome and Principe,2001,dtp1,97,5365,5204,161,afr,gavi
stp,Sao Tome and Principe,2001,mcv1,75,5365,4024,1341,afr,gavi
stp,Sao Tome and Principe,2001,dtp3,92,5365,4936,429,afr,gavi
stp,Sao Tome and Principe,2002,dtp1,94,5458,5131,327,afr,gavi
stp,Sao Tome and Principe,2002,dtp3,92,5458,5021,437,afr,gavi
stp,Sao Tome and Principe,2002,mcv1,85,5458,4639,819,afr,gavi
stp,Sao Tome and Principe,2003,dtp1,98,5549,5438,111,afr,gavi
stp,Sao Tome and Principe,2003,dtp3,94,5549,5216,333,afr,gavi
stp,Sao Tome and Principe,2003,mcv1,87,5549,4828,721,afr,gavi
stp,Sao Tome and Principe,2004,dtp1,99,5637,5581,56,afr,gavi
stp,Sao Tome and Principe,2004,dtp3,96,5637,5412,225,afr,gavi
stp,Sao Tome and Principe,2004,mcv1,91,5637,5130,507,afr,gavi
stp,Sao Tome and Principe,2005,dtp1,99,5725,5668,57,afr,gavi
stp,Sao Tome and Principe,2005,mcv1,88,5725,5038,687,afr,gavi
stp,Sao Tome and Principe,2005,dtp3,97,5725,5553,172,afr,gavi
stp,Sao Tome and Principe,2006,dtp3,97,5810,5636,174,afr,gavi
stp,Sao Tome and Principe,2006,dtp1,99,5810,5752,58,afr,gavi
stp,Sao Tome and Principe,2006,mcv1,85,5810,4939,871,afr,gavi
stp,Sao Tome and Principe,2007,dtp3,97,5894,5717,177,afr,gavi
stp,Sao Tome and Principe,2007,mcv1,86,5894,5069,825,afr,gavi
stp,Sao Tome and Principe,2007,dtp1,99,5894,5835,59,afr,gavi
stp,Sao Tome and Principe,2008,dtp1,99,5975,5915,60,afr,gavi
stp,Sao Tome and Principe,2008,dtp3,99,5975,5915,60,afr,gavi
stp,Sao Tome and Principe,2008,mcv1,93,5975,5557,418,afr,gavi
stp,Sao Tome and Principe,2009,dtp1,99,6055,5994,61,afr,gavi
stp,Sao Tome and Principe,2009,mcv1,90,6055,5450,605,afr,gavi
stp,Sao Tome and Principe,2009,dtp3,98,6055,5934,121,afr,gavi
stp,Sao Tome and Principe,2010,dtp1,98,6130,6007,123,afr,gavi
stp,Sao Tome and Principe,2010,mcv1,92,6130,5640,490,afr,gavi
stp,Sao Tome and Principe,2010,dtp3,98,6130,6007,123,afr,gavi
stp,Sao Tome and Principe,2011,dtp1,98,6200,6076,124,afr,gavi
stp,Sao Tome and Principe,2011,mcv1,91,6200,5642,558,afr,gavi
stp,Sao Tome and Principe,2011,dtp3,96,6200,5952,248,afr,gavi
stp,Sao Tome and Principe,2012,dtp1,98,6265,6140,125,afr,gavi
stp,Sao Tome and Principe,2012,dtp3,96,6265,6014,251,afr,gavi
stp,Sao Tome and Principe,2012,mcv1,92,6265,5764,501,afr,gavi
stp,Sao Tome and Principe,2013,dtp3,97,6324,6134,190,afr,gavi
stp,Sao Tome and Principe,2013,dtp1,99,6324,6261,63,afr,gavi
stp,Sao Tome and Principe,2013,mcv1,91,6324,5755,569,afr,gavi
stp,Sao Tome and Principe,2014,mcv1,92,6379,5869,510,afr,gavi
stp,Sao Tome and Principe,2014,dtp3,95,6379,6060,319,afr,gavi
stp,Sao Tome and Principe,2014,dtp1,98,6379,6251,128,afr,gavi
stp,Sao Tome and Principe,2014,mcv2,71,6124,4348,1776,afr,gavi
stp,Sao Tome and Principe,2015,dtp3,96,6431,6174,257,afr,gavi
stp,Sao Tome and Principe,2015,dtp1,98,6431,6302,129,afr,gavi
stp,Sao Tome and Principe,2015,mcv1,93,6431,5981,450,afr,gavi
stp,Sao Tome and Principe,2015,mcv2,76,6184,4700,1484,afr,gavi
stp,Sao Tome and Principe,2016,dtp3,96,6484,6225,259,afr,gavi
stp,Sao Tome and Principe,2016,dtp1,97,6484,6289,195,afr,gavi
stp,Sao Tome and Principe,2016,mcv1,93,6484,6030,454,afr,gavi
stp,Sao Tome and Principe,2016,mcv2,76,6262,4759,1503,afr,gavi
sur,Suriname,2000,dtp1,90,10680,9612,1068,amr,mic_nongavi
sur,Suriname,2000,mcv1,84,10680,8971,1709,amr,mic_nongavi
sur,Suriname,2000,dtp3,71,10680,7583,3097,amr,mic_nongavi
sur,Suriname,2001,dtp3,68,10615,7218,3397,amr,mic_nongavi
sur,Suriname,2001,dtp1,90,10615,9554,1061,amr,mic_nongavi
sur,Suriname,2001,mcv1,82,10615,8704,1911,amr,mic_nongavi
sur,Suriname,2002,dtp1,86,10547,9070,1477,amr,mic_nongavi
sur,Suriname,2002,dtp3,73,10547,7699,2848,amr,mic_nongavi
sur,Suriname,2002,mcv1,73,10547,7699,2848,amr,mic_nongavi
sur,Suriname,2003,dtp1,81,10474,8484,1990,amr,mic_nongavi
sur,Suriname,2003,dtp3,75,10474,7856,2618,amr,mic_nongavi
sur,Suriname,2003,mcv1,69,10474,7227,3247,amr,mic_nongavi
sur,Suriname,2004,dtp3,85,10401,8841,1560,amr,mic_nongavi
sur,Suriname,2004,mcv1,86,10401,8945,1456,amr,mic_nongavi
sur,Suriname,2004,dtp1,92,10401,9569,832,amr,mic_nongavi
sur,Suriname,2005,dtp1,93,10329,9606,723,amr,mic_nongavi
sur,Suriname,2005,dtp3,83,10329,8573,1756,amr,mic_nongavi
sur,Suriname,2005,mcv1,91,10329,9399,930,amr,mic_nongavi
sur,Suriname,2006,dtp1,94,10267,9651,616,amr,mic_nongavi
sur,Suriname,2006,dtp3,84,10267,8624,1643,amr,mic_nongavi
sur,Suriname,2006,mcv1,83,10267,8522,1745,amr,mic_nongavi
sur,Suriname,2007,dtp1,96,10213,9804,409,amr,mic_nongavi
sur,Suriname,2007,dtp3,84,10213,8579,1634,amr,mic_nongavi
sur,Suriname,2007,mcv1,85,10213,8681,1532,amr,mic_nongavi
sur,Suriname,2008,mcv1,86,10171,8747,1424,amr,mic_nongavi
sur,Suriname,2008,dtp1,95,10171,9662,509,amr,mic_nongavi
sur,Suriname,2008,dtp3,85,10171,8645,1526,amr,mic_nongavi
sur,Suriname,2009,dtp1,91,10141,9228,913,amr,mic_nongavi
sur,Suriname,2009,dtp3,87,10141,8823,1318,amr,mic_nongavi
sur,Suriname,2009,mcv1,88,10141,8924,1217,amr,mic_nongavi
sur,Suriname,2010,dtp1,99,10120,10019,101,amr,mic_nongavi
sur,Suriname,2010,mcv1,90,10120,9108,1012,amr,mic_nongavi
sur,Suriname,2010,dtp3,96,10120,9715,405,amr,mic_nongavi
sur,Suriname,2011,dtp3,86,10106,8691,1415,amr,mic_nongavi
sur,Suriname,2011,mcv1,85,10106,8590,1516,amr,mic_nongavi
sur,Suriname,2011,dtp1,90,10106,9095,1011,amr,mic_nongavi
sur,Suriname,2012,dtp3,84,10094,8479,1615,amr,mic_nongavi
sur,Suriname,2012,dtp1,94,10094,9488,606,amr,mic_nongavi
sur,Suriname,2012,mcv1,73,10094,7369,2725,amr,mic_nongavi
sur,Suriname,2013,dtp3,86,10080,8669,1411,amr,mic_nongavi
sur,Suriname,2013,mcv1,93,10080,9374,706,amr,mic_nongavi
sur,Suriname,2013,dtp1,91,10080,9173,907,amr,mic_nongavi
sur,Suriname,2013,mcv2,18,9945,1790,8155,amr,mic_nongavi
sur,Suriname,2014,dtp3,85,10062,8553,1509,amr,mic_nongavi
sur,Suriname,2014,dtp1,91,10062,9156,906,amr,mic_nongavi
sur,Suriname,2014,mcv1,85,10062,8553,1509,amr,mic_nongavi
sur,Suriname,2014,mcv2,18,9947,1790,8157,amr,mic_nongavi
sur,Suriname,2015,mcv1,94,10039,9437,602,amr,mic_nongavi
sur,Suriname,2015,dtp3,89,10039,8935,1104,amr,mic_nongavi
sur,Suriname,2015,dtp1,90,10039,9035,1004,amr,mic_nongavi
sur,Suriname,2015,mcv2,28,9944,2784,7160,amr,mic_nongavi
sur,Suriname,2016,dtp1,92,10008,9207,801,amr,mic_nongavi
sur,Suriname,2016,mcv1,97,10008,9708,300,amr,mic_nongavi
sur,Suriname,2016,dtp3,91,10008,9107,901,amr,mic_nongavi
sur,Suriname,2016,mcv2,44,9979,4391,5588,amr,mic_nongavi
svk,Slovakia,2000,dtp3,99,53237,52705,532,eur,hic
svk,Slovakia,2000,dtp1,99,53237,52705,532,eur,hic
svk,Slovakia,2000,mcv1,98,53237,52172,1065,eur,hic
svk,Slovakia,2000,mcv2,99,84641,83795,846,eur,hic
svk,Slovakia,2001,dtp3,99,52376,51852,524,eur,hic
svk,Slovakia,2001,dtp1,99,52376,51852,524,eur,hic
svk,Slovakia,2001,mcv1,99,52376,51852,524,eur,hic
svk,Slovakia,2001,mcv2,99,83057,82226,831,eur,hic
svk,Slovakia,2002,dtp3,99,52050,51530,520,eur,hic
svk,Slovakia,2002,dtp1,99,52050,51530,520,eur,hic
svk,Slovakia,2002,mcv1,99,52050,51530,520,eur,hic
svk,Slovakia,2002,mcv2,99,77461,76686,775,eur,hic
svk,Slovakia,2003,mcv1,99,52160,51638,522,eur,hic
svk,Slovakia,2003,dtp3,99,52160,51638,522,eur,hic
svk,Slovakia,2003,dtp1,99,52160,51638,522,eur,hic
svk,Slovakia,2003,mcv2,99,75490,74735,755,eur,hic
svk,Slovakia,2004,mcv1,99,52627,52101,526,eur,hic
svk,Slovakia,2004,dtp1,99,52627,52101,526,eur,hic
svk,Slovakia,2004,dtp3,99,52627,52101,526,eur,hic
svk,Slovakia,2004,mcv2,98,73182,71718,1464,eur,hic
svk,Slovakia,2005,mcv1,98,53336,52269,1067,eur,hic
svk,Slovakia,2005,dtp1,99,53336,52803,533,eur,hic
svk,Slovakia,2005,dtp3,99,53336,52803,533,eur,hic
svk,Slovakia,2005,mcv2,98,70024,68624,1400,eur,hic
svk,Slovakia,2006,mcv1,98,54164,53081,1083,eur,hic
svk,Slovakia,2006,dtp3,99,54164,53622,542,eur,hic
svk,Slovakia,2006,dtp1,99,54164,53622,542,eur,hic
svk,Slovakia,2006,mcv2,99,62882,62253,629,eur,hic
svk,Slovakia,2007,dtp1,99,54994,54444,550,eur,hic
svk,Slovakia,2007,mcv1,99,54994,54444,550,eur,hic
svk,Slovakia,2007,dtp3,99,54994,54444,550,eur,hic
svk,Slovakia,2007,mcv2,98,59644,58451,1193,eur,hic
svk,Slovakia,2008,dtp1,99,55726,55169,557,eur,hic
svk,Slovakia,2008,mcv1,99,55726,55169,557,eur,hic
svk,Slovakia,2008,dtp3,99,55726,55169,557,eur,hic
svk,Slovakia,2008,mcv2,99,56783,56215,568,eur,hic
svk,Slovakia,2009,dtp1,99,56289,55726,563,eur,hic
svk,Slovakia,2009,mcv1,99,56289,55726,563,eur,hic
svk,Slovakia,2009,dtp3,99,56289,55726,563,eur,hic
svk,Slovakia,2009,mcv2,99,54801,54253,548,eur,hic
svk,Slovakia,2010,dtp1,99,56650,56084,566,eur,hic
svk,Slovakia,2010,dtp3,99,56650,56084,566,eur,hic
svk,Slovakia,2010,mcv1,98,56650,55517,1133,eur,hic
svk,Slovakia,2010,mcv2,99,53809,53271,538,eur,hic
svk,Slovakia,2011,dtp3,99,56821,56253,568,eur,hic
svk,Slovakia,2011,dtp1,99,56821,56253,568,eur,hic
svk,Slovakia,2011,mcv1,98,56821,55685,1136,eur,hic
svk,Slovakia,2011,mcv2,99,52876,52347,529,eur,hic
svk,Slovakia,2012,mcv1,99,56872,56303,569,eur,hic
svk,Slovakia,2012,dtp1,99,56872,56303,569,eur,hic
svk,Slovakia,2012,dtp3,99,56872,56303,569,eur,hic
svk,Slovakia,2012,mcv2,99,52127,51606,521,eur,hic
svk,Slovakia,2013,dtp3,98,56860,55723,1137,eur,hic
svk,Slovakia,2013,dtp1,99,56860,56291,569,eur,hic
svk,Slovakia,2013,mcv1,98,56860,55723,1137,eur,hic
svk,Slovakia,2013,mcv2,99,51833,51315,518,eur,hic
svk,Slovakia,2014,dtp3,97,56789,55085,1704,eur,hic
svk,Slovakia,2014,dtp1,99,56789,56221,568,eur,hic
svk,Slovakia,2014,mcv1,97,56789,55085,1704,eur,hic
svk,Slovakia,2014,mcv2,98,52307,51261,1046,eur,hic
svk,Slovakia,2015,dtp1,99,56664,56097,567,eur,hic
svk,Slovakia,2015,dtp3,96,56664,54397,2267,eur,hic
svk,Slovakia,2015,mcv1,95,56664,53831,2833,eur,hic
svk,Slovakia,2015,mcv2,98,53536,52465,1071,eur,hic
svk,Slovakia,2016,dtp1,99,56477,55912,565,eur,hic
svk,Slovakia,2016,dtp3,96,56477,54218,2259,eur,hic
svk,Slovakia,2016,mcv1,95,56477,53653,2824,eur,hic
svk,Slovakia,2016,mcv2,97,54696,53055,1641,eur,hic
svn,Slovenia,2000,dtp3,91,17413,15846,1567,eur,hic
svn,Slovenia,2000,mcv1,95,17413,16542,871,eur,hic
svn,Slovenia,2000,dtp1,96,17413,16716,697,eur,hic
svn,Slovenia,2000,mcv2,98,19301,18915,386,eur,hic
svn,Slovenia,2001,mcv1,94,17399,16355,1044,eur,hic
svn,Slovenia,2001,dtp1,96,17399,16703,696,eur,hic
svn,Slovenia,2001,dtp3,92,17399,16007,1392,eur,hic
svn,Slovenia,2001,mcv2,98,18721,18347,374,eur,hic
svn,Slovenia,2002,dtp1,96,17539,16837,702,eur,hic
svn,Slovenia,2002,dtp3,93,17539,16311,1228,eur,hic
svn,Slovenia,2002,mcv1,93,17539,16311,1228,eur,hic
svn,Slovenia,2002,mcv2,98,18354,17987,367,eur,hic
svn,Slovenia,2003,mcv1,94,17840,16770,1070,eur,hic
svn,Slovenia,2003,dtp1,98,17840,17483,357,eur,hic
svn,Slovenia,2003,dtp3,95,17840,16948,892,eur,hic
svn,Slovenia,2003,mcv2,98,18142,17779,363,eur,hic
svn,Slovenia,2004,mcv1,94,18282,17185,1097,eur,hic
svn,Slovenia,2004,dtp1,98,18282,17916,366,eur,hic
svn,Slovenia,2004,dtp3,94,18282,17185,1097,eur,hic
svn,Slovenia,2004,mcv2,99,18028,17848,180,eur,hic
svn,Slovenia,2005,dtp1,98,18830,18453,377,eur,hic
svn,Slovenia,2005,mcv1,94,18830,17700,1130,eur,hic
svn,Slovenia,2005,dtp3,95,18830,17888,942,eur,hic
svn,Slovenia,2005,mcv2,99,17916,17737,179,eur,hic
svn,Slovenia,2006,dtp1,99,19432,19238,194,eur,hic
svn,Slovenia,2006,dtp3,97,19432,18849,583,eur,hic
svn,Slovenia,2006,mcv1,96,19432,18655,777,eur,hic
svn,Slovenia,2006,mcv2,99,17825,17647,178,eur,hic
svn,Slovenia,2007,mcv1,96,20026,19225,801,eur,hic
svn,Slovenia,2007,dtp1,99,20026,19826,200,eur,hic
svn,Slovenia,2007,dtp3,97,20026,19425,601,eur,hic
svn,Slovenia,2007,mcv2,98,17691,17337,354,eur,hic
svn,Slovenia,2008,dtp1,99,20556,20350,206,eur,hic
svn,Slovenia,2008,mcv1,96,20556,19734,822,eur,hic
svn,Slovenia,2008,dtp3,97,20556,19939,617,eur,hic
svn,Slovenia,2008,mcv2,98,17752,17397,355,eur,hic
svn,Slovenia,2009,mcv1,95,20990,19940,1050,eur,hic
svn,Slovenia,2009,dtp1,98,20990,20570,420,eur,hic
svn,Slovenia,2009,dtp3,96,20990,20150,840,eur,hic
svn,Slovenia,2009,mcv2,98,17973,17614,359,eur,hic
svn,Slovenia,2010,dtp3,96,21300,20448,852,eur,hic
svn,Slovenia,2010,dtp1,98,21300,20874,426,eur,hic
svn,Slovenia,2010,mcv1,95,21300,20235,1065,eur,hic
svn,Slovenia,2010,mcv2,96,18446,17708,738,eur,hic
svn,Slovenia,2011,mcv1,96,21482,20623,859,eur,hic
svn,Slovenia,2011,dtp3,96,21482,20623,859,eur,hic
svn,Slovenia,2011,dtp1,98,21482,21052,430,eur,hic
svn,Slovenia,2011,mcv2,96,19176,18409,767,eur,hic
svn,Slovenia,2012,dtp1,98,21560,21129,431,eur,hic
svn,Slovenia,2012,dtp3,96,21560,20698,862,eur,hic
svn,Slovenia,2012,mcv1,95,21560,20482,1078,eur,hic
svn,Slovenia,2012,mcv2,96,20055,19253,802,eur,hic
svn,Slovenia,2013,dtp3,95,21559,20481,1078,eur,hic
svn,Slovenia,2013,mcv1,94,21559,20265,1294,eur,hic
svn,Slovenia,2013,dtp1,98,21559,21128,431,eur,hic
svn,Slovenia,2013,mcv2,95,20946,19899,1047,eur,hic
svn,Slovenia,2014,mcv1,94,21484,20195,1289,eur,hic
svn,Slovenia,2014,dtp3,95,21484,20410,1074,eur,hic
svn,Slovenia,2014,dtp1,98,21484,21054,430,eur,hic
svn,Slovenia,2014,mcv2,94,21664,20364,1300,eur,hic
svn,Slovenia,2015,dtp1,98,21343,20916,427,eur,hic
svn,Slovenia,2015,dtp3,95,21343,20276,1067,eur,hic
svn,Slovenia,2015,mcv1,94,21343,20062,1281,eur,hic
svn,Slovenia,2015,mcv2,96,21985,21106,879,eur,hic
svn,Slovenia,2016,dtp3,94,21140,19872,1268,eur,hic
svn,Slovenia,2016,dtp1,98,21140,20717,423,eur,hic
svn,Slovenia,2016,mcv1,92,21140,19449,1691,eur,hic
svn,Slovenia,2016,mcv2,93,22164,20613,1551,eur,hic
swe,Sweden,2000,mcv1,91,91170,82965,8205,eur,hic
swe,Sweden,2000,dtp1,99,91170,90258,912,eur,hic
swe,Sweden,2000,dtp3,99,91170,90258,912,eur,hic
swe,Sweden,2000,mcv2,94,115534,108602,6932,eur,hic
swe,Sweden,2001,dtp1,99,92450,91525,925,eur,hic
swe,Sweden,2001,mcv1,94,92450,86903,5547,eur,hic
swe,Sweden,2001,dtp3,99,92450,91525,925,eur,hic
swe,Sweden,2001,mcv2,94,118577,111462,7115,eur,hic
swe,Sweden,2002,dtp3,99,94612,93666,946,eur,hic
swe,Sweden,2002,mcv1,95,94612,89881,4731,eur,hic
swe,Sweden,2002,dtp1,99,94612,93666,946,eur,hic
swe,Sweden,2002,mcv2,94,120758,113513,7245,eur,hic
swe,Sweden,2003,dtp3,99,97201,96229,972,eur,hic
swe,Sweden,2003,mcv1,95,97201,92341,4860,eur,hic
swe,Sweden,2003,dtp1,99,97201,96229,972,eur,hic
swe,Sweden,2003,mcv2,95,122585,116456,6129,eur,hic
swe,Sweden,2004,dtp3,99,99978,98978,1000,eur,hic
swe,Sweden,2004,dtp1,99,99978,98978,1000,eur,hic
swe,Sweden,2004,mcv1,96,99978,95979,3999,eur,hic
swe,Sweden,2004,mcv2,95,124992,118742,6250,eur,hic
swe,Sweden,2005,dtp1,99,102700,101673,1027,eur,hic
swe,Sweden,2005,dtp3,98,102700,100646,2054,eur,hic
swe,Sweden,2005,mcv1,96,102700,98592,4108,eur,hic
swe,Sweden,2005,mcv2,95,125352,119084,6268,eur,hic
swe,Sweden,2006,dtp3,98,105184,103080,2104,eur,hic
swe,Sweden,2006,mcv1,97,105184,102028,3156,eur,hic
swe,Sweden,2006,dtp1,99,105184,104132,1052,eur,hic
swe,Sweden,2006,mcv2,95,88409,83989,4420,eur,hic
swe,Sweden,2007,dtp3,98,107394,105246,2148,eur,hic
swe,Sweden,2007,dtp1,99,107394,106320,1074,eur,hic
swe,Sweden,2007,mcv1,96,107394,103098,4296,eur,hic
swe,Sweden,2007,mcv2,95,114049,108347,5702,eur,hic
swe,Sweden,2008,dtp1,99,109312,108219,1093,eur,hic
swe,Sweden,2008,dtp3,98,109312,107126,2186,eur,hic
swe,Sweden,2008,mcv1,96,109312,104940,4372,eur,hic
swe,Sweden,2008,mcv2,94,94847,89156,5691,eur,hic
swe,Sweden,2009,mcv1,97,110905,107578,3327,eur,hic
swe,Sweden,2009,dtp3,98,110905,108687,2218,eur,hic
swe,Sweden,2009,dtp1,99,110905,109796,1109,eur,hic
swe,Sweden,2009,mcv2,95,99963,94965,4998,eur,hic
swe,Sweden,2010,mcv1,97,112214,108848,3366,eur,hic
swe,Sweden,2010,dtp3,98,112214,109970,2244,eur,hic
swe,Sweden,2010,dtp1,99,112214,111092,1122,eur,hic
swe,Sweden,2010,mcv2,94,104018,97777,6241,eur,hic
swe,Sweden,2011,dtp1,99,113345,112212,1133,eur,hic
swe,Sweden,2011,mcv1,97,113345,109945,3400,eur,hic
swe,Sweden,2011,dtp3,98,113345,111078,2267,eur,hic
swe,Sweden,2011,mcv2,95,107265,101902,5363,eur,hic
swe,Sweden,2012,dtp3,98,114448,112159,2289,eur,hic
swe,Sweden,2012,mcv1,98,114448,112159,2289,eur,hic
swe,Sweden,2012,dtp1,99,114448,113304,1144,eur,hic
swe,Sweden,2012,mcv2,95,110331,104814,5517,eur,hic
swe,Sweden,2013,dtp3,98,115627,113314,2313,eur,hic
swe,Sweden,2013,mcv1,97,115627,112158,3469,eur,hic
swe,Sweden,2013,dtp1,99,115627,114471,1156,eur,hic
swe,Sweden,2013,mcv2,95,113234,107572,5662,eur,hic
swe,Sweden,2014,mcv1,97,116901,113394,3507,eur,hic
swe,Sweden,2014,dtp3,98,116901,114563,2338,eur,hic
swe,Sweden,2014,dtp1,99,116901,115732,1169,eur,hic
swe,Sweden,2014,mcv2,95,116015,110214,5801,eur,hic
swe,Sweden,2015,mcv1,97,118258,114710,3548,eur,hic
swe,Sweden,2015,dtp1,99,118258,117075,1183,eur,hic
swe,Sweden,2015,dtp3,98,118258,115893,2365,eur,hic
swe,Sweden,2015,mcv2,95,118796,112856,5940,eur,hic
swe,Sweden,2016,dtp3,98,119651,117258,2393,eur,hic
swe,Sweden,2016,dtp1,99,119651,118454,1197,eur,hic
swe,Sweden,2016,mcv1,97,119651,116061,3590,eur,hic
swe,Sweden,2016,mcv2,95,119936,113939,5997,eur,hic
swz,Swaziland,2000,dtp3,84,31648,26584,5064,afr,mic_nongavi
swz,Swaziland,2000,mcv1,92,31648,29116,2532,afr,mic_nongavi
swz,Swaziland,2000,dtp1,94,31648,29749,1899,afr,mic_nongavi
swz,Swaziland,2001,dtp3,84,31736,26658,5078,afr,mic_nongavi
swz,Swaziland,2001,dtp1,95,31736,30149,1587,afr,mic_nongavi
swz,Swaziland,2001,mcv1,93,31736,29514,2222,afr,mic_nongavi
swz,Swaziland,2002,dtp1,95,31936,30339,1597,afr,mic_nongavi
swz,Swaziland,2002,mcv1,93,31936,29700,2236,afr,mic_nongavi
swz,Swaziland,2002,dtp3,85,31936,27146,4790,afr,mic_nongavi
swz,Swaziland,2002,mcv2,99,31295,30982,313,afr,mic_nongavi
swz,Swaziland,2003,dtp1,95,32227,30616,1611,afr,mic_nongavi
swz,Swaziland,2003,mcv1,93,32227,29971,2256,afr,mic_nongavi
swz,Swaziland,2003,dtp3,85,32227,27393,4834,afr,mic_nongavi
swz,Swaziland,2003,mcv2,99,31140,30829,311,afr,mic_nongavi
swz,Swaziland,2004,dtp1,95,32596,30966,1630,afr,mic_nongavi
swz,Swaziland,2004,mcv1,93,32596,30314,2282,afr,mic_nongavi
swz,Swaziland,2004,dtp3,86,32596,28033,4563,afr,mic_nongavi
swz,Swaziland,2004,mcv2,99,31219,30907,312,afr,mic_nongavi
swz,Swaziland,2005,dtp1,95,33023,31372,1651,afr,mic_nongavi
swz,Swaziland,2005,dtp3,86,33023,28400,4623,afr,mic_nongavi
swz,Swaziland,2005,mcv1,93,33023,30711,2312,afr,mic_nongavi
swz,Swaziland,2005,mcv2,99,31476,31161,315,afr,mic_nongavi
swz,Swaziland,2006,dtp3,87,33480,29128,4352,afr,mic_nongavi
swz,Swaziland,2006,mcv1,93,33480,31136,2344,afr,mic_nongavi
swz,Swaziland,2006,dtp1,95,33480,31806,1674,afr,mic_nongavi
swz,Swaziland,2006,mcv2,99,31740,31423,317,afr,mic_nongavi
swz,Swaziland,2007,dtp3,87,33944,29531,4413,afr,mic_nongavi
swz,Swaziland,2007,mcv1,94,33944,31907,2037,afr,mic_nongavi
swz,Swaziland,2007,dtp1,95,33944,32247,1697,afr,mic_nongavi
swz,Swaziland,2007,mcv2,99,32149,31828,321,afr,mic_nongavi
swz,Swaziland,2008,dtp3,88,34393,30266,4127,afr,mic_nongavi
swz,Swaziland,2008,dtp1,96,34393,33017,1376,afr,mic_nongavi
swz,Swaziland,2008,mcv1,94,34393,32329,2064,afr,mic_nongavi
swz,Swaziland,2008,mcv2,99,32515,32190,325,afr,mic_nongavi
swz,Swaziland,2009,dtp1,95,34810,33070,1740,afr,mic_nongavi
swz,Swaziland,2009,mcv1,94,34810,32721,2089,afr,mic_nongavi
swz,Swaziland,2009,dtp3,88,34810,30633,4177,afr,mic_nongavi
swz,Swaziland,2009,mcv2,99,33071,32740,331,afr,mic_nongavi
swz,Swaziland,2010,dtp1,95,35191,33431,1760,afr,mic_nongavi
swz,Swaziland,2010,mcv1,94,35191,33080,2111,afr,mic_nongavi
swz,Swaziland,2010,dtp3,89,35191,31320,3871,afr,mic_nongavi
swz,Swaziland,2010,mcv2,99,33634,33298,336,afr,mic_nongavi
swz,Swaziland,2011,mcv1,87,35539,30919,4620,afr,mic_nongavi
swz,Swaziland,2011,dtp3,91,35539,32340,3199,afr,mic_nongavi
swz,Swaziland,2011,dtp1,98,35539,34828,711,afr,mic_nongavi
swz,Swaziland,2011,mcv2,92,34475,31717,2758,afr,mic_nongavi
swz,Swaziland,2012,mcv1,88,35866,31562,4304,afr,mic_nongavi
swz,Swaziland,2012,dtp3,95,35866,34073,1793,afr,mic_nongavi
swz,Swaziland,2012,dtp1,97,35866,34790,1076,afr,mic_nongavi
swz,Swaziland,2012,mcv2,52,35276,18344,16932,afr,mic_nongavi
swz,Swaziland,2013,dtp3,98,36178,35454,724,afr,mic_nongavi
swz,Swaziland,2013,dtp1,99,36178,35816,362,afr,mic_nongavi
swz,Swaziland,2013,mcv1,96,36178,34731,1447,afr,mic_nongavi
swz,Swaziland,2013,mcv2,89,34962,31116,3846,afr,mic_nongavi
swz,Swaziland,2014,dtp3,98,36473,35744,729,afr,mic_nongavi
swz,Swaziland,2014,mcv1,97,36473,35379,1094,afr,mic_nongavi
swz,Swaziland,2014,dtp1,99,36473,36108,365,afr,mic_nongavi
swz,Swaziland,2014,mcv2,89,35381,31489,3892,afr,mic_nongavi
swz,Swaziland,2015,mcv1,89,36736,32695,4041,afr,mic_nongavi
swz,Swaziland,2015,dtp3,90,36736,33062,3674,afr,mic_nongavi
swz,Swaziland,2015,dtp1,96,36736,35267,1469,afr,mic_nongavi
swz,Swaziland,2015,mcv2,89,35765,31831,3934,afr,mic_nongavi
swz,Swaziland,2016,dtp3,90,36956,33260,3696,afr,mic_nongavi
swz,Swaziland,2016,dtp1,96,36956,35478,1478,afr,mic_nongavi
swz,Swaziland,2016,mcv1,89,36956,32891,4065,afr,mic_nongavi
swz,Swaziland,2016,mcv2,89,35987,32028,3959,afr,mic_nongavi
syc,Seychelles,2000,dtp3,98,1533,1502,31,afr,hic
syc,Seychelles,2000,mcv1,97,1533,1487,46,afr,hic
syc,Seychelles,2000,dtp1,99,1533,1518,15,afr,hic
syc,Seychelles,2001,dtp3,96,1561,1499,62,afr,hic
syc,Seychelles,2001,dtp1,99,1561,1545,16,afr,hic
syc,Seychelles,2001,mcv1,95,1561,1483,78,afr,hic
syc,Seychelles,2001,mcv2,98,1517,1487,30,afr,hic
syc,Seychelles,2002,dtp1,99,1591,1575,16,afr,hic
syc,Seychelles,2002,mcv1,98,1591,1559,32,afr,hic
syc,Seychelles,2002,dtp3,99,1591,1575,16,afr,hic
syc,Seychelles,2002,mcv2,99,1474,1459,15,afr,hic
syc,Seychelles,2003,mcv1,99,1620,1604,16,afr,hic
syc,Seychelles,2003,dtp1,99,1620,1604,16,afr,hic
syc,Seychelles,2003,dtp3,99,1620,1604,16,afr,hic
syc,Seychelles,2003,mcv2,99,1433,1419,14,afr,hic
syc,Seychelles,2004,dtp1,99,1646,1630,16,afr,hic
syc,Seychelles,2004,mcv1,99,1646,1630,16,afr,hic
syc,Seychelles,2004,dtp3,99,1646,1630,16,afr,hic
syc,Seychelles,2004,mcv2,99,1399,1385,14,afr,hic
syc,Seychelles,2005,dtp3,99,1666,1649,17,afr,hic
syc,Seychelles,2005,dtp1,99,1666,1649,17,afr,hic
syc,Seychelles,2005,mcv1,99,1666,1649,17,afr,hic
syc,Seychelles,2005,mcv2,99,1380,1366,14,afr,hic
syc,Seychelles,2006,dtp3,99,1680,1663,17,afr,hic
syc,Seychelles,2006,dtp1,99,1680,1663,17,afr,hic
syc,Seychelles,2006,mcv1,99,1680,1663,17,afr,hic
syc,Seychelles,2006,mcv2,99,1379,1365,14,afr,hic
syc,Seychelles,2007,dtp1,99,1686,1669,17,afr,hic
syc,Seychelles,2007,mcv1,99,1686,1669,17,afr,hic
syc,Seychelles,2007,dtp3,99,1686,1669,17,afr,hic
syc,Seychelles,2007,mcv2,99,1378,1364,14,afr,hic
syc,Seychelles,2008,dtp1,99,1688,1671,17,afr,hic
syc,Seychelles,2008,mcv1,99,1688,1671,17,afr,hic
syc,Seychelles,2008,dtp3,99,1688,1671,17,afr,hic
syc,Seychelles,2008,mcv2,98,1371,1344,27,afr,hic
syc,Seychelles,2009,dtp1,99,1685,1668,17,afr,hic
syc,Seychelles,2009,mcv1,97,1685,1634,51,afr,hic
syc,Seychelles,2009,dtp3,99,1685,1668,17,afr,hic
syc,Seychelles,2009,mcv2,99,1357,1343,14,afr,hic
syc,Seychelles,2010,dtp1,99,1676,1659,17,afr,hic
syc,Seychelles,2010,dtp3,99,1676,1659,17,afr,hic
syc,Seychelles,2010,mcv1,99,1676,1659,17,afr,hic
syc,Seychelles,2010,mcv2,98,1326,1299,27,afr,hic
syc,Seychelles,2011,dtp1,99,1660,1643,17,afr,hic
syc,Seychelles,2011,dtp3,99,1660,1643,17,afr,hic
syc,Seychelles,2011,mcv1,99,1660,1643,17,afr,hic
syc,Seychelles,2011,mcv2,99,1325,1312,13,afr,hic
syc,Seychelles,2012,dtp3,98,1638,1605,33,afr,hic
syc,Seychelles,2012,mcv1,98,1638,1605,33,afr,hic
syc,Seychelles,2012,dtp1,98,1638,1605,33,afr,hic
syc,Seychelles,2012,mcv2,99,1337,1324,13,afr,hic
syc,Seychelles,2013,mcv1,97,1611,1563,48,afr,hic
syc,Seychelles,2013,dtp3,98,1611,1579,32,afr,hic
syc,Seychelles,2013,dtp1,99,1611,1595,16,afr,hic
syc,Seychelles,2013,mcv2,97,1357,1316,41,afr,hic
syc,Seychelles,2014,dtp3,99,1581,1565,16,afr,hic
syc,Seychelles,2014,mcv1,99,1581,1565,16,afr,hic
syc,Seychelles,2014,dtp1,99,1581,1565,16,afr,hic
syc,Seychelles,2014,mcv2,98,1381,1353,28,afr,hic
syc,Seychelles,2015,mcv1,98,1547,1516,31,afr,hic
syc,Seychelles,2015,dtp3,97,1547,1501,46,afr,hic
syc,Seychelles,2015,dtp1,99,1547,1532,15,afr,hic
syc,Seychelles,2015,mcv2,98,1402,1374,28,afr,hic
syc,Seychelles,2016,dtp1,98,1511,1481,30,afr,hic
syc,Seychelles,2016,mcv1,97,1511,1466,45,afr,hic
syc,Seychelles,2016,dtp3,96,1511,1451,60,afr,hic
syc,Seychelles,2016,mcv2,99,1447,1433,14,afr,hic
syr,Syrian Arab Republic,2000,dtp3,84,499143,419280,79863,emr,mic_nongavi
syr,Syrian Arab Republic,2000,mcv1,84,499143,419280,79863,emr,mic_nongavi
syr,Syrian Arab Republic,2000,dtp1,90,499143,449229,49914,emr,mic_nongavi
syr,Syrian Arab Republic,2000,mcv2,80,482164,385731,96433,emr,mic_nongavi
syr,Syrian Arab Republic,2001,dtp3,82,503915,413210,90705,emr,mic_nongavi
syr,Syrian Arab Republic,2001,mcv1,80,503915,403132,100783,emr,mic_nongavi
syr,Syrian Arab Republic,2001,dtp1,90,503915,453524,50391,emr,mic_nongavi
syr,Syrian Arab Republic,2001,mcv2,83,500453,415376,85077,emr,mic_nongavi
syr,Syrian Arab Republic,2002,dtp1,92,508928,468214,40714,emr,mic_nongavi
syr,Syrian Arab Republic,2002,mcv1,84,508928,427500,81428,emr,mic_nongavi
syr,Syrian Arab Republic,2002,dtp3,84,508928,427500,81428,emr,mic_nongavi
syr,Syrian Arab Republic,2002,mcv2,84,516016,433453,82563,emr,mic_nongavi
syr,Syrian Arab Republic,2003,dtp1,90,514390,462951,51439,emr,mic_nongavi
syr,Syrian Arab Republic,2003,mcv1,83,514390,426944,87446,emr,mic_nongavi
syr,Syrian Arab Republic,2003,dtp3,83,514390,426944,87446,emr,mic_nongavi
syr,Syrian Arab Republic,2003,mcv2,83,495055,410896,84159,emr,mic_nongavi
syr,Syrian Arab Republic,2004,dtp1,89,519977,462780,57197,emr,mic_nongavi
syr,Syrian Arab Republic,2004,dtp3,81,519977,421181,98796,emr,mic_nongavi
syr,Syrian Arab Republic,2004,mcv1,82,519977,426381,93596,emr,mic_nongavi
syr,Syrian Arab Republic,2004,mcv2,82,500392,410321,90071,emr,mic_nongavi
syr,Syrian Arab Republic,2005,dtp1,88,524953,461959,62994,emr,mic_nongavi
syr,Syrian Arab Republic,2005,dtp3,80,524953,419962,104991,emr,mic_nongavi
syr,Syrian Arab Republic,2005,mcv1,81,524953,425212,99741,emr,mic_nongavi
syr,Syrian Arab Republic,2005,mcv2,81,508662,412016,96646,emr,mic_nongavi
syr,Syrian Arab Republic,2006,dtp3,80,528346,422677,105669,emr,mic_nongavi
syr,Syrian Arab Republic,2006,dtp1,88,528346,464944,63402,emr,mic_nongavi
syr,Syrian Arab Republic,2006,mcv1,81,528346,427960,100386,emr,mic_nongavi
syr,Syrian Arab Republic,2006,mcv2,81,506685,410415,96270,emr,mic_nongavi
syr,Syrian Arab Republic,2007,dtp3,80,529217,423374,105843,emr,mic_nongavi
syr,Syrian Arab Republic,2007,mcv1,81,529217,428666,100551,emr,mic_nongavi
syr,Syrian Arab Republic,2007,dtp1,88,529217,465711,63506,emr,mic_nongavi
syr,Syrian Arab Republic,2007,mcv2,81,507184,410819,96365,emr,mic_nongavi
syr,Syrian Arab Republic,2008,dtp3,79,526890,416243,110647,emr,mic_nongavi
syr,Syrian Arab Republic,2008,dtp1,88,526890,463663,63227,emr,mic_nongavi
syr,Syrian Arab Republic,2008,mcv1,81,526890,426781,100109,emr,mic_nongavi
syr,Syrian Arab Republic,2008,mcv2,81,541274,438432,102842,emr,mic_nongavi
syr,Syrian Arab Republic,2009,dtp1,89,521094,463774,57320,emr,mic_nongavi
syr,Syrian Arab Republic,2009,mcv1,82,521094,427297,93797,emr,mic_nongavi
syr,Syrian Arab Republic,2009,dtp3,80,521094,416875,104219,emr,mic_nongavi
syr,Syrian Arab Republic,2009,mcv2,82,542453,444811,97642,emr,mic_nongavi
syr,Syrian Arab Republic,2010,dtp1,89,511306,455062,56244,emr,mic_nongavi
syr,Syrian Arab Republic,2010,mcv1,82,511306,419271,92035,emr,mic_nongavi
syr,Syrian Arab Republic,2010,dtp3,80,511306,409045,102261,emr,mic_nongavi
syr,Syrian Arab Republic,2010,mcv2,82,531227,435606,95621,emr,mic_nongavi
syr,Syrian Arab Republic,2011,mcv1,80,497172,397738,99434,emr,mic_nongavi
syr,Syrian Arab Republic,2011,dtp3,72,497172,357964,139208,emr,mic_nongavi
syr,Syrian Arab Republic,2011,dtp1,86,497172,427568,69604,emr,mic_nongavi
syr,Syrian Arab Republic,2011,mcv2,71,536371,380823,155548,emr,mic_nongavi
syr,Syrian Arab Republic,2012,mcv1,61,479512,292502,187010,emr,mic_nongavi
syr,Syrian Arab Republic,2012,dtp3,45,479512,215780,263732,emr,mic_nongavi
syr,Syrian Arab Republic,2012,dtp1,68,479512,326068,153444,emr,mic_nongavi
syr,Syrian Arab Republic,2012,mcv2,53,530379,281101,249278,emr,mic_nongavi
syr,Syrian Arab Republic,2013,dtp3,41,459634,188450,271184,emr,mic_nongavi
syr,Syrian Arab Republic,2013,dtp1,55,459634,252799,206835,emr,mic_nongavi
syr,Syrian Arab Republic,2013,mcv1,58,459634,266588,193046,emr,mic_nongavi
syr,Syrian Arab Republic,2013,mcv2,51,492335,251091,241244,emr,mic_nongavi
syr,Syrian Arab Republic,2014,dtp3,43,438903,188728,250175,emr,mic_nongavi
syr,Syrian Arab Republic,2014,mcv1,54,438903,237008,201895,emr,mic_nongavi
syr,Syrian Arab Republic,2014,dtp1,65,438903,285287,153616,emr,mic_nongavi
syr,Syrian Arab Republic,2014,mcv2,49,469763,230184,239579,emr,mic_nongavi
syr,Syrian Arab Republic,2015,dtp3,41,419273,171902,247371,emr,mic_nongavi
syr,Syrian Arab Republic,2015,mcv1,53,419273,222215,197058,emr,mic_nongavi
syr,Syrian Arab Republic,2015,dtp1,62,419273,259949,159324,emr,mic_nongavi
syr,Syrian Arab Republic,2015,mcv2,47,450200,211594,238606,emr,mic_nongavi
syr,Syrian Arab Republic,2016,dtp3,42,402786,169170,233616,emr,mic_nongavi
syr,Syrian Arab Republic,2016,dtp1,61,402786,245699,157087,emr,mic_nongavi
syr,Syrian Arab Republic,2016,mcv1,62,402786,249727,153059,emr,mic_nongavi
syr,Syrian Arab Republic,2016,mcv2,52,422668,219787,202881,emr,mic_nongavi
tcd,Chad,2000,dtp3,36,379098,136475,242623,afr,gavi
tcd,Chad,2000,dtp1,45,379098,170594,208504,afr,gavi
tcd,Chad,2000,mcv1,28,379098,106147,272951,afr,gavi
tcd,Chad,2001,dtp1,44,391779,172383,219396,afr,gavi
tcd,Chad,2001,dtp3,26,391779,101863,289916,afr,gavi
tcd,Chad,2001,mcv1,26,391779,101863,289916,afr,gavi
tcd,Chad,2002,dtp1,45,404478,182015,222463,afr,gavi
tcd,Chad,2002,dtp3,25,404478,101120,303358,afr,gavi
tcd,Chad,2002,mcv1,25,404478,101120,303358,afr,gavi
tcd,Chad,2003,dtp1,45,417111,187700,229411,afr,gavi
tcd,Chad,2003,dtp3,23,417111,95936,321175,afr,gavi
tcd,Chad,2003,mcv1,23,417111,95936,321175,afr,gavi
tcd,Chad,2004,dtp1,35,429617,150366,279251,afr,gavi
tcd,Chad,2004,dtp3,21,429617,90220,339397,afr,gavi
tcd,Chad,2004,mcv1,16,429617,68739,360878,afr,gavi
tcd,Chad,2005,dtp1,46,441960,203302,238658,afr,gavi
tcd,Chad,2005,dtp3,25,441960,110490,331470,afr,gavi
tcd,Chad,2005,mcv1,27,441960,119329,322631,afr,gavi
tcd,Chad,2006,dtp3,40,454136,181654,272482,afr,gavi
tcd,Chad,2006,dtp1,58,454136,263399,190737,afr,gavi
tcd,Chad,2006,mcv1,39,454136,177113,277023,afr,gavi
tcd,Chad,2007,mcv1,31,466201,144522,321679,afr,gavi
tcd,Chad,2007,dtp3,28,466201,130536,335665,afr,gavi
tcd,Chad,2007,dtp1,50,466201,233100,233101,afr,gavi
tcd,Chad,2008,mcv1,27,478204,129115,349089,afr,gavi
tcd,Chad,2008,dtp1,47,478204,224756,253448,afr,gavi
tcd,Chad,2008,dtp3,19,478204,90859,387345,afr,gavi
tcd,Chad,2009,dtp1,45,490165,220574,269591,afr,gavi
tcd,Chad,2009,mcv1,36,490165,176459,313706,afr,gavi
tcd,Chad,2009,dtp3,24,490165,117640,372525,afr,gavi
tcd,Chad,2010,dtp1,55,502122,276167,225955,afr,gavi
tcd,Chad,2010,mcv1,46,502122,230976,271146,afr,gavi
tcd,Chad,2010,dtp3,39,502122,195828,306294,afr,gavi
tcd,Chad,2011,dtp1,55,514111,282761,231350,afr,gavi
tcd,Chad,2011,dtp3,33,514111,169657,344454,afr,gavi
tcd,Chad,2011,mcv1,54,514111,277620,236491,afr,gavi
tcd,Chad,2012,dtp1,57,526149,299905,226244,afr,gavi
tcd,Chad,2012,dtp3,40,526149,210460,315689,afr,gavi
tcd,Chad,2012,mcv1,63,526149,331474,194675,afr,gavi
tcd,Chad,2013,dtp1,58,538231,312174,226057,afr,gavi
tcd,Chad,2013,dtp3,39,538231,209910,328321,afr,gavi
tcd,Chad,2013,mcv1,57,538231,306792,231439,afr,gavi
tcd,Chad,2014,dtp3,37,550340,203626,346714,afr,gavi
tcd,Chad,2014,mcv1,52,550340,286177,264163,afr,gavi
tcd,Chad,2014,dtp1,60,550340,330204,220136,afr,gavi
tcd,Chad,2015,dtp3,46,562449,258727,303722,afr,gavi
tcd,Chad,2015,dtp1,60,562449,337469,224980,afr,gavi
tcd,Chad,2015,mcv1,60,562449,337469,224980,afr,gavi
tcd,Chad,2016,dtp1,60,574517,344710,229807,afr,gavi
tcd,Chad,2016,mcv1,58,574517,333220,241297,afr,gavi
tcd,Chad,2016,dtp3,46,574517,264278,310239,afr,gavi
tgo,Togo,2000,mcv1,58,180224,104530,75694,afr,gavi
tgo,Togo,2000,dtp1,80,180224,144179,36045,afr,gavi
tgo,Togo,2000,dtp3,64,180224,115343,64881,afr,gavi
tgo,Togo,2001,dtp1,63,185778,117040,68738,afr,gavi
tgo,Togo,2001,mcv1,40,185778,74311,111467,afr,gavi
tgo,Togo,2001,dtp3,50,185778,92889,92889,afr,gavi
tgo,Togo,2002,dtp3,59,191413,112934,78479,afr,gavi
tgo,Togo,2002,dtp1,75,191413,143560,47853,afr,gavi
tgo,Togo,2002,mcv1,48,191413,91878,99535,afr,gavi
tgo,Togo,2003,dtp1,83,196985,163498,33487,afr,gavi
tgo,Togo,2003,dtp3,72,196985,141829,55156,afr,gavi
tgo,Togo,2003,mcv1,68,196985,133950,63035,afr,gavi
tgo,Togo,2004,dtp1,83,202379,167975,34404,afr,gavi
tgo,Togo,2004,dtp3,71,202379,143689,58690,afr,gavi
tgo,Togo,2004,mcv1,70,202379,141665,60714,afr,gavi
tgo,Togo,2005,mcv1,70,207486,145240,62246,afr,gavi
tgo,Togo,2005,dtp1,91,207486,188812,18674,afr,gavi
tgo,Togo,2005,dtp3,82,207486,170139,37347,afr,gavi
tgo,Togo,2006,dtp3,84,212235,178277,33958,afr,gavi
tgo,Togo,2006,dtp1,91,212235,193134,19101,afr,gavi
tgo,Togo,2006,mcv1,78,212235,165543,46692,afr,gavi
tgo,Togo,2007,mcv1,71,216644,153817,62827,afr,gavi
tgo,Togo,2007,dtp3,82,216644,177648,38996,afr,gavi
tgo,Togo,2007,dtp1,94,216644,203645,12999,afr,gavi
tgo,Togo,2008,mcv1,63,220737,139064,81673,afr,gavi
tgo,Togo,2008,dtp1,92,220737,203078,17659,afr,gavi
tgo,Togo,2008,dtp3,81,220737,178797,41940,afr,gavi
tgo,Togo,2009,dtp1,93,224520,208804,15716,afr,gavi
tgo,Togo,2009,mcv1,66,224520,148183,76337,afr,gavi
tgo,Togo,2009,dtp3,78,224520,175126,49394,afr,gavi
tgo,Togo,2010,dtp1,97,228005,221165,6840,afr,gavi
tgo,Togo,2010,dtp3,83,228005,189244,38761,afr,gavi
tgo,Togo,2010,mcv1,68,228005,155043,72962,afr,gavi
tgo,Togo,2011,mcv1,72,231222,166480,64742,afr,gavi
tgo,Togo,2011,dtp3,85,231222,196539,34683,afr,gavi
tgo,Togo,2011,dtp1,94,231222,217349,13873,afr,gavi
tgo,Togo,2012,dtp3,84,234243,196764,37479,afr,gavi
tgo,Togo,2012,mcv1,72,234243,168655,65588,afr,gavi
tgo,Togo,2012,dtp1,94,234243,220188,14055,afr,gavi
tgo,Togo,2013,dtp3,84,237146,199203,37943,afr,gavi
tgo,Togo,2013,dtp1,94,237146,222917,14229,afr,gavi
tgo,Togo,2013,mcv1,72,237146,170745,66401,afr,gavi
tgo,Togo,2014,dtp3,87,239989,208790,31199,afr,gavi
tgo,Togo,2014,mcv1,82,239989,196791,43198,afr,gavi
tgo,Togo,2014,dtp1,91,239989,218390,21599,afr,gavi
tgo,Togo,2015,dtp1,92,242829,223403,19426,afr,gavi
tgo,Togo,2015,mcv1,85,242829,206405,36424,afr,gavi
tgo,Togo,2015,dtp3,88,242829,213690,29139,afr,gavi
tgo,Togo,2016,dtp1,93,245701,228502,17199,afr,gavi
tgo,Togo,2016,mcv1,87,245701,213760,31941,afr,gavi
tgo,Togo,2016,dtp3,89,245701,218674,27027,afr,gavi
tha,Thailand,2000,dtp3,97,895615,868747,26868,sear,mic_nongavi
tha,Thailand,2000,mcv1,94,895615,841878,53737,sear,mic_nongavi
tha,Thailand,2000,dtp1,98,895615,877703,17912,sear,mic_nongavi
tha,Thailand,2000,mcv2,99,1010516,1000411,10105,sear,mic_nongavi
tha,Thailand,2001,dtp3,96,879566,844383,35183,sear,mic_nongavi
tha,Thailand,2001,mcv1,94,879566,826792,52774,sear,mic_nongavi
tha,Thailand,2001,dtp1,98,879566,861975,17591,sear,mic_nongavi
tha,Thailand,2001,mcv2,86,995393,856038,139355,sear,mic_nongavi
tha,Thailand,2002,dtp1,98,865033,847732,17301,sear,mic_nongavi
tha,Thailand,2002,mcv1,94,865033,813131,51902,sear,mic_nongavi
tha,Thailand,2002,dtp3,96,865033,830432,34601,sear,mic_nongavi
tha,Thailand,2002,mcv2,89,976511,869095,107416,sear,mic_nongavi
tha,Thailand,2003,dtp1,99,852000,843480,8520,sear,mic_nongavi
tha,Thailand,2003,mcv1,96,852000,817920,34080,sear,mic_nongavi
tha,Thailand,2003,dtp3,98,852000,834960,17040,sear,mic_nongavi
tha,Thailand,2003,mcv2,92,955314,878889,76425,sear,mic_nongavi
tha,Thailand,2004,dtp1,99,840422,832018,8404,sear,mic_nongavi
tha,Thailand,2004,mcv1,96,840422,806805,33617,sear,mic_nongavi
tha,Thailand,2004,dtp3,98,840422,823614,16808,sear,mic_nongavi
tha,Thailand,2004,mcv2,95,933015,886364,46651,sear,mic_nongavi
tha,Thailand,2005,dtp1,99,830140,821839,8301,sear,mic_nongavi
tha,Thailand,2005,dtp3,98,830140,813537,16603,sear,mic_nongavi
tha,Thailand,2005,mcv1,96,830140,796934,33206,sear,mic_nongavi
tha,Thailand,2005,mcv2,95,911501,865926,45575,sear,mic_nongavi
tha,Thailand,2006,dtp3,98,820861,804444,16417,sear,mic_nongavi
tha,Thailand,2006,mcv1,96,820861,788027,32834,sear,mic_nongavi
tha,Thailand,2006,dtp1,99,820861,812652,8209,sear,mic_nongavi
tha,Thailand,2006,mcv2,94,894025,840384,53641,sear,mic_nongavi
tha,Thailand,2007,dtp3,98,812070,795829,16241,sear,mic_nongavi
tha,Thailand,2007,mcv1,96,812070,779587,32483,sear,mic_nongavi
tha,Thailand,2007,dtp1,99,812070,803949,8121,sear,mic_nongavi
tha,Thailand,2007,mcv2,94,876884,824271,52613,sear,mic_nongavi
tha,Thailand,2008,dtp3,99,803257,795224,8033,sear,mic_nongavi
tha,Thailand,2008,dtp1,99,803257,795224,8033,sear,mic_nongavi
tha,Thailand,2008,mcv1,98,803257,787192,16065,sear,mic_nongavi
tha,Thailand,2008,mcv2,91,860395,782959,77436,sear,mic_nongavi
tha,Thailand,2009,dtp1,99,794064,786123,7941,sear,mic_nongavi
tha,Thailand,2009,mcv1,98,794064,778183,15881,sear,mic_nongavi
tha,Thailand,2009,dtp3,99,794064,786123,7941,sear,mic_nongavi
tha,Thailand,2009,mcv2,91,844755,768727,76028,sear,mic_nongavi
tha,Thailand,2010,dtp1,99,784031,776191,7840,sear,mic_nongavi
tha,Thailand,2010,mcv1,98,784031,768350,15681,sear,mic_nongavi
tha,Thailand,2010,dtp3,99,784031,776191,7840,sear,mic_nongavi
tha,Thailand,2010,mcv2,91,830206,755487,74719,sear,mic_nongavi
tha,Thailand,2011,mcv1,98,772784,757328,15456,sear,mic_nongavi
tha,Thailand,2011,dtp1,99,772784,765056,7728,sear,mic_nongavi
tha,Thailand,2011,dtp3,99,772784,765056,7728,sear,mic_nongavi
tha,Thailand,2011,mcv2,91,825197,750929,74268,sear,mic_nongavi
tha,Thailand,2012,dtp3,99,760361,752757,7604,sear,mic_nongavi
tha,Thailand,2012,mcv1,98,760361,745154,15207,sear,mic_nongavi
tha,Thailand,2012,dtp1,99,760361,752757,7604,sear,mic_nongavi
tha,Thailand,2012,mcv2,91,823278,749183,74095,sear,mic_nongavi
tha,Thailand,2013,dtp3,99,746957,739487,7470,sear,mic_nongavi
tha,Thailand,2013,dtp1,99,746957,739487,7470,sear,mic_nongavi
tha,Thailand,2013,mcv1,99,746957,739487,7470,sear,mic_nongavi
tha,Thailand,2013,mcv2,94,822294,772956,49338,sear,mic_nongavi
tha,Thailand,2014,dtp3,99,732793,725465,7328,sear,mic_nongavi
tha,Thailand,2014,mcv1,99,732793,725465,7328,sear,mic_nongavi
tha,Thailand,2014,dtp1,99,732793,725465,7328,sear,mic_nongavi
tha,Thailand,2014,mcv2,94,820355,771134,49221,sear,mic_nongavi
tha,Thailand,2015,dtp3,99,718231,711049,7182,sear,mic_nongavi
tha,Thailand,2015,mcv1,99,718231,711049,7182,sear,mic_nongavi
tha,Thailand,2015,dtp1,99,718231,711049,7182,sear,mic_nongavi
tha,Thailand,2015,mcv2,95,814766,774028,40738,sear,mic_nongavi
tha,Thailand,2016,dtp3,99,703731,696694,7037,sear,mic_nongavi
tha,Thailand,2016,dtp1,99,703731,696694,7037,sear,mic_nongavi
tha,Thailand,2016,mcv1,99,703731,696694,7037,sear,mic_nongavi
tha,Thailand,2016,mcv2,95,804741,764504,40237,sear,mic_nongavi
tjk,Tajikistan,2000,dtp1,88,175355,154312,21043,eur,gavi
tjk,Tajikistan,2000,mcv1,88,175355,154312,21043,eur,gavi
tjk,Tajikistan,2000,dtp3,83,175355,145545,29810,eur,gavi
tjk,Tajikistan,2000,mcv2,59,176440,104100,72340,eur,gavi
tjk,Tajikistan,2001,mcv1,88,174623,153668,20955,eur,gavi
tjk,Tajikistan,2001,dtp3,85,174623,148430,26193,eur,gavi
tjk,Tajikistan,2001,dtp1,89,174623,155414,19209,eur,gavi
tjk,Tajikistan,2001,mcv2,72,175270,126194,49076,eur,gavi
tjk,Tajikistan,2002,dtp3,85,175203,148923,26280,eur,gavi
tjk,Tajikistan,2002,dtp1,92,175203,161187,14016,eur,gavi
tjk,Tajikistan,2002,mcv1,89,175203,155931,19272,eur,gavi
tjk,Tajikistan,2002,mcv2,93,175337,163063,12274,eur,gavi
tjk,Tajikistan,2003,dtp1,92,177262,163081,14181,eur,gavi
tjk,Tajikistan,2003,mcv1,91,177262,161308,15954,eur,gavi
tjk,Tajikistan,2003,dtp3,85,177262,150673,26589,eur,gavi
tjk,Tajikistan,2003,mcv2,94,176027,165465,10562,eur,gavi
tjk,Tajikistan,2004,dtp1,93,180823,168165,12658,eur,gavi
tjk,Tajikistan,2004,mcv1,92,180823,166357,14466,eur,gavi
tjk,Tajikistan,2004,dtp3,86,180823,155508,25315,eur,gavi
tjk,Tajikistan,2004,mcv2,98,176583,173051,3532,eur,gavi
tjk,Tajikistan,2005,dtp3,84,185831,156098,29733,eur,gavi
tjk,Tajikistan,2005,dtp1,92,185831,170965,14866,eur,gavi
tjk,Tajikistan,2005,mcv1,85,185831,157956,27875,eur,gavi
tjk,Tajikistan,2005,mcv2,92,176199,162103,14096,eur,gavi
tjk,Tajikistan,2006,dtp1,92,192103,176735,15368,eur,gavi
tjk,Tajikistan,2006,mcv1,82,192103,157524,34579,eur,gavi
tjk,Tajikistan,2006,dtp3,83,192103,159445,32658,eur,gavi
tjk,Tajikistan,2006,mcv2,96,175187,168180,7007,eur,gavi
tjk,Tajikistan,2007,dtp1,88,199168,175268,23900,eur,gavi
tjk,Tajikistan,2007,mcv1,85,199168,169293,29875,eur,gavi
tjk,Tajikistan,2007,dtp3,86,199168,171284,27884,eur,gavi
tjk,Tajikistan,2007,mcv2,90,172822,155540,17282,eur,gavi
tjk,Tajikistan,2008,mcv1,86,206529,177615,28914,eur,gavi
tjk,Tajikistan,2008,dtp1,92,206529,190007,16522,eur,gavi
tjk,Tajikistan,2008,dtp3,86,206529,177615,28914,eur,gavi
tjk,Tajikistan,2008,mcv2,87,170201,148075,22126,eur,gavi
tjk,Tajikistan,2009,mcv1,89,213804,190286,23518,eur,gavi
tjk,Tajikistan,2009,dtp3,93,213804,198838,14966,eur,gavi
tjk,Tajikistan,2009,dtp1,96,213804,205252,8552,eur,gavi
tjk,Tajikistan,2009,mcv2,93,168458,156666,11792,eur,gavi
tjk,Tajikistan,2010,mcv1,94,220613,207376,13237,eur,gavi
tjk,Tajikistan,2010,dtp1,95,220613,209582,11031,eur,gavi
tjk,Tajikistan,2010,dtp3,93,220613,205170,15443,eur,gavi
tjk,Tajikistan,2010,mcv2,95,168943,160496,8447,eur,gavi
tjk,Tajikistan,2011,dtp1,98,226657,222124,4533,eur,gavi
tjk,Tajikistan,2011,dtp3,96,226657,217591,9066,eur,gavi
tjk,Tajikistan,2011,mcv1,98,226657,222124,4533,eur,gavi
tjk,Tajikistan,2011,mcv2,96,172834,165921,6913,eur,gavi
tjk,Tajikistan,2012,dtp1,96,231846,222572,9274,eur,gavi
tjk,Tajikistan,2012,mcv1,94,231846,217935,13911,eur,gavi
tjk,Tajikistan,2012,dtp3,94,231846,217935,13911,eur,gavi
tjk,Tajikistan,2012,mcv2,97,179992,174592,5400,eur,gavi
tjk,Tajikistan,2013,dtp1,98,236119,231397,4722,eur,gavi
tjk,Tajikistan,2013,dtp3,96,236119,226674,9445,eur,gavi
tjk,Tajikistan,2013,mcv1,92,236119,217229,18890,eur,gavi
tjk,Tajikistan,2013,mcv2,92,189059,173934,15125,eur,gavi
tjk,Tajikistan,2014,dtp3,97,239385,232203,7182,eur,gavi
tjk,Tajikistan,2014,dtp1,98,239385,234597,4788,eur,gavi
tjk,Tajikistan,2014,mcv1,98,239385,234597,4788,eur,gavi
tjk,Tajikistan,2014,mcv2,98,198610,194638,3972,eur,gavi
tjk,Tajikistan,2015,dtp1,97,241614,234366,7248,eur,gavi
tjk,Tajikistan,2015,mcv1,97,241614,234366,7248,eur,gavi
tjk,Tajikistan,2015,dtp3,96,241614,231949,9665,eur,gavi
tjk,Tajikistan,2015,mcv2,94,206702,194300,12402,eur,gavi
tjk,Tajikistan,2016,dtp1,98,242863,238006,4857,eur,gavi
tjk,Tajikistan,2016,dtp3,96,242863,233148,9715,eur,gavi
tjk,Tajikistan,2016,mcv1,97,242863,235577,7286,eur,gavi
tjk,Tajikistan,2016,mcv2,97,214158,207733,6425,eur,gavi
tkm,Turkmenistan,2000,mcv1,96,99775,95784,3991,eur,mic_nongavi
tkm,Turkmenistan,2000,dtp1,97,99775,96782,2993,eur,mic_nongavi
tkm,Turkmenistan,2000,dtp3,97,99775,96782,2993,eur,mic_nongavi
tkm,Turkmenistan,2000,mcv2,92,115438,106203,9235,eur,mic_nongavi
tkm,Turkmenistan,2001,mcv1,98,99702,97708,1994,eur,mic_nongavi
tkm,Turkmenistan,2001,dtp1,96,99702,95714,3988,eur,mic_nongavi
tkm,Turkmenistan,2001,dtp3,95,99702,94717,4985,eur,mic_nongavi
tkm,Turkmenistan,2001,mcv2,94,112066,105342,6724,eur,mic_nongavi
tkm,Turkmenistan,2002,dtp3,98,100067,98066,2001,eur,mic_nongavi
tkm,Turkmenistan,2002,dtp1,99,100067,99066,1001,eur,mic_nongavi
tkm,Turkmenistan,2002,mcv1,88,100067,88059,12008,eur,mic_nongavi
tkm,Turkmenistan,2002,mcv2,87,106814,92928,13886,eur,mic_nongavi
tkm,Turkmenistan,2003,dtp1,96,100696,96668,4028,eur,mic_nongavi
tkm,Turkmenistan,2003,mcv1,97,100696,97675,3021,eur,mic_nongavi
tkm,Turkmenistan,2003,dtp3,83,100696,83578,17118,eur,mic_nongavi
tkm,Turkmenistan,2003,mcv2,89,100873,89777,11096,eur,mic_nongavi
tkm,Turkmenistan,2004,dtp1,98,101609,99577,2032,eur,mic_nongavi
tkm,Turkmenistan,2004,mcv1,97,101609,98561,3048,eur,mic_nongavi
tkm,Turkmenistan,2004,dtp3,97,101609,98561,3048,eur,mic_nongavi
tkm,Turkmenistan,2004,mcv2,90,95451,85906,9545,eur,mic_nongavi
tkm,Turkmenistan,2005,dtp3,99,103056,102025,1031,eur,mic_nongavi
tkm,Turkmenistan,2005,dtp1,99,103056,102025,1031,eur,mic_nongavi
tkm,Turkmenistan,2005,mcv1,99,103056,102025,1031,eur,mic_nongavi
tkm,Turkmenistan,2005,mcv2,98,91980,90140,1840,eur,mic_nongavi
tkm,Turkmenistan,2006,mcv1,99,105391,104337,1054,eur,mic_nongavi
tkm,Turkmenistan,2006,dtp1,99,105391,104337,1054,eur,mic_nongavi
tkm,Turkmenistan,2006,dtp3,98,105391,103283,2108,eur,mic_nongavi
tkm,Turkmenistan,2006,mcv2,99,90752,89844,908,eur,mic_nongavi
tkm,Turkmenistan,2007,mcv1,99,108778,107690,1088,eur,mic_nongavi
tkm,Turkmenistan,2007,dtp3,98,108778,106602,2176,eur,mic_nongavi
tkm,Turkmenistan,2007,dtp1,99,108778,107690,1088,eur,mic_nongavi
tkm,Turkmenistan,2007,mcv2,98,92087,90245,1842,eur,mic_nongavi
tkm,Turkmenistan,2008,dtp1,98,113167,110904,2263,eur,mic_nongavi
tkm,Turkmenistan,2008,mcv1,99,113167,112035,1132,eur,mic_nongavi
tkm,Turkmenistan,2008,dtp3,96,113167,108640,4527,eur,mic_nongavi
tkm,Turkmenistan,2008,mcv2,99,94980,94030,950,eur,mic_nongavi
tkm,Turkmenistan,2009,dtp3,96,118312,113580,4732,eur,mic_nongavi
tkm,Turkmenistan,2009,dtp1,98,118312,115946,2366,eur,mic_nongavi
tkm,Turkmenistan,2009,mcv1,99,118312,117129,1183,eur,mic_nongavi
tkm,Turkmenistan,2009,mcv2,99,98333,97350,983,eur,mic_nongavi
tkm,Turkmenistan,2010,mcv1,99,123735,122498,1237,eur,mic_nongavi
tkm,Turkmenistan,2010,dtp3,96,123735,118786,4949,eur,mic_nongavi
tkm,Turkmenistan,2010,dtp1,99,123735,122498,1237,eur,mic_nongavi
tkm,Turkmenistan,2010,mcv2,99,100642,99636,1006,eur,mic_nongavi
tkm,Turkmenistan,2011,mcv1,99,128838,127550,1288,eur,mic_nongavi
tkm,Turkmenistan,2011,dtp1,98,128838,126261,2577,eur,mic_nongavi
tkm,Turkmenistan,2011,dtp3,97,128838,124973,3865,eur,mic_nongavi
tkm,Turkmenistan,2011,mcv2,99,102245,101223,1022,eur,mic_nongavi
tkm,Turkmenistan,2012,dtp1,98,133083,130421,2662,eur,mic_nongavi
tkm,Turkmenistan,2012,mcv1,99,133083,131752,1331,eur,mic_nongavi
tkm,Turkmenistan,2012,dtp3,97,133083,129091,3992,eur,mic_nongavi
tkm,Turkmenistan,2012,mcv2,99,103073,102042,1031,eur,mic_nongavi
tkm,Turkmenistan,2013,dtp1,99,136081,134720,1361,eur,mic_nongavi
tkm,Turkmenistan,2013,dtp3,98,136081,133359,2722,eur,mic_nongavi
tkm,Turkmenistan,2013,mcv1,99,136081,134720,1361,eur,mic_nongavi
tkm,Turkmenistan,2013,mcv2,99,103785,102747,1038,eur,mic_nongavi
tkm,Turkmenistan,2014,dtp3,98,137670,134917,2753,eur,mic_nongavi
tkm,Turkmenistan,2014,dtp1,99,137670,136293,1377,eur,mic_nongavi
tkm,Turkmenistan,2014,mcv1,99,137670,136293,1377,eur,mic_nongavi
tkm,Turkmenistan,2014,mcv2,99,105144,104093,1051,eur,mic_nongavi
tkm,Turkmenistan,2015,dtp1,99,137854,136475,1379,eur,mic_nongavi
tkm,Turkmenistan,2015,mcv1,99,137854,136475,1379,eur,mic_nongavi
tkm,Turkmenistan,2015,dtp3,99,137854,136475,1379,eur,mic_nongavi
tkm,Turkmenistan,2015,mcv2,99,108089,107008,1081,eur,mic_nongavi
tkm,Turkmenistan,2016,dtp1,99,136837,135469,1368,eur,mic_nongavi
tkm,Turkmenistan,2016,dtp3,98,136837,134100,2737,eur,mic_nongavi
tkm,Turkmenistan,2016,mcv1,99,136837,135469,1368,eur,mic_nongavi
tkm,Turkmenistan,2016,mcv2,99,113060,111929,1131,eur,mic_nongavi
tls,Timor-Leste,2002,dtp3,54,36158,19525,16633,sear,gavi
tls,Timor-Leste,2002,dtp1,68,36158,24587,11571,sear,gavi
tls,Timor-Leste,2002,mcv1,56,36158,20248,15910,sear,gavi
tls,Timor-Leste,2003,dtp3,55,36337,19985,16352,sear,gavi
tls,Timor-Leste,2003,mcv1,55,36337,19985,16352,sear,gavi
tls,Timor-Leste,2003,dtp1,65,36337,23619,12718,sear,gavi
tls,Timor-Leste,2004,dtp3,57,36791,20971,15820,sear,gavi
tls,Timor-Leste,2004,mcv1,55,36791,20235,16556,sear,gavi
tls,Timor-Leste,2004,dtp1,65,36791,23914,12877,sear,gavi
tls,Timor-Leste,2005,dtp3,55,37479,20613,16866,sear,gavi
tls,Timor-Leste,2005,dtp1,64,37479,23987,13492,sear,gavi
tls,Timor-Leste,2005,mcv1,48,37479,17990,19489,sear,gavi
tls,Timor-Leste,2006,mcv1,61,38303,23365,14938,sear,gavi
tls,Timor-Leste,2006,dtp1,71,38303,27195,11108,sear,gavi
tls,Timor-Leste,2006,dtp3,63,38303,24131,14172,sear,gavi
tls,Timor-Leste,2007,dtp3,70,39120,27384,11736,sear,gavi
tls,Timor-Leste,2007,dtp1,76,39120,29731,9389,sear,gavi
tls,Timor-Leste,2007,mcv1,63,39120,24646,14474,sear,gavi
tls,Timor-Leste,2008,dtp3,79,39826,31463,8363,sear,gavi
tls,Timor-Leste,2008,dtp1,85,39826,33852,5974,sear,gavi
tls,Timor-Leste,2008,mcv1,73,39826,29073,10753,sear,gavi
tls,Timor-Leste,2009,dtp3,72,40386,29078,11308,sear,gavi
tls,Timor-Leste,2009,dtp1,77,40386,31097,9289,sear,gavi
tls,Timor-Leste,2009,mcv1,70,40386,28270,12116,sear,gavi
tls,Timor-Leste,2010,mcv1,66,40794,26924,13870,sear,gavi
tls,Timor-Leste,2010,dtp3,72,40794,29372,11422,sear,gavi
tls,Timor-Leste,2010,dtp1,76,40794,31003,9791,sear,gavi
tls,Timor-Leste,2011,dtp3,67,41085,27527,13558,sear,gavi
tls,Timor-Leste,2011,mcv1,62,41085,25473,15612,sear,gavi
tls,Timor-Leste,2011,dtp1,70,41085,28759,12326,sear,gavi
tls,Timor-Leste,2012,dtp3,83,41332,34306,7026,sear,gavi
tls,Timor-Leste,2012,mcv1,73,41332,30172,11160,sear,gavi
tls,Timor-Leste,2012,dtp1,84,41332,34719,6613,sear,gavi
tls,Timor-Leste,2013,dtp3,82,41601,34113,7488,sear,gavi
tls,Timor-Leste,2013,dtp1,88,41601,36609,4992,sear,gavi
tls,Timor-Leste,2013,mcv1,70,41601,29121,12480,sear,gavi
tls,Timor-Leste,2014,dtp3,77,41919,32278,9641,sear,gavi
tls,Timor-Leste,2014,dtp1,83,41919,34793,7126,sear,gavi
tls,Timor-Leste,2014,mcv1,74,41919,31020,10899,sear,gavi
tls,Timor-Leste,2015,dtp1,82,42307,34692,7615,sear,gavi
tls,Timor-Leste,2015,dtp3,76,42307,32153,10154,sear,gavi
tls,Timor-Leste,2015,mcv1,70,42307,29615,12692,sear,gavi
tls,Timor-Leste,2016,dtp1,95,42776,40637,2139,sear,gavi
tls,Timor-Leste,2016,mcv1,78,42776,33365,9411,sear,gavi
tls,Timor-Leste,2016,dtp3,85,42776,36360,6416,sear,gavi
tls,Timor-Leste,2016,mcv2,22,41409,9110,32299,sear,gavi
ton,Tonga,2000,dtp1,99,2705,2678,27,wpr,mic_nongavi
ton,Tonga,2000,mcv1,92,2705,2489,216,wpr,mic_nongavi
ton,Tonga,2000,dtp3,91,2705,2462,243,wpr,mic_nongavi
ton,Tonga,2001,mcv1,89,2726,2426,300,wpr,mic_nongavi
ton,Tonga,2001,dtp1,99,2726,2699,27,wpr,mic_nongavi
ton,Tonga,2001,dtp3,89,2726,2426,300,wpr,mic_nongavi
ton,Tonga,2002,dtp1,94,2753,2588,165,wpr,mic_nongavi
ton,Tonga,2002,dtp3,84,2753,2313,440,wpr,mic_nongavi
ton,Tonga,2002,mcv1,85,2753,2340,413,wpr,mic_nongavi
ton,Tonga,2003,dtp3,90,2781,2503,278,wpr,mic_nongavi
ton,Tonga,2003,dtp1,96,2781,2670,111,wpr,mic_nongavi
ton,Tonga,2003,mcv1,93,2781,2586,195,wpr,mic_nongavi
ton,Tonga,2003,mcv2,82,2721,2231,490,wpr,mic_nongavi
ton,Tonga,2004,dtp3,90,2804,2524,280,wpr,mic_nongavi
ton,Tonga,2004,dtp1,95,2804,2664,140,wpr,mic_nongavi
ton,Tonga,2004,mcv1,93,2804,2608,196,wpr,mic_nongavi
ton,Tonga,2004,mcv2,85,2725,2316,409,wpr,mic_nongavi
ton,Tonga,2005,dtp3,89,2821,2511,310,wpr,mic_nongavi
ton,Tonga,2005,dtp1,94,2821,2652,169,wpr,mic_nongavi
ton,Tonga,2005,mcv1,92,2821,2595,226,wpr,mic_nongavi
ton,Tonga,2005,mcv2,84,2734,2297,437,wpr,mic_nongavi
ton,Tonga,2006,mcv1,90,2827,2544,283,wpr,mic_nongavi
ton,Tonga,2006,dtp3,88,2827,2488,339,wpr,mic_nongavi
ton,Tonga,2006,dtp1,92,2827,2601,226,wpr,mic_nongavi
ton,Tonga,2006,mcv2,85,2774,2358,416,wpr,mic_nongavi
ton,Tonga,2007,mcv1,90,2823,2541,282,wpr,mic_nongavi
ton,Tonga,2007,dtp3,87,2823,2456,367,wpr,mic_nongavi
ton,Tonga,2007,dtp1,91,2823,2569,254,wpr,mic_nongavi
ton,Tonga,2007,mcv2,85,2811,2389,422,wpr,mic_nongavi
ton,Tonga,2008,dtp3,86,2809,2416,393,wpr,mic_nongavi
ton,Tonga,2008,mcv1,89,2809,2500,309,wpr,mic_nongavi
ton,Tonga,2008,dtp1,90,2809,2528,281,wpr,mic_nongavi
ton,Tonga,2008,mcv2,84,2759,2318,441,wpr,mic_nongavi
ton,Tonga,2009,dtp3,84,2785,2339,446,wpr,mic_nongavi
ton,Tonga,2009,dtp1,87,2785,2423,362,wpr,mic_nongavi
ton,Tonga,2009,mcv1,87,2785,2423,362,wpr,mic_nongavi
ton,Tonga,2009,mcv2,84,2762,2320,442,wpr,mic_nongavi
ton,Tonga,2010,dtp1,86,2753,2368,385,wpr,mic_nongavi
ton,Tonga,2010,mcv1,86,2753,2368,385,wpr,mic_nongavi
ton,Tonga,2010,dtp3,82,2753,2257,496,wpr,mic_nongavi
ton,Tonga,2010,mcv2,84,2754,2313,441,wpr,mic_nongavi
ton,Tonga,2011,dtp1,86,2715,2335,380,wpr,mic_nongavi
ton,Tonga,2011,dtp3,82,2715,2226,489,wpr,mic_nongavi
ton,Tonga,2011,mcv1,85,2715,2308,407,wpr,mic_nongavi
ton,Tonga,2011,mcv2,85,2748,2336,412,wpr,mic_nongavi
ton,Tonga,2012,dtp3,77,2671,2057,614,wpr,mic_nongavi
ton,Tonga,2012,mcv1,81,2671,2164,507,wpr,mic_nongavi
ton,Tonga,2012,dtp1,81,2671,2164,507,wpr,mic_nongavi
ton,Tonga,2012,mcv2,81,2730,2211,519,wpr,mic_nongavi
ton,Tonga,2013,mcv1,86,2629,2261,368,wpr,mic_nongavi
ton,Tonga,2013,dtp3,82,2629,2156,473,wpr,mic_nongavi
ton,Tonga,2013,dtp1,86,2629,2261,368,wpr,mic_nongavi
ton,Tonga,2013,mcv2,86,2662,2289,373,wpr,mic_nongavi
ton,Tonga,2014,mcv1,85,2590,2202,388,wpr,mic_nongavi
ton,Tonga,2014,dtp3,80,2590,2072,518,wpr,mic_nongavi
ton,Tonga,2014,dtp1,86,2590,2227,363,wpr,mic_nongavi
ton,Tonga,2014,mcv2,78,2626,2048,578,wpr,mic_nongavi
ton,Tonga,2015,mcv1,85,2555,2172,383,wpr,mic_nongavi
ton,Tonga,2015,dtp1,86,2555,2197,358,wpr,mic_nongavi
ton,Tonga,2015,dtp3,78,2555,1993,562,wpr,mic_nongavi
ton,Tonga,2015,mcv2,85,2594,2205,389,wpr,mic_nongavi
ton,Tonga,2016,mcv1,84,2528,2124,404,wpr,mic_nongavi
ton,Tonga,2016,dtp1,83,2528,2098,430,wpr,mic_nongavi
ton,Tonga,2016,dtp3,78,2528,1972,556,wpr,mic_nongavi
ton,Tonga,2016,mcv2,85,2543,2162,381,wpr,mic_nongavi
tto,Trinidad and Tobago,2000,dtp1,90,18173,16356,1817,amr,hic
tto,Trinidad and Tobago,2000,mcv1,90,18173,16356,1817,amr,hic
tto,Trinidad and Tobago,2000,dtp3,90,18173,16356,1817,amr,hic
tto,Trinidad and Tobago,2001,mcv1,91,18254,16611,1643,amr,hic
tto,Trinidad and Tobago,2001,dtp1,91,18254,16611,1643,amr,hic
tto,Trinidad and Tobago,2001,dtp3,91,18254,16611,1643,amr,hic
tto,Trinidad and Tobago,2001,mcv2,80,17889,14311,3578,amr,hic
tto,Trinidad and Tobago,2002,dtp1,98,18421,18053,368,amr,hic
tto,Trinidad and Tobago,2002,mcv1,87,18421,16026,2395,amr,hic
tto,Trinidad and Tobago,2002,dtp3,96,18421,17684,737,amr,hic
tto,Trinidad and Tobago,2002,mcv2,77,17584,13540,4044,amr,hic
tto,Trinidad and Tobago,2003,dtp1,93,18638,17333,1305,amr,hic
tto,Trinidad and Tobago,2003,dtp3,91,18638,16961,1677,amr,hic
tto,Trinidad and Tobago,2003,mcv1,88,18638,16401,2237,amr,hic
tto,Trinidad and Tobago,2003,mcv2,73,17422,12718,4704,amr,hic
tto,Trinidad and Tobago,2004,dtp1,98,18878,18500,378,amr,hic
tto,Trinidad and Tobago,2004,dtp3,94,18878,17745,1133,amr,hic
tto,Trinidad and Tobago,2004,mcv1,95,18878,17934,944,amr,hic
tto,Trinidad and Tobago,2004,mcv2,78,17344,13528,3816,amr,hic
tto,Trinidad and Tobago,2005,dtp1,98,19112,18730,382,amr,hic
tto,Trinidad and Tobago,2005,dtp3,95,19112,18156,956,amr,hic
tto,Trinidad and Tobago,2005,mcv1,93,19112,17774,1338,amr,hic
tto,Trinidad and Tobago,2005,mcv2,84,17278,14514,2764,amr,hic
tto,Trinidad and Tobago,2006,dtp1,93,19322,17969,1353,amr,hic
tto,Trinidad and Tobago,2006,dtp3,92,19322,17776,1546,amr,hic
tto,Trinidad and Tobago,2006,mcv1,89,19322,17197,2125,amr,hic
tto,Trinidad and Tobago,2006,mcv2,78,17605,13732,3873,amr,hic
tto,Trinidad and Tobago,2007,dtp1,90,19497,17547,1950,amr,hic
tto,Trinidad and Tobago,2007,dtp3,88,19497,17157,2340,amr,hic
tto,Trinidad and Tobago,2007,mcv1,91,19497,17742,1755,amr,hic
tto,Trinidad and Tobago,2007,mcv2,87,18058,15710,2348,amr,hic
tto,Trinidad and Tobago,2008,dtp1,91,19626,17860,1766,amr,hic
tto,Trinidad and Tobago,2008,dtp3,90,19626,17663,1963,amr,hic
tto,Trinidad and Tobago,2008,mcv1,91,19626,17860,1766,amr,hic
tto,Trinidad and Tobago,2008,mcv2,81,18530,15009,3521,amr,hic
tto,Trinidad and Tobago,2009,dtp1,95,19692,18707,985,amr,hic
tto,Trinidad and Tobago,2009,dtp3,90,19692,17723,1969,amr,hic
tto,Trinidad and Tobago,2009,mcv1,94,19692,18510,1182,amr,hic
tto,Trinidad and Tobago,2009,mcv2,80,18887,15110,3777,amr,hic
tto,Trinidad and Tobago,2010,dtp1,96,19681,18894,787,amr,hic
tto,Trinidad and Tobago,2010,mcv1,92,19681,18107,1574,amr,hic
tto,Trinidad and Tobago,2010,dtp3,90,19681,17713,1968,amr,hic
tto,Trinidad and Tobago,2010,mcv2,82,18971,15556,3415,amr,hic
tto,Trinidad and Tobago,2011,dtp1,96,19582,18799,783,amr,hic
tto,Trinidad and Tobago,2011,mcv1,92,19582,18015,1567,amr,hic
tto,Trinidad and Tobago,2011,dtp3,90,19582,17624,1958,amr,hic
tto,Trinidad and Tobago,2011,mcv2,83,19220,15953,3267,amr,hic
tto,Trinidad and Tobago,2012,dtp3,92,19404,17852,1552,amr,hic
tto,Trinidad and Tobago,2012,mcv1,85,19404,16493,2911,amr,hic
tto,Trinidad and Tobago,2012,dtp1,97,19404,18822,582,amr,hic
tto,Trinidad and Tobago,2012,mcv2,85,19424,16510,2914,amr,hic
tto,Trinidad and Tobago,2013,dtp3,92,19158,17625,1533,amr,hic
tto,Trinidad and Tobago,2013,mcv1,91,19158,17434,1724,amr,hic
tto,Trinidad and Tobago,2013,dtp1,94,19158,18009,1149,amr,hic
tto,Trinidad and Tobago,2013,mcv2,86,19567,16828,2739,amr,hic
tto,Trinidad and Tobago,2014,mcv1,96,18853,18099,754,amr,hic
tto,Trinidad and Tobago,2014,dtp1,93,18853,17533,1320,amr,hic
tto,Trinidad and Tobago,2014,dtp3,92,18853,17345,1508,amr,hic
tto,Trinidad and Tobago,2014,mcv2,93,19635,18261,1374,amr,hic
tto,Trinidad and Tobago,2015,mcv1,89,18500,16465,2035,amr,hic
tto,Trinidad and Tobago,2015,dtp3,96,18500,17760,740,amr,hic
tto,Trinidad and Tobago,2015,dtp1,98,18500,18130,370,amr,hic
tto,Trinidad and Tobago,2015,mcv2,79,19620,15500,4120,amr,hic
tto,Trinidad and Tobago,2016,mcv1,86,18111,15575,2536,amr,hic
tto,Trinidad and Tobago,2016,dtp3,97,18111,17568,543,amr,hic
tto,Trinidad and Tobago,2016,dtp1,97,18111,17568,543,amr,hic
tto,Trinidad and Tobago,2016,mcv2,65,19500,12675,6825,amr,hic
tun,Tunisia,2000,dtp3,97,163420,158517,4903,emr,mic_nongavi
tun,Tunisia,2000,mcv1,95,163420,155249,8171,emr,mic_nongavi
tun,Tunisia,2000,dtp1,99,163420,161786,1634,emr,mic_nongavi
tun,Tunisia,2000,mcv2,98,184128,180445,3683,emr,mic_nongavi
tun,Tunisia,2001,dtp3,98,161773,158538,3235,emr,mic_nongavi
tun,Tunisia,2001,dtp1,99,161773,160155,1618,emr,mic_nongavi
tun,Tunisia,2001,mcv1,92,161773,148831,12942,emr,mic_nongavi
tun,Tunisia,2001,mcv2,99,178585,176799,1786,emr,mic_nongavi
tun,Tunisia,2002,dtp1,96,160932,154495,6437,emr,mic_nongavi
tun,Tunisia,2002,mcv1,94,160932,151276,9656,emr,mic_nongavi
tun,Tunisia,2002,dtp3,96,160932,154495,6437,emr,mic_nongavi
tun,Tunisia,2002,mcv2,98,173709,170235,3474,emr,mic_nongavi
tun,Tunisia,2003,mcv1,90,160963,144867,16096,emr,mic_nongavi
tun,Tunisia,2003,dtp1,96,160963,154524,6439,emr,mic_nongavi
tun,Tunisia,2003,dtp3,95,160963,152915,8048,emr,mic_nongavi
tun,Tunisia,2003,mcv2,99,169444,167750,1694,emr,mic_nongavi
tun,Tunisia,2004,mcv1,95,161928,153832,8096,emr,mic_nongavi
tun,Tunisia,2004,dtp1,97,161928,157070,4858,emr,mic_nongavi
tun,Tunisia,2004,dtp3,97,161928,157070,4858,emr,mic_nongavi
tun,Tunisia,2004,mcv2,99,165724,164067,1657,emr,mic_nongavi
tun,Tunisia,2005,dtp1,98,164043,160762,3281,emr,mic_nongavi
tun,Tunisia,2005,dtp3,98,164043,160762,3281,emr,mic_nongavi
tun,Tunisia,2005,mcv1,96,164043,157481,6562,emr,mic_nongavi
tun,Tunisia,2005,mcv2,99,162327,160704,1623,emr,mic_nongavi
tun,Tunisia,2006,mcv1,98,167538,164187,3351,emr,mic_nongavi
tun,Tunisia,2006,dtp1,99,167538,165863,1675,emr,mic_nongavi
tun,Tunisia,2006,dtp3,99,167538,165863,1675,emr,mic_nongavi
tun,Tunisia,2006,mcv2,98,159743,156548,3195,emr,mic_nongavi
tun,Tunisia,2007,dtp3,98,172328,168881,3447,emr,mic_nongavi
tun,Tunisia,2007,mcv1,98,172328,168881,3447,emr,mic_nongavi
tun,Tunisia,2007,dtp1,99,172328,170605,1723,emr,mic_nongavi
tun,Tunisia,2007,mcv2,98,158246,155081,3165,emr,mic_nongavi
tun,Tunisia,2008,dtp3,99,178131,176350,1781,emr,mic_nongavi
tun,Tunisia,2008,dtp1,99,178131,176350,1781,emr,mic_nongavi
tun,Tunisia,2008,mcv1,98,178131,174568,3563,emr,mic_nongavi
tun,Tunisia,2008,mcv2,99,157678,156101,1577,emr,mic_nongavi
tun,Tunisia,2009,dtp1,99,184567,182721,1846,emr,mic_nongavi
tun,Tunisia,2009,mcv1,98,184567,180876,3691,emr,mic_nongavi
tun,Tunisia,2009,dtp3,99,184567,182721,1846,emr,mic_nongavi
tun,Tunisia,2009,mcv2,97,157877,153141,4736,emr,mic_nongavi
tun,Tunisia,2010,dtp1,98,191046,187225,3821,emr,mic_nongavi
tun,Tunisia,2010,mcv1,97,191046,185315,5731,emr,mic_nongavi
tun,Tunisia,2010,dtp3,98,191046,187225,3821,emr,mic_nongavi
tun,Tunisia,2010,mcv2,98,158616,155444,3172,emr,mic_nongavi
tun,Tunisia,2011,mcv1,96,196912,189036,7876,emr,mic_nongavi
tun,Tunisia,2011,dtp1,98,196912,192974,3938,emr,mic_nongavi
tun,Tunisia,2011,dtp3,98,196912,192974,3938,emr,mic_nongavi
tun,Tunisia,2011,mcv2,96,160407,153991,6416,emr,mic_nongavi
tun,Tunisia,2012,dtp3,97,201653,195603,6050,emr,mic_nongavi
tun,Tunisia,2012,dtp1,99,201653,199636,2017,emr,mic_nongavi
tun,Tunisia,2012,mcv1,96,201653,193587,8066,emr,mic_nongavi
tun,Tunisia,2012,mcv2,96,163015,156494,6521,emr,mic_nongavi
tun,Tunisia,2013,dtp3,98,204905,200807,4098,emr,mic_nongavi
tun,Tunisia,2013,dtp1,99,204905,202856,2049,emr,mic_nongavi
tun,Tunisia,2013,mcv1,94,204905,192611,12294,emr,mic_nongavi
tun,Tunisia,2013,mcv2,98,166398,163070,3328,emr,mic_nongavi
tun,Tunisia,2014,dtp3,98,206487,202357,4130,emr,mic_nongavi
tun,Tunisia,2014,mcv1,98,206487,202357,4130,emr,mic_nongavi
tun,Tunisia,2014,dtp1,98,206487,202357,4130,emr,mic_nongavi
tun,Tunisia,2014,mcv2,95,170598,162068,8530,emr,mic_nongavi
tun,Tunisia,2015,mcv1,98,206404,202276,4128,emr,mic_nongavi
tun,Tunisia,2015,dtp3,98,206404,202276,4128,emr,mic_nongavi
tun,Tunisia,2015,dtp1,98,206404,202276,4128,emr,mic_nongavi
tun,Tunisia,2015,mcv2,98,175570,172059,3511,emr,mic_nongavi
tun,Tunisia,2016,dtp3,98,204878,200780,4098,emr,mic_nongavi
tun,Tunisia,2016,dtp1,99,204878,202829,2049,emr,mic_nongavi
tun,Tunisia,2016,mcv1,96,204878,196683,8195,emr,mic_nongavi
tun,Tunisia,2016,mcv2,97,181884,176427,5457,emr,mic_nongavi
tur,Turkey,2000,dtp3,85,1329108,1129742,199366,eur,mic_nongavi
tur,Turkey,2000,mcv1,87,1329108,1156324,172784,eur,mic_nongavi
tur,Turkey,2000,dtp1,92,1329108,1222779,106329,eur,mic_nongavi
tur,Turkey,2001,dtp3,88,1323662,1164823,158839,eur,mic_nongavi
tur,Turkey,2001,mcv1,91,1323662,1204532,119130,eur,mic_nongavi
tur,Turkey,2001,dtp1,95,1323662,1257479,66183,eur,mic_nongavi
tur,Turkey,2001,mcv2,91,1277992,1162973,115019,eur,mic_nongavi
tur,Turkey,2002,mcv1,83,1316971,1093086,223885,eur,mic_nongavi
tur,Turkey,2002,dtp1,82,1316971,1079916,237055,eur,mic_nongavi
tur,Turkey,2002,dtp3,78,1316971,1027237,289734,eur,mic_nongavi
tur,Turkey,2002,mcv2,83,1291438,1071894,219544,eur,mic_nongavi
tur,Turkey,2003,dtp1,76,1310115,995687,314428,eur,mic_nongavi
tur,Turkey,2003,mcv1,75,1310115,982586,327529,eur,mic_nongavi
tur,Turkey,2003,dtp3,68,1310115,890878,419237,eur,mic_nongavi
tur,Turkey,2003,mcv2,97,1307148,1267934,39214,eur,mic_nongavi
tur,Turkey,2004,dtp1,86,1303646,1121136,182510,eur,mic_nongavi
tur,Turkey,2004,mcv1,81,1303646,1055953,247693,eur,mic_nongavi
tur,Turkey,2004,dtp3,85,1303646,1108099,195547,eur,mic_nongavi
tur,Turkey,2004,mcv2,97,1320978,1281349,39629,eur,mic_nongavi
tur,Turkey,2005,dtp1,92,1298100,1194252,103848,eur,mic_nongavi
tur,Turkey,2005,dtp3,90,1298100,1168290,129810,eur,mic_nongavi
tur,Turkey,2005,mcv1,91,1298100,1181271,116829,eur,mic_nongavi
tur,Turkey,2005,mcv2,98,1327789,1301233,26556,eur,mic_nongavi
tur,Turkey,2006,dtp3,90,1293832,1164449,129383,eur,mic_nongavi
tur,Turkey,2006,mcv1,98,1293832,1267955,25877,eur,mic_nongavi
tur,Turkey,2006,dtp1,92,1293832,1190325,103507,eur,mic_nongavi
tur,Turkey,2006,mcv2,84,1328498,1115938,212560,eur,mic_nongavi
tur,Turkey,2007,dtp3,96,1290715,1239086,51629,eur,mic_nongavi
tur,Turkey,2007,mcv1,96,1290715,1239086,51629,eur,mic_nongavi
tur,Turkey,2007,dtp1,98,1290715,1264901,25814,eur,mic_nongavi
tur,Turkey,2007,mcv2,94,1321549,1242256,79293,eur,mic_nongavi
tur,Turkey,2008,dtp3,96,1288548,1237006,51542,eur,mic_nongavi
tur,Turkey,2008,dtp1,97,1288548,1249892,38656,eur,mic_nongavi
tur,Turkey,2008,mcv1,97,1288548,1249892,38656,eur,mic_nongavi
tur,Turkey,2008,mcv2,92,1310505,1205665,104840,eur,mic_nongavi
tur,Turkey,2009,dtp1,97,1287216,1248600,38616,eur,mic_nongavi
tur,Turkey,2009,mcv1,97,1287216,1248600,38616,eur,mic_nongavi
tur,Turkey,2009,dtp3,96,1287216,1235727,51489,eur,mic_nongavi
tur,Turkey,2009,mcv2,88,1299036,1143152,155884,eur,mic_nongavi
tur,Turkey,2010,dtp1,98,1286496,1260766,25730,eur,mic_nongavi
tur,Turkey,2010,mcv1,97,1286496,1247901,38595,eur,mic_nongavi
tur,Turkey,2010,dtp3,97,1286496,1247901,38595,eur,mic_nongavi
tur,Turkey,2010,mcv2,91,1291736,1175480,116256,eur,mic_nongavi
tur,Turkey,2011,mcv1,98,1286068,1260347,25721,eur,mic_nongavi
tur,Turkey,2011,dtp1,98,1286068,1260347,25721,eur,mic_nongavi
tur,Turkey,2011,dtp3,97,1286068,1247486,38582,eur,mic_nongavi
tur,Turkey,2011,mcv2,86,1293689,1112573,181116,eur,mic_nongavi
tur,Turkey,2012,dtp3,97,1285513,1246948,38565,eur,mic_nongavi
tur,Turkey,2012,dtp1,97,1285513,1246948,38565,eur,mic_nongavi
tur,Turkey,2012,mcv1,96,1285513,1234092,51421,eur,mic_nongavi
tur,Turkey,2012,mcv2,85,1298163,1103439,194724,eur,mic_nongavi
tur,Turkey,2013,dtp3,98,1284444,1258755,25689,eur,mic_nongavi
tur,Turkey,2013,dtp1,99,1284444,1271600,12844,eur,mic_nongavi
tur,Turkey,2013,mcv1,98,1284444,1258755,25689,eur,mic_nongavi
tur,Turkey,2013,mcv2,98,1304780,1278684,26096,eur,mic_nongavi
tur,Turkey,2014,dtp3,96,1282604,1231300,51304,eur,mic_nongavi
tur,Turkey,2014,mcv1,94,1282604,1205648,76956,eur,mic_nongavi
tur,Turkey,2014,dtp1,97,1282604,1244126,38478,eur,mic_nongavi
tur,Turkey,2014,mcv2,88,1313209,1155624,157585,eur,mic_nongavi
tur,Turkey,2015,dtp3,97,1279800,1241406,38394,eur,mic_nongavi
tur,Turkey,2015,mcv1,97,1279800,1241406,38394,eur,mic_nongavi
tur,Turkey,2015,dtp1,98,1279800,1254204,25596,eur,mic_nongavi
tur,Turkey,2015,mcv2,86,1322952,1137739,185213,eur,mic_nongavi
tur,Turkey,2016,dtp3,98,1275959,1250440,25519,eur,mic_nongavi
tur,Turkey,2016,dtp1,99,1275959,1263199,12760,eur,mic_nongavi
tur,Turkey,2016,mcv1,98,1275959,1250440,25519,eur,mic_nongavi
tur,Turkey,2016,mcv2,85,1333160,1133186,199974,eur,mic_nongavi
tuv,Tuvalu,2000,dtp1,93,239.9445179005,223,16.9445179005,wpr,mic_nongavi
tuv,Tuvalu,2000,dtp3,82,239.9445179005,197,42.9445179005,wpr,mic_nongavi
tuv,Tuvalu,2000,mcv1,81,239.9445179005,194,45.9445179005,wpr,mic_nongavi
tuv,Tuvalu,2001,dtp1,99,238.3694564777,236,2.3694564777,wpr,mic_nongavi
tuv,Tuvalu,2001,dtp3,96,238.3694564777,229,9.3694564777,wpr,mic_nongavi
tuv,Tuvalu,2001,mcv1,99,238.3694564777,236,2.3694564777,wpr,mic_nongavi
tuv,Tuvalu,2001,mcv2,99,238.3694564777,236,2.3694564777,wpr,mic_nongavi
tuv,Tuvalu,2002,dtp3,98,237.7902815276,233,4.7902815276,wpr,mic_nongavi
tuv,Tuvalu,2002,mcv1,99,237.7902815276,235,2.7902815276,wpr,mic_nongavi
tuv,Tuvalu,2002,dtp1,99,237.7902815276,235,2.7902815276,wpr,mic_nongavi
tuv,Tuvalu,2002,mcv2,97,237.7902815276,231,6.7902815276,wpr,mic_nongavi
tuv,Tuvalu,2003,dtp1,99,237.6088640536,235,2.6088640536,wpr,mic_nongavi
tuv,Tuvalu,2003,dtp3,93,237.6088640536,221,16.6088640536,wpr,mic_nongavi
tuv,Tuvalu,2003,mcv1,95,237.6088640536,226,11.6088640536,wpr,mic_nongavi
tuv,Tuvalu,2003,mcv2,93,237.6088640536,221,16.6088640536,wpr,mic_nongavi
tuv,Tuvalu,2004,dtp3,98,237.4750489281,233,4.4750489281,wpr,mic_nongavi
tuv,Tuvalu,2004,dtp1,99,237.4750489281,235,2.4750489281,wpr,mic_nongavi
tuv,Tuvalu,2004,mcv1,97,237.4750489281,230,7.4750489281,wpr,mic_nongavi
tuv,Tuvalu,2004,mcv2,90,237.4750489281,214,23.4750489281,wpr,mic_nongavi
tuv,Tuvalu,2005,dtp1,99,237.6741433504,235,2.6741433504,wpr,mic_nongavi
tuv,Tuvalu,2005,dtp3,93,237.6741433504,221,16.6741433504,wpr,mic_nongavi
tuv,Tuvalu,2005,mcv1,62,237.6741433504,147,90.6741433504,wpr,mic_nongavi
tuv,Tuvalu,2005,mcv2,86,237.6741433504,204,33.6741433504,wpr,mic_nongavi
tuv,Tuvalu,2006,mcv1,84,237.2310461974,199,38.2310461974,wpr,mic_nongavi
tuv,Tuvalu,2006,dtp3,97,237.2310461974,230,7.2310461974,wpr,mic_nongavi
tuv,Tuvalu,2006,dtp1,99,237.2310461974,235,2.2310461974,wpr,mic_nongavi
tuv,Tuvalu,2006,mcv2,83,237.2310461974,197,40.2310461974,wpr,mic_nongavi
tuv,Tuvalu,2007,dtp3,97,236.652772335,230,6.652772335,wpr,mic_nongavi
tuv,Tuvalu,2007,dtp1,99,236.652772335,234,2.652772335,wpr,mic_nongavi
tuv,Tuvalu,2007,mcv1,95,236.652772335,225,11.652772335,wpr,mic_nongavi
tuv,Tuvalu,2007,mcv2,74,236.652772335,175,61.652772335,wpr,mic_nongavi
tuv,Tuvalu,2008,dtp1,99,235.6453963144,233,2.6453963144,wpr,mic_nongavi
tuv,Tuvalu,2008,dtp3,99,235.6453963144,233,2.6453963144,wpr,mic_nongavi
tuv,Tuvalu,2008,mcv1,93,235.6453963144,219,16.6453963144,wpr,mic_nongavi
tuv,Tuvalu,2008,mcv2,82,235.6453963144,193,42.6453963144,wpr,mic_nongavi
tuv,Tuvalu,2009,dtp3,88,234.4682602828,206,28.4682602828,wpr,mic_nongavi
tuv,Tuvalu,2009,mcv1,90,234.4682602828,211,23.4682602828,wpr,mic_nongavi
tuv,Tuvalu,2009,dtp1,97,234.4682602828,227,7.4682602828,wpr,mic_nongavi
tuv,Tuvalu,2009,mcv2,84,234.4682602828,197,37.4682602828,wpr,mic_nongavi
tuv,Tuvalu,2010,mcv1,85,232.7381893919,198,34.7381893919,wpr,mic_nongavi
tuv,Tuvalu,2010,dtp3,89,232.7381893919,207,25.7381893919,wpr,mic_nongavi
tuv,Tuvalu,2010,dtp1,99,232.7381893919,230,2.7381893919,wpr,mic_nongavi
tuv,Tuvalu,2010,mcv2,87,232.7381893919,202,30.7381893919,wpr,mic_nongavi
tuv,Tuvalu,2011,dtp1,99,231.0159610778,229,2.0159610778,wpr,mic_nongavi
tuv,Tuvalu,2011,mcv1,98,231.0159610778,226,5.0159610778,wpr,mic_nongavi
tuv,Tuvalu,2011,dtp3,96,231.0159610778,222,9.0159610778,wpr,mic_nongavi
tuv,Tuvalu,2011,mcv2,90,231.0159610778,208,23.0159610778,wpr,mic_nongavi
tuv,Tuvalu,2012,dtp3,97,229.2494194742,222,7.2494194742,wpr,mic_nongavi
tuv,Tuvalu,2012,mcv1,98,229.2494194742,225,4.2494194742,wpr,mic_nongavi
tuv,Tuvalu,2012,dtp1,99,229.2494194742,227,2.2494194742,wpr,mic_nongavi
tuv,Tuvalu,2012,mcv2,93,229.2494194742,213,16.2494194742,wpr,mic_nongavi
tuv,Tuvalu,2013,dtp3,90,227.4860592909,205,22.4860592909,wpr,mic_nongavi
tuv,Tuvalu,2013,mcv1,96,227.4860592909,218,9.4860592909,wpr,mic_nongavi
tuv,Tuvalu,2013,dtp1,99,227.4860592909,225,2.4860592909,wpr,mic_nongavi
tuv,Tuvalu,2013,mcv2,84,227.4860592909,191,36.4860592909,wpr,mic_nongavi
tuv,Tuvalu,2014,mcv1,94,225.7381239823,212,13.7381239823,wpr,mic_nongavi
tuv,Tuvalu,2014,dtp1,99,225.7381239823,223,2.7381239823,wpr,mic_nongavi
tuv,Tuvalu,2014,dtp3,89,225.7381239823,201,24.7381239823,wpr,mic_nongavi
tuv,Tuvalu,2014,mcv2,91,225.7381239823,205,20.7381239823,wpr,mic_nongavi
tuv,Tuvalu,2015,mcv1,94,224.2672355281,211,13.2672355281,wpr,mic_nongavi
tuv,Tuvalu,2015,dtp1,99,224.2672355281,222,2.2672355281,wpr,mic_nongavi
tuv,Tuvalu,2015,dtp3,96,224.2672355281,215,9.2672355281,wpr,mic_nongavi
tuv,Tuvalu,2015,mcv2,86,224.2672355281,193,31.2672355281,wpr,mic_nongavi
tuv,Tuvalu,2016,dtp3,94,223.0354122285,210,13.0354122285,wpr,mic_nongavi
tuv,Tuvalu,2016,dtp1,99,223.0354122285,221,2.0354122285,wpr,mic_nongavi
tuv,Tuvalu,2016,mcv1,96,223.0354122285,214,9.0354122285,wpr,mic_nongavi
tuv,Tuvalu,2016,mcv2,92,NA,NA,#VALUE!,wpr,mic_nongavi
tza,United Republic of Tanzania,2000,dtp3,79,1330292,1050931,279361,afr,gavi
tza,United Republic of Tanzania,2000,mcv1,78,1330292,1037628,292664,afr,gavi
tza,United Republic of Tanzania,2000,dtp1,92,1330292,1223869,106423,afr,gavi
tza,United Republic of Tanzania,2001,dtp1,95,1375709,1306924,68785,afr,gavi
tza,United Republic of Tanzania,2001,mcv1,86,1375709,1183110,192599,afr,gavi
tza,United Republic of Tanzania,2001,dtp3,87,1375709,1196867,178842,afr,gavi
tza,United Republic of Tanzania,2002,dtp3,89,1423946,1267312,156634,afr,gavi
tza,United Republic of Tanzania,2002,dtp1,96,1423946,1366988,56958,afr,gavi
tza,United Republic of Tanzania,2002,mcv1,89,1423946,1267312,156634,afr,gavi
tza,United Republic of Tanzania,2003,dtp1,99,1474258,1459515,14743,afr,gavi
tza,United Republic of Tanzania,2003,dtp3,95,1474258,1400545,73713,afr,gavi
tza,United Republic of Tanzania,2003,mcv1,97,1474258,1430030,44228,afr,gavi
tza,United Republic of Tanzania,2004,dtp1,99,1525838,1510580,15258,afr,gavi
tza,United Republic of Tanzania,2004,dtp3,95,1525838,1449546,76292,afr,gavi
tza,United Republic of Tanzania,2004,mcv1,94,1525838,1434288,91550,afr,gavi
tza,United Republic of Tanzania,2005,dtp1,95,1577524,1498648,78876,afr,gavi
tza,United Republic of Tanzania,2005,mcv1,91,1577524,1435547,141977,afr,gavi
tza,United Republic of Tanzania,2005,dtp3,90,1577524,1419772,157752,afr,gavi
tza,United Republic of Tanzania,2006,dtp3,90,1628099,1465289,162810,afr,gavi
tza,United Republic of Tanzania,2006,dtp1,94,1628099,1530413,97686,afr,gavi
tza,United Republic of Tanzania,2006,mcv1,93,1628099,1514132,113967,afr,gavi
tza,United Republic of Tanzania,2007,dtp3,83,1676769,1391718,285051,afr,gavi
tza,United Republic of Tanzania,2007,mcv1,90,1676769,1509092,167677,afr,gavi
tza,United Republic of Tanzania,2007,dtp1,89,1676769,1492324,184445,afr,gavi
tza,United Republic of Tanzania,2008,mcv1,88,1723025,1516262,206763,afr,gavi
tza,United Republic of Tanzania,2008,dtp1,88,1723025,1516262,206763,afr,gavi
tza,United Republic of Tanzania,2008,dtp3,86,1723025,1481801,241224,afr,gavi
tza,United Republic of Tanzania,2009,dtp1,90,1766641,1589977,176664,afr,gavi
tza,United Republic of Tanzania,2009,mcv1,91,1766641,1607643,158998,afr,gavi
tza,United Republic of Tanzania,2009,dtp3,85,1766641,1501645,264996,afr,gavi
tza,United Republic of Tanzania,2010,dtp1,98,1807723,1771569,36154,afr,gavi
tza,United Republic of Tanzania,2010,dtp3,91,1807723,1645028,162695,afr,gavi
tza,United Republic of Tanzania,2010,mcv1,92,1807723,1663105,144618,afr,gavi
tza,United Republic of Tanzania,2011,dtp1,96,1846769,1772898,73871,afr,gavi
tza,United Republic of Tanzania,2011,mcv1,93,1846769,1717495,129274,afr,gavi
tza,United Republic of Tanzania,2011,dtp3,90,1846769,1662092,184677,afr,gavi
tza,United Republic of Tanzania,2012,dtp1,99,1884822,1865974,18848,afr,gavi
tza,United Republic of Tanzania,2012,dtp3,92,1884822,1734036,150786,afr,gavi
tza,United Republic of Tanzania,2012,mcv1,97,1884822,1828277,56545,afr,gavi
tza,United Republic of Tanzania,2013,dtp3,91,1922836,1749781,173055,afr,gavi
tza,United Republic of Tanzania,2013,dtp1,99,1922836,1903608,19228,afr,gavi
tza,United Republic of Tanzania,2013,mcv1,99,1922836,1903608,19228,afr,gavi
tza,United Republic of Tanzania,2014,dtp3,97,1961347,1902507,58840,afr,gavi
tza,United Republic of Tanzania,2014,mcv1,99,1961347,1941734,19613,afr,gavi
tza,United Republic of Tanzania,2014,dtp1,99,1961347,1941734,19613,afr,gavi
tza,United Republic of Tanzania,2014,mcv2,29,1836308,532529,1303779,afr,gavi
tza,United Republic of Tanzania,2015,dtp3,98,2000755,1960740,40015,afr,gavi
tza,United Republic of Tanzania,2015,dtp1,99,2000755,1980747,20008,afr,gavi
tza,United Republic of Tanzania,2015,mcv1,99,2000755,1980747,20008,afr,gavi
tza,United Republic of Tanzania,2015,mcv2,57,1882148,1072824,809324,afr,gavi
tza,United Republic of Tanzania,2016,dtp3,97,2041235,1979998,61237,afr,gavi
tza,United Republic of Tanzania,2016,dtp1,99,2041235,2020823,20412,afr,gavi
tza,United Republic of Tanzania,2016,mcv1,90,2041235,1837111,204124,afr,gavi
tza,United Republic of Tanzania,2016,mcv2,71,1932190,1371855,560335,afr,gavi
uga,Uganda,2000,dtp3,52,1079229,561199,518030,afr,gavi
uga,Uganda,2000,mcv1,57,1079229,615161,464068,afr,gavi
uga,Uganda,2000,dtp1,80,1079229,863383,215846,afr,gavi
uga,Uganda,2001,dtp1,82,1114712,914064,200648,afr,gavi
uga,Uganda,2001,mcv1,59,1114712,657680,457032,afr,gavi
uga,Uganda,2001,dtp3,55,1114712,613092,501620,afr,gavi
uga,Uganda,2002,dtp3,57,1150847,655983,494864,afr,gavi
uga,Uganda,2002,dtp1,84,1150847,966711,184136,afr,gavi
uga,Uganda,2002,mcv1,62,1150847,713525,437322,afr,gavi
uga,Uganda,2003,dtp1,86,1187272,1021054,166218,afr,gavi
uga,Uganda,2003,dtp3,59,1187272,700490,486782,afr,gavi
uga,Uganda,2003,mcv1,64,1187272,759854,427418,afr,gavi
uga,Uganda,2004,dtp1,88,1223757,1076906,146851,afr,gavi
uga,Uganda,2004,dtp3,62,1223757,758729,465028,afr,gavi
uga,Uganda,2004,mcv1,66,1223757,807680,416077,afr,gavi
uga,Uganda,2005,dtp1,90,1260093,1134084,126009,afr,gavi
uga,Uganda,2005,mcv1,68,1260093,856863,403230,afr,gavi
uga,Uganda,2005,dtp3,64,1260093,806460,453633,afr,gavi
uga,Uganda,2006,dtp3,64,1296145,829533,466612,afr,gavi
uga,Uganda,2006,dtp1,85,1296145,1101723,194422,afr,gavi
uga,Uganda,2006,mcv1,75,1296145,972109,324036,afr,gavi
uga,Uganda,2007,dtp3,73,1331950,972324,359626,afr,gavi
uga,Uganda,2007,mcv1,75,1331950,998962,332988,afr,gavi
uga,Uganda,2007,dtp1,93,1331950,1238714,93236,afr,gavi
uga,Uganda,2008,mcv1,70,1367567,957297,410270,afr,gavi
uga,Uganda,2008,dtp1,87,1367567,1189783,177784,afr,gavi
uga,Uganda,2008,dtp3,71,1367567,970973,396594,afr,gavi
uga,Uganda,2009,dtp1,96,1403009,1346889,56120,afr,gavi
uga,Uganda,2009,mcv1,77,1403009,1080317,322692,afr,gavi
uga,Uganda,2009,dtp3,79,1403009,1108377,294632,afr,gavi
uga,Uganda,2010,dtp1,87,1438326,1251344,186982,afr,gavi
uga,Uganda,2010,dtp3,80,1438326,1150661,287665,afr,gavi
uga,Uganda,2010,mcv1,73,1438326,1049978,388348,afr,gavi
uga,Uganda,2011,dtp1,91,1473608,1340983,132625,afr,gavi
uga,Uganda,2011,mcv1,75,1473608,1105206,368402,afr,gavi
uga,Uganda,2011,dtp3,82,1473608,1208359,265249,afr,gavi
uga,Uganda,2012,dtp1,89,1508994,1343005,165989,afr,gavi
uga,Uganda,2012,dtp3,78,1508994,1177015,331979,afr,gavi
uga,Uganda,2012,mcv1,82,1508994,1237375,271619,afr,gavi
uga,Uganda,2013,dtp3,78,1544612,1204797,339815,afr,gavi
uga,Uganda,2013,dtp1,89,1544612,1374705,169907,afr,gavi
uga,Uganda,2013,mcv1,82,1544612,1266582,278030,afr,gavi
uga,Uganda,2014,dtp3,78,1580541,1232822,347719,afr,gavi
uga,Uganda,2014,mcv1,82,1580541,1296044,284497,afr,gavi
uga,Uganda,2014,dtp1,89,1580541,1406681,173860,afr,gavi
uga,Uganda,2015,dtp1,89,1616871,1439015,177856,afr,gavi
uga,Uganda,2015,dtp3,78,1616871,1261159,355712,afr,gavi
uga,Uganda,2015,mcv1,82,1616871,1325834,291037,afr,gavi
uga,Uganda,2016,dtp1,89,1653663,1471760,181903,afr,gavi
uga,Uganda,2016,mcv1,82,1653663,1356004,297659,afr,gavi
uga,Uganda,2016,dtp3,78,1653663,1289857,363806,afr,gavi
ukr,Ukraine,2000,mcv1,99,397174,393202,3972,eur,gavi
ukr,Ukraine,2000,dtp1,99,397174,393202,3972,eur,gavi
ukr,Ukraine,2000,dtp3,99,397174,393202,3972,eur,gavi
ukr,Ukraine,2000,mcv2,99,547641,542165,5476,eur,gavi
ukr,Ukraine,2001,mcv1,99,394273,390330,3943,eur,gavi
ukr,Ukraine,2001,dtp3,99,394273,390330,3943,eur,gavi
ukr,Ukraine,2001,dtp1,99,394273,390330,3943,eur,gavi
ukr,Ukraine,2001,mcv2,98,489954,480155,9799,eur,gavi
ukr,Ukraine,2002,dtp3,99,397294,393321,3973,eur,gavi
ukr,Ukraine,2002,dtp1,99,397294,393321,3973,eur,gavi
ukr,Ukraine,2002,mcv1,99,397294,393321,3973,eur,gavi
ukr,Ukraine,2002,mcv2,98,465478,456168,9310,eur,gavi
ukr,Ukraine,2003,dtp1,99,405339,401286,4053,eur,gavi
ukr,Ukraine,2003,mcv1,99,405339,401286,4053,eur,gavi
ukr,Ukraine,2003,dtp3,97,405339,393179,12160,eur,gavi
ukr,Ukraine,2003,mcv2,99,444553,440107,4446,eur,gavi
ukr,Ukraine,2004,dtp1,99,417369,413195,4174,eur,gavi
ukr,Ukraine,2004,dtp3,99,417369,413195,4174,eur,gavi
ukr,Ukraine,2004,mcv1,99,417369,413195,4174,eur,gavi
ukr,Ukraine,2004,mcv2,97,426995,414185,12810,eur,gavi
ukr,Ukraine,2005,dtp3,96,431854,414580,17274,eur,gavi
ukr,Ukraine,2005,dtp1,99,431854,427535,4319,eur,gavi
ukr,Ukraine,2005,mcv1,96,431854,414580,17274,eur,gavi
ukr,Ukraine,2005,mcv2,96,412237,395748,16489,eur,gavi
ukr,Ukraine,2006,dtp1,99,447063,442592,4471,eur,gavi
ukr,Ukraine,2006,mcv1,98,447063,438122,8941,eur,gavi
ukr,Ukraine,2006,dtp3,98,447063,438122,8941,eur,gavi
ukr,Ukraine,2006,mcv2,98,399488,391498,7990,eur,gavi
ukr,Ukraine,2007,mcv1,97,461348,447508,13840,eur,gavi
ukr,Ukraine,2007,dtp3,98,461348,452121,9227,eur,gavi
ukr,Ukraine,2007,dtp1,99,461348,456735,4613,eur,gavi
ukr,Ukraine,2007,mcv2,96,390956,375318,15638,eur,gavi
ukr,Ukraine,2008,dtp1,90,473316,425984,47332,eur,gavi
ukr,Ukraine,2008,mcv1,94,473316,444917,28399,eur,gavi
ukr,Ukraine,2008,dtp3,90,473316,425984,47332,eur,gavi
ukr,Ukraine,2008,mcv2,95,386902,367557,19345,eur,gavi
ukr,Ukraine,2009,mcv1,75,482047,361535,120512,eur,gavi
ukr,Ukraine,2009,dtp3,71,482047,342253,139794,eur,gavi
ukr,Ukraine,2009,dtp1,71,482047,342253,139794,eur,gavi
ukr,Ukraine,2009,mcv2,68,387585,263558,124027,eur,gavi
ukr,Ukraine,2010,dtp3,52,487051,253267,233784,eur,gavi
ukr,Ukraine,2010,dtp1,52,487051,253267,233784,eur,gavi
ukr,Ukraine,2010,mcv1,56,487051,272749,214302,eur,gavi
ukr,Ukraine,2010,mcv2,41,393065,161157,231908,eur,gavi
ukr,Ukraine,2011,mcv1,67,488464,327271,161193,eur,gavi
ukr,Ukraine,2011,dtp3,50,488464,244232,244232,eur,gavi
ukr,Ukraine,2011,dtp1,50,488464,244232,244232,eur,gavi
ukr,Ukraine,2011,mcv2,56,406346,227554,178792,eur,gavi
ukr,Ukraine,2012,dtp1,76,487327,370369,116958,eur,gavi
ukr,Ukraine,2012,mcv1,79,487327,384988,102339,eur,gavi
ukr,Ukraine,2012,dtp3,76,487327,370369,116958,eur,gavi
ukr,Ukraine,2012,mcv2,54,427383,230787,196596,eur,gavi
ukr,Ukraine,2013,dtp1,76,484564,368269,116295,eur,gavi
ukr,Ukraine,2013,dtp3,76,484564,368269,116295,eur,gavi
ukr,Ukraine,2013,mcv1,79,484564,382806,101758,eur,gavi
ukr,Ukraine,2013,mcv2,54,451913,244033,207880,eur,gavi
ukr,Ukraine,2014,dtp3,23,480513,110518,369995,eur,gavi
ukr,Ukraine,2014,dtp1,59,480513,283503,197010,eur,gavi
ukr,Ukraine,2014,mcv1,56,480513,269087,211426,eur,gavi
ukr,Ukraine,2014,mcv2,57,475571,271075,204496,eur,gavi
ukr,Ukraine,2015,dtp1,59,475442,280511,194931,eur,gavi
ukr,Ukraine,2015,mcv1,56,475442,266248,209194,eur,gavi
ukr,Ukraine,2015,dtp3,23,475442,109352,366090,eur,gavi
ukr,Ukraine,2015,mcv2,57,492373,280653,211720,eur,gavi
ukr,Ukraine,2016,dtp1,42,469514,197196,272318,eur,gavi
ukr,Ukraine,2016,dtp3,19,469514,89208,380306,eur,gavi
ukr,Ukraine,2016,mcv1,42,469514,197196,272318,eur,gavi
ukr,Ukraine,2016,mcv2,31,500265,155082,345183,eur,gavi
ury,Uruguay,2000,mcv1,89,53396,47522,5874,amr,hic
ury,Uruguay,2000,dtp1,92,53396,49124,4272,amr,hic
ury,Uruguay,2000,dtp3,90,53396,48056,5340,amr,hic
ury,Uruguay,2001,dtp1,99,52908,52379,529,amr,hic
ury,Uruguay,2001,dtp3,94,52908,49734,3174,amr,hic
ury,Uruguay,2001,mcv1,94,52908,49734,3174,amr,hic
ury,Uruguay,2002,dtp3,95,52425,49804,2621,amr,hic
ury,Uruguay,2002,mcv1,95,52425,49804,2621,amr,hic
ury,Uruguay,2002,dtp1,99,52425,51901,524,amr,hic
ury,Uruguay,2003,dtp3,91,51944,47269,4675,amr,hic
ury,Uruguay,2003,dtp1,98,51944,50905,1039,amr,hic
ury,Uruguay,2003,mcv1,95,51944,49347,2597,amr,hic
ury,Uruguay,2004,dtp3,94,51471,48383,3088,amr,hic
ury,Uruguay,2004,dtp1,98,51471,50442,1029,amr,hic
ury,Uruguay,2004,mcv1,95,51471,48897,2574,amr,hic
ury,Uruguay,2005,dtp1,99,51015,50505,510,amr,hic
ury,Uruguay,2005,dtp3,96,51015,48974,2041,amr,hic
ury,Uruguay,2005,mcv1,95,51015,48464,2551,amr,hic
ury,Uruguay,2006,dtp3,95,50581,48052,2529,amr,hic
ury,Uruguay,2006,dtp1,99,50581,50075,506,amr,hic
ury,Uruguay,2006,mcv1,94,50581,47546,3035,amr,hic
ury,Uruguay,2007,mcv1,96,50175,48168,2007,amr,hic
ury,Uruguay,2007,dtp3,94,50175,47164,3011,amr,hic
ury,Uruguay,2007,dtp1,98,50175,49172,1003,amr,hic
ury,Uruguay,2008,dtp3,94,49796,46808,2988,amr,hic
ury,Uruguay,2008,dtp1,98,49796,48800,996,amr,hic
ury,Uruguay,2008,mcv1,95,49796,47306,2490,amr,hic
ury,Uruguay,2009,dtp3,95,49450,46977,2473,amr,hic
ury,Uruguay,2009,mcv1,94,49450,46483,2967,amr,hic
ury,Uruguay,2009,dtp1,99,49450,48955,495,amr,hic
ury,Uruguay,2010,mcv1,95,49137,46680,2457,amr,hic
ury,Uruguay,2010,dtp3,95,49137,46680,2457,amr,hic
ury,Uruguay,2010,dtp1,98,49137,48154,983,amr,hic
ury,Uruguay,2011,dtp1,99,48857,48368,489,amr,hic
ury,Uruguay,2011,mcv1,95,48857,46414,2443,amr,hic
ury,Uruguay,2011,dtp3,95,48857,46414,2443,amr,hic
ury,Uruguay,2012,dtp3,95,48605,46175,2430,amr,hic
ury,Uruguay,2012,mcv1,96,48605,46661,1944,amr,hic
ury,Uruguay,2012,dtp1,98,48605,47633,972,amr,hic
ury,Uruguay,2013,dtp3,94,48376,45473,2903,amr,hic
ury,Uruguay,2013,mcv1,96,48376,46441,1935,amr,hic
ury,Uruguay,2013,dtp1,98,48376,47408,968,amr,hic
ury,Uruguay,2013,mcv2,92,49066,45141,3925,amr,hic
ury,Uruguay,2014,mcv1,96,48165,46238,1927,amr,hic
ury,Uruguay,2014,dtp3,95,48165,45757,2408,amr,hic
ury,Uruguay,2014,dtp1,99,48165,47683,482,amr,hic
ury,Uruguay,2014,mcv2,93,48870,45449,3421,amr,hic
ury,Uruguay,2015,mcv1,96,47969,46050,1919,amr,hic
ury,Uruguay,2015,dtp1,99,47969,47489,480,amr,hic
ury,Uruguay,2015,dtp3,95,47969,45571,2398,amr,hic
ury,Uruguay,2015,mcv2,93,48616,45213,3403,amr,hic
ury,Uruguay,2016,dtp3,95,47785,45396,2389,amr,hic
ury,Uruguay,2016,dtp1,97,47785,46351,1434,amr,hic
ury,Uruguay,2016,mcv1,95,47785,45396,2389,amr,hic
ury,Uruguay,2016,mcv2,92,48405,44533,3872,amr,hic
usa,United States of America,2000,dtp1,99,3937989,3898609,39380,amr,hic
usa,United States of America,2000,dtp3,94,3937989,3701710,236279,amr,hic
usa,United States of America,2000,mcv1,91,3937989,3583570,354419,amr,hic
usa,United States of America,2001,dtp1,98,3968555,3889184,79371,amr,hic
usa,United States of America,2001,mcv1,91,3968555,3611385,357170,amr,hic
usa,United States of America,2001,dtp3,94,3968555,3730442,238113,amr,hic
usa,United States of America,2002,dtp3,94,4004356,3764095,240261,amr,hic
usa,United States of America,2002,mcv1,91,4004356,3643964,360392,amr,hic
usa,United States of America,2002,dtp1,96,4004356,3844182,160174,amr,hic
usa,United States of America,2003,mcv1,93,4040700,3757851,282849,amr,hic
usa,United States of America,2003,dtp1,98,4040700,3959886,80814,amr,hic
usa,United States of America,2003,dtp3,96,4040700,3879072,161628,amr,hic
usa,United States of America,2004,dtp1,98,4074176,3992692,81484,amr,hic
usa,United States of America,2004,mcv1,93,4074176,3788984,285192,amr,hic
usa,United States of America,2004,dtp3,96,4074176,3911209,162967,amr,hic
usa,United States of America,2005,dtp1,98,4099097,4017115,81982,amr,hic
usa,United States of America,2005,dtp3,96,4099097,3935133,163964,amr,hic
usa,United States of America,2005,mcv1,92,4099097,3771169,327928,amr,hic
usa,United States of America,2006,dtp3,96,4109744,3945354,164390,amr,hic
usa,United States of America,2006,dtp1,98,4109744,4027549,82195,amr,hic
usa,United States of America,2006,mcv1,92,4109744,3780964,328780,amr,hic
usa,United States of America,2007,dtp3,96,4104756,3940566,164190,amr,hic
usa,United States of America,2007,dtp1,98,4104756,4022661,82095,amr,hic
usa,United States of America,2007,mcv1,92,4104756,3776376,328380,amr,hic
usa,United States of America,2008,dtp1,98,4085245,4003540,81705,amr,hic
usa,United States of America,2008,dtp3,96,4085245,3921835,163410,amr,hic
usa,United States of America,2008,mcv1,92,4085245,3758425,326820,amr,hic
usa,United States of America,2009,dtp3,95,4053866,3851173,202693,amr,hic
usa,United States of America,2009,dtp1,97,4053866,3932250,121616,amr,hic
usa,United States of America,2009,mcv1,90,4053866,3648479,405387,amr,hic
usa,United States of America,2010,dtp1,97,4016775,3896272,120503,amr,hic
usa,United States of America,2010,dtp3,95,4016775,3815936,200839,amr,hic
usa,United States of America,2010,mcv1,92,4016775,3695433,321342,amr,hic
usa,United States of America,2011,dtp1,97,3982097,3862634,119463,amr,hic
usa,United States of America,2011,dtp3,96,3982097,3822813,159284,amr,hic
usa,United States of America,2011,mcv1,92,3982097,3663529,318568,amr,hic
usa,United States of America,2012,dtp3,94,3957406,3719962,237444,amr,hic
usa,United States of America,2012,mcv1,91,3957406,3601239,356167,amr,hic
usa,United States of America,2012,dtp1,96,3957406,3799110,158296,amr,hic
usa,United States of America,2013,mcv1,92,3948001,3632161,315840,amr,hic
usa,United States of America,2013,dtp3,94,3948001,3711121,236880,amr,hic
usa,United States of America,2013,dtp1,97,3948001,3829561,118440,amr,hic
usa,United States of America,2014,mcv1,92,3955768,3639307,316461,amr,hic
usa,United States of America,2014,dtp3,95,3955768,3757980,197788,amr,hic
usa,United States of America,2014,dtp1,97,3955768,3837095,118673,amr,hic
usa,United States of America,2015,dtp3,95,3980232,3781220,199012,amr,hic
usa,United States of America,2015,mcv1,92,3980232,3661813,318419,amr,hic
usa,United States of America,2015,dtp1,97,3980232,3860825,119407,amr,hic
usa,United States of America,2016,dtp1,97,4018180,3897635,120545,amr,hic
usa,United States of America,2016,dtp3,95,4018180,3817271,200909,amr,hic
usa,United States of America,2016,mcv1,92,4018180,3696726,321454,amr,hic
uzb,Uzbekistan,2000,mcv1,99,535272,529919,5353,eur,gavi
uzb,Uzbekistan,2000,dtp1,99,535272,529919,5353,eur,gavi
uzb,Uzbekistan,2000,dtp3,99,535272,529919,5353,eur,gavi
uzb,Uzbekistan,2000,mcv2,98,576164,564641,11523,eur,gavi
uzb,Uzbekistan,2001,mcv1,99,526887,521618,5269,eur,gavi
uzb,Uzbekistan,2001,dtp3,99,526887,521618,5269,eur,gavi
uzb,Uzbekistan,2001,dtp1,99,526887,521618,5269,eur,gavi
uzb,Uzbekistan,2001,mcv2,98,547037,536096,10941,eur,gavi
uzb,Uzbekistan,2002,dtp3,99,524279,519036,5243,eur,gavi
uzb,Uzbekistan,2002,dtp1,99,524279,519036,5243,eur,gavi
uzb,Uzbekistan,2002,mcv1,97,524279,508551,15728,eur,gavi
uzb,Uzbekistan,2002,mcv2,97,519719,504127,15592,eur,gavi
uzb,Uzbekistan,2003,dtp1,99,527222,521950,5272,eur,gavi
uzb,Uzbekistan,2003,mcv1,99,527222,521950,5272,eur,gavi
uzb,Uzbekistan,2003,dtp3,98,527222,516678,10544,eur,gavi
uzb,Uzbekistan,2003,mcv2,98,521742,511307,10435,eur,gavi
uzb,Uzbekistan,2004,dtp1,99,535351,529997,5354,eur,gavi
uzb,Uzbekistan,2004,dtp3,99,535351,529997,5354,eur,gavi
uzb,Uzbekistan,2004,mcv1,98,535351,524644,10707,eur,gavi
uzb,Uzbekistan,2004,mcv2,99,566666,560999,5667,eur,gavi
uzb,Uzbekistan,2005,dtp3,99,547836,542358,5478,eur,gavi
uzb,Uzbekistan,2005,dtp1,99,547836,542358,5478,eur,gavi
uzb,Uzbekistan,2005,mcv1,99,547836,542358,5478,eur,gavi
uzb,Uzbekistan,2005,mcv2,81,546302,442505,103797,eur,gavi
uzb,Uzbekistan,2006,dtp1,96,563409,540873,22536,eur,gavi
uzb,Uzbekistan,2006,mcv1,98,563409,552141,11268,eur,gavi
uzb,Uzbekistan,2006,dtp3,96,563409,540873,22536,eur,gavi
uzb,Uzbekistan,2006,mcv2,63,530627,334295,196332,eur,gavi
uzb,Uzbekistan,2007,mcv1,98,580217,568613,11604,eur,gavi
uzb,Uzbekistan,2007,dtp3,96,580217,557008,23209,eur,gavi
uzb,Uzbekistan,2007,dtp1,98,580217,568613,11604,eur,gavi
uzb,Uzbekistan,2007,mcv2,44,518376,228085,290291,eur,gavi
uzb,Uzbekistan,2008,dtp1,99,596516,590551,5965,eur,gavi
uzb,Uzbekistan,2008,mcv1,98,596516,584586,11930,eur,gavi
uzb,Uzbekistan,2008,dtp3,98,596516,584586,11930,eur,gavi
uzb,Uzbekistan,2008,mcv2,26,510118,132631,377487,eur,gavi
uzb,Uzbekistan,2009,mcv1,95,611122,580566,30556,eur,gavi
uzb,Uzbekistan,2009,dtp3,98,611122,598900,12222,eur,gavi
uzb,Uzbekistan,2009,dtp1,99,611122,605011,6111,eur,gavi
uzb,Uzbekistan,2009,mcv2,8,506441,40515,465926,eur,gavi
uzb,Uzbekistan,2010,dtp3,99,623125,616894,6231,eur,gavi
uzb,Uzbekistan,2010,dtp1,99,623125,616894,6231,eur,gavi
uzb,Uzbekistan,2010,mcv1,98,623125,610662,12463,eur,gavi
uzb,Uzbekistan,2010,mcv2,54,507525,274064,233461,eur,gavi
uzb,Uzbekistan,2011,mcv1,99,632125,625804,6321,eur,gavi
uzb,Uzbekistan,2011,dtp3,99,632125,625804,6321,eur,gavi
uzb,Uzbekistan,2011,dtp1,99,632125,625804,6321,eur,gavi
uzb,Uzbekistan,2011,mcv2,99,516954,511784,5170,eur,gavi
uzb,Uzbekistan,2012,dtp1,99,638519,632134,6385,eur,gavi
uzb,Uzbekistan,2012,mcv1,99,638519,632134,6385,eur,gavi
uzb,Uzbekistan,2012,dtp3,99,638519,632134,6385,eur,gavi
uzb,Uzbekistan,2012,mcv2,99,536608,531242,5366,eur,gavi
uzb,Uzbekistan,2013,dtp1,99,642637,636211,6426,eur,gavi
uzb,Uzbekistan,2013,dtp3,99,642637,636211,6426,eur,gavi
uzb,Uzbekistan,2013,mcv1,97,642637,623358,19279,eur,gavi
uzb,Uzbekistan,2013,mcv2,99,561793,556175,5618,eur,gavi
uzb,Uzbekistan,2014,dtp3,99,644405,637961,6444,eur,gavi
uzb,Uzbekistan,2014,dtp1,99,644405,637961,6444,eur,gavi
uzb,Uzbekistan,2014,mcv1,99,644405,637961,6444,eur,gavi
uzb,Uzbekistan,2014,mcv2,99,587678,581801,5877,eur,gavi
uzb,Uzbekistan,2015,dtp1,99,643719,637282,6437,eur,gavi
uzb,Uzbekistan,2015,mcv1,99,643719,637282,6437,eur,gavi
uzb,Uzbekistan,2015,dtp3,99,643719,637282,6437,eur,gavi
uzb,Uzbekistan,2015,mcv2,99,607701,601624,6077,eur,gavi
uzb,Uzbekistan,2016,dtp1,99,640556,634150,6406,eur,gavi
uzb,Uzbekistan,2016,dtp3,99,640556,634150,6406,eur,gavi
uzb,Uzbekistan,2016,mcv1,99,640556,634150,6406,eur,gavi
uzb,Uzbekistan,2016,mcv2,99,622646,616420,6226,eur,gavi
vct,Saint Vincent and The Grenadines,2000,mcv1,96,2107,2023,84,amr,mic_nongavi
vct,Saint Vincent and The Grenadines,2000,dtp1,99,2107,2086,21,amr,mic_nongavi
vct,Saint Vincent and The Grenadines,2000,dtp3,98,2107,2065,42,amr,mic_nongavi
vct,Saint Vincent and The Grenadines,2001,mcv1,98,2054,2013,41,amr,mic_nongavi
vct,Saint Vincent and The Grenadines,2001,dtp1,99,2054,2033,21,amr,mic_nongavi
vct,Saint Vincent and The Grenadines,2001,dtp3,99,2054,2033,21,amr,mic_nongavi
vct,Saint Vincent and The Grenadines,2001,mcv2,99,2202,2180,22,amr,mic_nongavi
vct,Saint Vincent and The Grenadines,2002,dtp1,99,2009,1989,20,amr,mic_nongavi
vct,Saint Vincent and The Grenadines,2002,dtp3,99,2009,1989,20,amr,mic_nongavi
vct,Saint Vincent and The Grenadines,2002,mcv1,99,2009,1989,20,amr,mic_nongavi
vct,Saint Vincent and The Grenadines,2002,mcv2,99,2153,2131,22,amr,mic_nongavi
vct,Saint Vincent and The Grenadines,2003,dtp1,99,1972,1952,20,amr,mic_nongavi
vct,Saint Vincent and The Grenadines,2003,dtp3,99,1972,1952,20,amr,mic_nongavi
vct,Saint Vincent and The Grenadines,2003,mcv1,94,1972,1854,118,amr,mic_nongavi
vct,Saint Vincent and The Grenadines,2003,mcv2,86,2067,1778,289,amr,mic_nongavi
vct,Saint Vincent and The Grenadines,2004,dtp1,99,1944,1925,19,amr,mic_nongavi
vct,Saint Vincent and The Grenadines,2004,dtp3,99,1944,1925,19,amr,mic_nongavi
vct,Saint Vincent and The Grenadines,2004,mcv1,99,1944,1925,19,amr,mic_nongavi
vct,Saint Vincent and The Grenadines,2004,mcv2,73,2054,1499,555,amr,mic_nongavi
vct,Saint Vincent and The Grenadines,2005,dtp1,99,1924,1905,19,amr,mic_nongavi
vct,Saint Vincent and The Grenadines,2005,dtp3,99,1924,1905,19,amr,mic_nongavi
vct,Saint Vincent and The Grenadines,2005,mcv1,97,1924,1866,58,amr,mic_nongavi
vct,Saint Vincent and The Grenadines,2005,mcv2,93,2007,1867,140,amr,mic_nongavi
vct,Saint Vincent and The Grenadines,2006,mcv1,99,1907,1888,19,amr,mic_nongavi
vct,Saint Vincent and The Grenadines,2006,dtp3,99,1907,1888,19,amr,mic_nongavi
vct,Saint Vincent and The Grenadines,2006,dtp1,99,1907,1888,19,amr,mic_nongavi
vct,Saint Vincent and The Grenadines,2006,mcv2,88,1877,1652,225,amr,mic_nongavi
vct,Saint Vincent and The Grenadines,2007,mcv1,99,1892,1873,19,amr,mic_nongavi
vct,Saint Vincent and The Grenadines,2007,dtp3,99,1892,1873,19,amr,mic_nongavi
vct,Saint Vincent and The Grenadines,2007,dtp1,99,1892,1873,19,amr,mic_nongavi
vct,Saint Vincent and The Grenadines,2007,mcv2,83,1905,1581,324,amr,mic_nongavi
vct,Saint Vincent and The Grenadines,2008,dtp3,99,1876,1857,19,amr,mic_nongavi
vct,Saint Vincent and The Grenadines,2008,mcv1,99,1876,1857,19,amr,mic_nongavi
vct,Saint Vincent and The Grenadines,2008,dtp1,99,1876,1857,19,amr,mic_nongavi
vct,Saint Vincent and The Grenadines,2008,mcv2,94,1855,1744,111,amr,mic_nongavi
vct,Saint Vincent and The Grenadines,2009,dtp3,99,1857,1838,19,amr,mic_nongavi
vct,Saint Vincent and The Grenadines,2009,mcv1,99,1857,1838,19,amr,mic_nongavi
vct,Saint Vincent and The Grenadines,2009,dtp1,99,1857,1838,19,amr,mic_nongavi
vct,Saint Vincent and The Grenadines,2009,mcv2,94,1818,1709,109,amr,mic_nongavi
vct,Saint Vincent and The Grenadines,2010,dtp1,99,1834,1816,18,amr,mic_nongavi
vct,Saint Vincent and The Grenadines,2010,dtp3,99,1834,1816,18,amr,mic_nongavi
vct,Saint Vincent and The Grenadines,2010,mcv1,99,1834,1816,18,amr,mic_nongavi
vct,Saint Vincent and The Grenadines,2010,mcv2,89,1804,1606,198,amr,mic_nongavi
vct,Saint Vincent and The Grenadines,2011,dtp1,98,1809,1773,36,amr,mic_nongavi
vct,Saint Vincent and The Grenadines,2011,mcv1,97,1809,1755,54,amr,mic_nongavi
vct,Saint Vincent and The Grenadines,2011,dtp3,96,1809,1737,72,amr,mic_nongavi
vct,Saint Vincent and The Grenadines,2011,mcv2,91,1806,1643,163,amr,mic_nongavi
vct,Saint Vincent and The Grenadines,2012,dtp3,96,1783,1712,71,amr,mic_nongavi
vct,Saint Vincent and The Grenadines,2012,mcv1,94,1783,1676,107,amr,mic_nongavi
vct,Saint Vincent and The Grenadines,2012,dtp1,98,1783,1747,36,amr,mic_nongavi
vct,Saint Vincent and The Grenadines,2012,mcv2,92,1823,1677,146,amr,mic_nongavi
vct,Saint Vincent and The Grenadines,2013,mcv1,99,1756,1738,18,amr,mic_nongavi
vct,Saint Vincent and The Grenadines,2013,dtp3,97,1756,1703,53,amr,mic_nongavi
vct,Saint Vincent and The Grenadines,2013,dtp1,99,1756,1738,18,amr,mic_nongavi
vct,Saint Vincent and The Grenadines,2013,mcv2,96,1833,1760,73,amr,mic_nongavi
vct,Saint Vincent and The Grenadines,2014,mcv1,99,1729,1712,17,amr,mic_nongavi
vct,Saint Vincent and The Grenadines,2014,dtp3,98,1729,1694,35,amr,mic_nongavi
vct,Saint Vincent and The Grenadines,2014,dtp1,99,1729,1712,17,amr,mic_nongavi
vct,Saint Vincent and The Grenadines,2014,mcv2,98,1823,1787,36,amr,mic_nongavi
vct,Saint Vincent and The Grenadines,2015,dtp3,98,1703,1669,34,amr,mic_nongavi
vct,Saint Vincent and The Grenadines,2015,mcv1,99,1703,1686,17,amr,mic_nongavi
vct,Saint Vincent and The Grenadines,2015,dtp1,99,1703,1686,17,amr,mic_nongavi
vct,Saint Vincent and The Grenadines,2015,mcv2,99,1776,1758,18,amr,mic_nongavi
vct,Saint Vincent and The Grenadines,2016,mcv1,99,1677,1660,17,amr,mic_nongavi
vct,Saint Vincent and The Grenadines,2016,dtp1,99,1677,1660,17,amr,mic_nongavi
vct,Saint Vincent and The Grenadines,2016,dtp3,98,1677,1643,34,amr,mic_nongavi
vct,Saint Vincent and The Grenadines,2016,mcv2,99,1739,1722,17,amr,mic_nongavi
ven,Venezuela (Bolivarian Republic of),2000,dtp3,77,571242,439856,131386,amr,mic_nongavi
ven,Venezuela (Bolivarian Republic of),2000,mcv1,84,571242,479843,91399,amr,mic_nongavi
ven,Venezuela (Bolivarian Republic of),2000,dtp1,92,571242,525543,45699,amr,mic_nongavi
ven,Venezuela (Bolivarian Republic of),2001,dtp1,82,573817,470530,103287,amr,mic_nongavi
ven,Venezuela (Bolivarian Republic of),2001,mcv1,98,573817,562341,11476,amr,mic_nongavi
ven,Venezuela (Bolivarian Republic of),2001,dtp3,70,573817,401672,172145,amr,mic_nongavi
ven,Venezuela (Bolivarian Republic of),2002,dtp3,65,576582,374778,201804,amr,mic_nongavi
ven,Venezuela (Bolivarian Republic of),2002,dtp1,79,576582,455500,121082,amr,mic_nongavi
ven,Venezuela (Bolivarian Republic of),2002,mcv1,83,576582,478563,98019,amr,mic_nongavi
ven,Venezuela (Bolivarian Republic of),2003,dtp1,88,579400,509872,69528,amr,mic_nongavi
ven,Venezuela (Bolivarian Republic of),2003,dtp3,68,579400,393992,185408,amr,mic_nongavi
ven,Venezuela (Bolivarian Republic of),2003,mcv1,83,579400,480902,98498,amr,mic_nongavi
ven,Venezuela (Bolivarian Republic of),2004,dtp1,93,582172,541420,40752,amr,mic_nongavi
ven,Venezuela (Bolivarian Republic of),2004,dtp3,86,582172,500668,81504,amr,mic_nongavi
ven,Venezuela (Bolivarian Republic of),2004,mcv1,80,582172,465738,116434,amr,mic_nongavi
ven,Venezuela (Bolivarian Republic of),2005,dtp1,98,584812,573116,11696,amr,mic_nongavi
ven,Venezuela (Bolivarian Republic of),2005,mcv1,76,584812,444457,140355,amr,mic_nongavi
ven,Venezuela (Bolivarian Republic of),2005,dtp3,87,584812,508786,76026,amr,mic_nongavi
ven,Venezuela (Bolivarian Republic of),2006,dtp3,71,587261,416955,170306,amr,mic_nongavi
ven,Venezuela (Bolivarian Republic of),2006,dtp1,79,587261,463936,123325,amr,mic_nongavi
ven,Venezuela (Bolivarian Republic of),2006,mcv1,82,587261,481554,105707,amr,mic_nongavi
ven,Venezuela (Bolivarian Republic of),2007,dtp3,62,589489,365483,224006,amr,mic_nongavi
ven,Venezuela (Bolivarian Republic of),2007,mcv1,87,589489,512855,76634,amr,mic_nongavi
ven,Venezuela (Bolivarian Republic of),2007,dtp1,70,589489,412642,176847,amr,mic_nongavi
ven,Venezuela (Bolivarian Republic of),2008,mcv1,93,591451,550049,41402,amr,mic_nongavi
ven,Venezuela (Bolivarian Republic of),2008,dtp1,87,591451,514562,76889,amr,mic_nongavi
ven,Venezuela (Bolivarian Republic of),2008,dtp3,50,591451,295726,295725,amr,mic_nongavi
ven,Venezuela (Bolivarian Republic of),2009,dtp1,86,593085,510053,83032,amr,mic_nongavi
ven,Venezuela (Bolivarian Republic of),2009,mcv1,87,593085,515984,77101,amr,mic_nongavi
ven,Venezuela (Bolivarian Republic of),2009,dtp3,84,593085,498191,94894,amr,mic_nongavi
ven,Venezuela (Bolivarian Republic of),2009,mcv2,6,579471,34768,544703,amr,mic_nongavi
ven,Venezuela (Bolivarian Republic of),2010,dtp1,90,594329,534896,59433,amr,mic_nongavi
ven,Venezuela (Bolivarian Republic of),2010,dtp3,78,594329,463577,130752,amr,mic_nongavi
ven,Venezuela (Bolivarian Republic of),2010,mcv1,79,594329,469520,124809,amr,mic_nongavi
ven,Venezuela (Bolivarian Republic of),2010,mcv2,31,581709,180330,401379,amr,mic_nongavi
ven,Venezuela (Bolivarian Republic of),2011,dtp1,90,595140,535626,59514,amr,mic_nongavi
ven,Venezuela (Bolivarian Republic of),2011,mcv1,86,595140,511820,83320,amr,mic_nongavi
ven,Venezuela (Bolivarian Republic of),2011,dtp3,78,595140,464209,130931,amr,mic_nongavi
ven,Venezuela (Bolivarian Republic of),2011,mcv2,26,584539,151980,432559,amr,mic_nongavi
ven,Venezuela (Bolivarian Republic of),2012,dtp1,90,595528,535975,59553,amr,mic_nongavi
ven,Venezuela (Bolivarian Republic of),2012,dtp3,81,595528,482378,113150,amr,mic_nongavi
ven,Venezuela (Bolivarian Republic of),2012,mcv1,87,595528,518109,77419,amr,mic_nongavi
ven,Venezuela (Bolivarian Republic of),2012,mcv2,33,587092,193740,393352,amr,mic_nongavi
ven,Venezuela (Bolivarian Republic of),2013,dtp3,82,595512,488320,107192,amr,mic_nongavi
ven,Venezuela (Bolivarian Republic of),2013,dtp1,90,595512,535961,59551,amr,mic_nongavi
ven,Venezuela (Bolivarian Republic of),2013,mcv1,85,595512,506185,89327,amr,mic_nongavi
ven,Venezuela (Bolivarian Republic of),2013,mcv2,38,589286,223929,365357,amr,mic_nongavi
ven,Venezuela (Bolivarian Republic of),2014,dtp3,78,595103,464180,130923,amr,mic_nongavi
ven,Venezuela (Bolivarian Republic of),2014,mcv1,89,595103,529642,65461,amr,mic_nongavi
ven,Venezuela (Bolivarian Republic of),2014,dtp1,88,595103,523691,71412,amr,mic_nongavi
ven,Venezuela (Bolivarian Republic of),2014,mcv2,50,591063,295532,295531,amr,mic_nongavi
ven,Venezuela (Bolivarian Republic of),2015,dtp1,98,594311,582425,11886,amr,mic_nongavi
ven,Venezuela (Bolivarian Republic of),2015,dtp3,87,594311,517051,77260,amr,mic_nongavi
ven,Venezuela (Bolivarian Republic of),2015,mcv1,92,594311,546766,47545,amr,mic_nongavi
ven,Venezuela (Bolivarian Republic of),2015,mcv2,52,592363,308029,284334,amr,mic_nongavi
ven,Venezuela (Bolivarian Republic of),2016,dtp1,98,593153,581290,11863,amr,mic_nongavi
ven,Venezuela (Bolivarian Republic of),2016,mcv1,88,593153,521975,71178,amr,mic_nongavi
ven,Venezuela (Bolivarian Republic of),2016,dtp3,84,593153,498249,94904,amr,mic_nongavi
ven,Venezuela (Bolivarian Republic of),2016,mcv2,53,593601,314609,278992,amr,mic_nongavi
vnm,Viet Nam,2000,dtp3,96,1370277,1315466,54811,wpr,gavi
vnm,Viet Nam,2000,mcv1,97,1370277,1329169,41108,wpr,gavi
vnm,Viet Nam,2000,dtp1,97,1370277,1329169,41108,wpr,gavi
vnm,Viet Nam,2001,dtp3,96,1355727,1301498,54229,wpr,gavi
vnm,Viet Nam,2001,dtp1,99,1355727,1342170,13557,wpr,gavi
vnm,Viet Nam,2001,mcv1,98,1355727,1328612,27115,wpr,gavi
vnm,Viet Nam,2002,dtp1,85,1354058,1150949,203109,wpr,gavi
vnm,Viet Nam,2002,mcv1,96,1354058,1299896,54162,wpr,gavi
vnm,Viet Nam,2002,dtp3,75,1354058,1015544,338514,wpr,gavi
vnm,Viet Nam,2003,dtp1,99,1361409,1347795,13614,wpr,gavi
vnm,Viet Nam,2003,mcv1,93,1361409,1266110,95299,wpr,gavi
vnm,Viet Nam,2003,dtp3,99,1361409,1347795,13614,wpr,gavi
vnm,Viet Nam,2004,dtp1,98,1375836,1348319,27517,wpr,gavi
vnm,Viet Nam,2004,mcv1,97,1375836,1334561,41275,wpr,gavi
vnm,Viet Nam,2004,dtp3,96,1375836,1320803,55033,wpr,gavi
vnm,Viet Nam,2005,dtp1,98,1395559,1367648,27911,wpr,gavi
vnm,Viet Nam,2005,dtp3,95,1395559,1325781,69778,wpr,gavi
vnm,Viet Nam,2005,mcv1,95,1395559,1325781,69778,wpr,gavi
vnm,Viet Nam,2006,dtp3,94,1419089,1333944,85145,wpr,gavi
vnm,Viet Nam,2006,mcv1,93,1419089,1319753,99336,wpr,gavi
vnm,Viet Nam,2006,dtp1,94,1419089,1333944,85145,wpr,gavi
vnm,Viet Nam,2007,dtp3,92,1444920,1329326,115594,wpr,gavi
vnm,Viet Nam,2007,mcv1,83,1444920,1199284,245636,wpr,gavi
vnm,Viet Nam,2007,dtp1,92,1444920,1329326,115594,wpr,gavi
vnm,Viet Nam,2007,mcv2,18,1291301,232434,1058867,wpr,gavi
vnm,Viet Nam,2008,dtp3,93,1471245,1368258,102987,wpr,gavi
vnm,Viet Nam,2008,dtp1,97,1471245,1427108,44137,wpr,gavi
vnm,Viet Nam,2008,mcv1,92,1471245,1353545,117700,wpr,gavi
vnm,Viet Nam,2008,mcv2,97,1300062,1261060,39002,wpr,gavi
vnm,Viet Nam,2009,dtp1,97,1496101,1451218,44883,wpr,gavi
vnm,Viet Nam,2009,mcv1,97,1496101,1451218,44883,wpr,gavi
vnm,Viet Nam,2009,dtp3,96,1496101,1436257,59844,wpr,gavi
vnm,Viet Nam,2009,mcv2,96,1320604,1267780,52824,wpr,gavi
vnm,Viet Nam,2010,dtp1,93,1517502,1411277,106225,wpr,gavi
vnm,Viet Nam,2010,mcv1,98,1517502,1487152,30350,wpr,gavi
vnm,Viet Nam,2010,dtp3,93,1517502,1411277,106225,wpr,gavi
vnm,Viet Nam,2010,mcv2,98,1336943,1310204,26739,wpr,gavi
vnm,Viet Nam,2011,mcv1,96,1534022,1472661,61361,wpr,gavi
vnm,Viet Nam,2011,dtp1,97,1534022,1488001,46021,wpr,gavi
vnm,Viet Nam,2011,dtp3,95,1534022,1457321,76701,wpr,gavi
vnm,Viet Nam,2011,mcv2,93,1488328,1384145,104183,wpr,gavi
vnm,Viet Nam,2012,dtp3,97,1545660,1499290,46370,wpr,gavi
vnm,Viet Nam,2012,mcv1,96,1545660,1483834,61826,wpr,gavi
vnm,Viet Nam,2012,dtp1,99,1545660,1530203,15457,wpr,gavi
vnm,Viet Nam,2012,mcv2,83,1522555,1263721,258834,wpr,gavi
vnm,Viet Nam,2013,dtp3,59,1552646,916061,636585,wpr,gavi
vnm,Viet Nam,2013,dtp1,83,1552646,1288696,263950,wpr,gavi
vnm,Viet Nam,2013,mcv1,98,1552646,1521593,31053,wpr,gavi
vnm,Viet Nam,2013,mcv2,86,1531527,1317113,214414,wpr,gavi
vnm,Viet Nam,2014,dtp3,95,1554997,1477247,77750,wpr,gavi
vnm,Viet Nam,2014,mcv1,97,1554997,1508347,46650,wpr,gavi
vnm,Viet Nam,2014,dtp1,95,1554997,1477247,77750,wpr,gavi
vnm,Viet Nam,2014,mcv2,94,1548662,1455742,92920,wpr,gavi
vnm,Viet Nam,2015,mcv1,97,1553461,1506857,46604,wpr,gavi
vnm,Viet Nam,2015,dtp3,97,1553461,1506857,46604,wpr,gavi
vnm,Viet Nam,2015,dtp1,98,1553461,1522392,31069,wpr,gavi
vnm,Viet Nam,2015,mcv2,92,1559783,1435000,124783,wpr,gavi
vnm,Viet Nam,2016,dtp3,96,1549309,1487337,61972,wpr,gavi
vnm,Viet Nam,2016,dtp1,96,1549309,1487337,61972,wpr,gavi
vnm,Viet Nam,2016,mcv1,99,1549309,1533816,15493,wpr,gavi
vnm,Viet Nam,2016,mcv2,95,1561108,1483053,78055,wpr,gavi
vut,Vanuatu,2000,dtp3,71,5818,4131,1687,wpr,mic_nongavi
vut,Vanuatu,2000,mcv1,61,5818,3549,2269,wpr,mic_nongavi
vut,Vanuatu,2000,dtp1,85,5818,4945,873,wpr,mic_nongavi
vut,Vanuatu,2001,dtp3,70,5848,4094,1754,wpr,mic_nongavi
vut,Vanuatu,2001,dtp1,84,5848,4912,936,wpr,mic_nongavi
vut,Vanuatu,2001,mcv1,59,5848,3450,2398,wpr,mic_nongavi
vut,Vanuatu,2002,dtp1,83,5874,4875,999,wpr,mic_nongavi
vut,Vanuatu,2002,mcv1,58,5874,3407,2467,wpr,mic_nongavi
vut,Vanuatu,2002,dtp3,70,5874,4112,1762,wpr,mic_nongavi
vut,Vanuatu,2003,dtp1,82,5901,4839,1062,wpr,mic_nongavi
vut,Vanuatu,2003,mcv1,56,5901,3305,2596,wpr,mic_nongavi
vut,Vanuatu,2003,dtp3,69,5901,4072,1829,wpr,mic_nongavi
vut,Vanuatu,2004,dtp1,80,5931,4745,1186,wpr,mic_nongavi
vut,Vanuatu,2004,mcv1,55,5931,3262,2669,wpr,mic_nongavi
vut,Vanuatu,2004,dtp3,69,5931,4092,1839,wpr,mic_nongavi
vut,Vanuatu,2005,dtp1,79,5971,4717,1254,wpr,mic_nongavi
vut,Vanuatu,2005,dtp3,68,5971,4060,1911,wpr,mic_nongavi
vut,Vanuatu,2005,mcv1,53,5971,3165,2806,wpr,mic_nongavi
vut,Vanuatu,2006,dtp3,68,6022,4095,1927,wpr,mic_nongavi
vut,Vanuatu,2006,mcv1,52,6022,3131,2891,wpr,mic_nongavi
vut,Vanuatu,2006,dtp1,78,6022,4697,1325,wpr,mic_nongavi
vut,Vanuatu,2007,dtp3,67,6085,4077,2008,wpr,mic_nongavi
vut,Vanuatu,2007,mcv1,52,6085,3164,2921,wpr,mic_nongavi
vut,Vanuatu,2007,dtp1,78,6085,4746,1339,wpr,mic_nongavi
vut,Vanuatu,2008,dtp3,67,6158,4126,2032,wpr,mic_nongavi
vut,Vanuatu,2008,dtp1,77,6158,4742,1416,wpr,mic_nongavi
vut,Vanuatu,2008,mcv1,52,6158,3202,2956,wpr,mic_nongavi
vut,Vanuatu,2009,dtp1,77,6243,4807,1436,wpr,mic_nongavi
vut,Vanuatu,2009,mcv1,53,6243,3309,2934,wpr,mic_nongavi
vut,Vanuatu,2009,dtp3,66,6243,4120,2123,wpr,mic_nongavi
vut,Vanuatu,2010,dtp1,76,6334,4814,1520,wpr,mic_nongavi
vut,Vanuatu,2010,mcv1,53,6334,3357,2977,wpr,mic_nongavi
vut,Vanuatu,2010,dtp3,65,6334,4117,2217,wpr,mic_nongavi
vut,Vanuatu,2011,mcv1,53,6430,3408,3022,wpr,mic_nongavi
vut,Vanuatu,2011,dtp1,76,6430,4887,1543,wpr,mic_nongavi
vut,Vanuatu,2011,dtp3,65,6430,4180,2250,wpr,mic_nongavi
vut,Vanuatu,2012,dtp3,64,6525,4176,2349,wpr,mic_nongavi
vut,Vanuatu,2012,mcv1,53,6525,3458,3067,wpr,mic_nongavi
vut,Vanuatu,2012,dtp1,75,6525,4894,1631,wpr,mic_nongavi
vut,Vanuatu,2013,dtp3,64,6615,4234,2381,wpr,mic_nongavi
vut,Vanuatu,2013,dtp1,75,6615,4961,1654,wpr,mic_nongavi
vut,Vanuatu,2013,mcv1,53,6615,3506,3109,wpr,mic_nongavi
vut,Vanuatu,2014,dtp3,64,6698,4287,2411,wpr,mic_nongavi
vut,Vanuatu,2014,mcv1,53,6698,3550,3148,wpr,mic_nongavi
vut,Vanuatu,2014,dtp1,75,6698,5023,1675,wpr,mic_nongavi
vut,Vanuatu,2015,mcv1,53,6773,3590,3183,wpr,mic_nongavi
vut,Vanuatu,2015,dtp3,64,6773,4335,2438,wpr,mic_nongavi
vut,Vanuatu,2015,dtp1,75,6773,5080,1693,wpr,mic_nongavi
vut,Vanuatu,2016,dtp3,64,6840,4378,2462,wpr,mic_nongavi
vut,Vanuatu,2016,dtp1,75,6840,5130,1710,wpr,mic_nongavi
vut,Vanuatu,2016,mcv1,53,6840,3625,3215,wpr,mic_nongavi
wsm,Samoa,2000,mcv1,93,5200,4836,364,wpr,mic_nongavi
wsm,Samoa,2000,dtp1,97,5200,5044,156,wpr,mic_nongavi
wsm,Samoa,2000,dtp3,95,5200,4940,260,wpr,mic_nongavi
wsm,Samoa,2001,mcv1,92,5179,4765,414,wpr,mic_nongavi
wsm,Samoa,2001,dtp1,99,5179,5127,52,wpr,mic_nongavi
wsm,Samoa,2001,dtp3,85,5179,4402,777,wpr,mic_nongavi
wsm,Samoa,2002,dtp1,99,5165,5113,52,wpr,mic_nongavi
wsm,Samoa,2002,dtp3,86,5165,4442,723,wpr,mic_nongavi
wsm,Samoa,2002,mcv1,99,5165,5113,52,wpr,mic_nongavi
wsm,Samoa,2002,mcv2,84,4984,4187,797,wpr,mic_nongavi
wsm,Samoa,2003,dtp1,96,5164,4957,207,wpr,mic_nongavi
wsm,Samoa,2003,dtp3,83,5164,4286,878,wpr,mic_nongavi
wsm,Samoa,2003,mcv1,62,5164,3202,1962,wpr,mic_nongavi
wsm,Samoa,2003,mcv2,65,4898,3184,1714,wpr,mic_nongavi
wsm,Samoa,2004,dtp1,91,5173,4707,466,wpr,mic_nongavi
wsm,Samoa,2004,dtp3,55,5173,2845,2328,wpr,mic_nongavi
wsm,Samoa,2004,mcv1,25,5173,1293,3880,wpr,mic_nongavi
wsm,Samoa,2004,mcv2,45,4828,2173,2655,wpr,mic_nongavi
wsm,Samoa,2005,dtp1,87,5188,4514,674,wpr,mic_nongavi
wsm,Samoa,2005,dtp3,49,5188,2542,2646,wpr,mic_nongavi
wsm,Samoa,2005,mcv1,57,5188,2957,2231,wpr,mic_nongavi
wsm,Samoa,2005,mcv2,26,4806,1250,3556,wpr,mic_nongavi
wsm,Samoa,2006,mcv1,54,5200,2808,2392,wpr,mic_nongavi
wsm,Samoa,2006,dtp3,39,5200,2028,3172,wpr,mic_nongavi
wsm,Samoa,2006,dtp1,80,5200,4160,1040,wpr,mic_nongavi
wsm,Samoa,2006,mcv2,6,5041,302,4739,wpr,mic_nongavi
wsm,Samoa,2007,mcv1,63,5202,3277,1925,wpr,mic_nongavi
wsm,Samoa,2007,dtp3,53,5202,2757,2445,wpr,mic_nongavi
wsm,Samoa,2007,dtp1,85,5202,4422,780,wpr,mic_nongavi
wsm,Samoa,2007,mcv2,36,5073,1826,3247,wpr,mic_nongavi
wsm,Samoa,2008,dtp3,26,5185,1348,3837,wpr,mic_nongavi
wsm,Samoa,2008,mcv1,44,5185,2281,2904,wpr,mic_nongavi
wsm,Samoa,2008,dtp1,48,5185,2489,2696,wpr,mic_nongavi
wsm,Samoa,2008,mcv2,46,5085,2339,2746,wpr,mic_nongavi
wsm,Samoa,2009,dtp3,49,5152,2524,2628,wpr,mic_nongavi
wsm,Samoa,2009,mcv1,45,5152,2318,2834,wpr,mic_nongavi
wsm,Samoa,2009,dtp1,86,5152,4431,721,wpr,mic_nongavi
wsm,Samoa,2009,mcv2,14,5123,717,4406,wpr,mic_nongavi
wsm,Samoa,2010,dtp1,91,5101,4642,459,wpr,mic_nongavi
wsm,Samoa,2010,dtp3,62,5101,3163,1938,wpr,mic_nongavi
wsm,Samoa,2010,mcv1,56,5101,2857,2244,wpr,mic_nongavi
wsm,Samoa,2010,mcv2,30,5146,1544,3602,wpr,mic_nongavi
wsm,Samoa,2011,dtp1,91,5036,4583,453,wpr,mic_nongavi
wsm,Samoa,2011,mcv1,59,5036,2971,2065,wpr,mic_nongavi
wsm,Samoa,2011,dtp3,65,5036,3273,1763,wpr,mic_nongavi
wsm,Samoa,2011,mcv2,50,5260,2630,2630,wpr,mic_nongavi
wsm,Samoa,2012,dtp3,64,4967,3179,1788,wpr,mic_nongavi
wsm,Samoa,2012,mcv1,76,4967,3775,1192,wpr,mic_nongavi
wsm,Samoa,2012,dtp1,88,4967,4371,596,wpr,mic_nongavi
wsm,Samoa,2012,mcv2,52,5348,2781,2567,wpr,mic_nongavi
wsm,Samoa,2013,mcv1,90,4898,4408,490,wpr,mic_nongavi
wsm,Samoa,2013,dtp3,67,4898,3282,1616,wpr,mic_nongavi
wsm,Samoa,2013,dtp1,89,4898,4359,539,wpr,mic_nongavi
wsm,Samoa,2013,mcv2,72,5040,3629,1411,wpr,mic_nongavi
wsm,Samoa,2014,mcv1,82,4834,3964,870,wpr,mic_nongavi
wsm,Samoa,2014,dtp3,63,4834,3045,1789,wpr,mic_nongavi
wsm,Samoa,2014,dtp1,88,4834,4254,580,wpr,mic_nongavi
wsm,Samoa,2014,mcv2,63,4981,3138,1843,wpr,mic_nongavi
wsm,Samoa,2015,dtp3,66,4779,3154,1625,wpr,mic_nongavi
wsm,Samoa,2015,mcv1,69,4779,3298,1481,wpr,mic_nongavi
wsm,Samoa,2015,dtp1,89,4779,4253,526,wpr,mic_nongavi
wsm,Samoa,2015,mcv2,48,4908,2356,2552,wpr,mic_nongavi
wsm,Samoa,2016,mcv1,68,4732,3218,1514,wpr,mic_nongavi
wsm,Samoa,2016,dtp1,95,4732,4495,237,wpr,mic_nongavi
wsm,Samoa,2016,dtp3,62,4732,2934,1798,wpr,mic_nongavi
wsm,Samoa,2016,mcv2,44,4713,2074,2639,wpr,mic_nongavi
yem,Yemen,2000,dtp3,74,655803,485294,170509,emr,gavi
yem,Yemen,2000,mcv1,70,655803,459062,196741,emr,gavi
yem,Yemen,2000,dtp1,88,655803,577107,78696,emr,gavi
yem,Yemen,2001,dtp3,73,664285,484928,179357,emr,gavi
yem,Yemen,2001,dtp1,87,664285,577928,86357,emr,gavi
yem,Yemen,2001,mcv1,72,664285,478285,186000,emr,gavi
yem,Yemen,2002,dtp1,72,674094,485348,188746,emr,gavi
yem,Yemen,2002,mcv1,62,674094,417938,256156,emr,gavi
yem,Yemen,2002,dtp3,65,674094,438161,235933,emr,gavi
yem,Yemen,2003,dtp1,77,684811,527304,157507,emr,gavi
yem,Yemen,2003,mcv1,64,684811,438279,246532,emr,gavi
yem,Yemen,2003,dtp3,61,684811,417735,267076,emr,gavi
yem,Yemen,2004,dtp1,89,696313,619719,76594,emr,gavi
yem,Yemen,2004,mcv1,74,696313,515272,181041,emr,gavi
yem,Yemen,2004,dtp3,72,696313,501345,194968,emr,gavi
yem,Yemen,2005,dtp1,88,708586,623556,85030,emr,gavi
yem,Yemen,2005,dtp3,79,708586,559783,148803,emr,gavi
yem,Yemen,2005,mcv1,73,708586,517268,191318,emr,gavi
yem,Yemen,2005,mcv2,21,666192,139900,526292,emr,gavi
yem,Yemen,2006,dtp3,78,721661,562896,158765,emr,gavi
yem,Yemen,2006,mcv1,65,721661,469080,252581,emr,gavi
yem,Yemen,2006,dtp1,86,721661,620628,101033,emr,gavi
yem,Yemen,2006,mcv2,26,685809,178310,507499,emr,gavi
yem,Yemen,2007,dtp3,79,735399,580965,154434,emr,gavi
yem,Yemen,2007,mcv1,71,735399,522133,213266,emr,gavi
yem,Yemen,2007,dtp1,88,735399,647151,88248,emr,gavi
yem,Yemen,2007,mcv2,32,706194,225982,480212,emr,gavi
yem,Yemen,2008,dtp3,78,749527,584631,164896,emr,gavi
yem,Yemen,2008,dtp1,85,749527,637098,112429,emr,gavi
yem,Yemen,2008,mcv1,69,749527,517174,232353,emr,gavi
yem,Yemen,2008,mcv2,35,704127,246444,457683,emr,gavi
yem,Yemen,2009,dtp1,84,763693,641502,122191,emr,gavi
yem,Yemen,2009,mcv1,65,763693,496400,267293,emr,gavi
yem,Yemen,2009,dtp3,76,763693,580407,183286,emr,gavi
yem,Yemen,2009,mcv2,38,719500,273410,446090,emr,gavi
yem,Yemen,2010,dtp1,84,777447,653055,124392,emr,gavi
yem,Yemen,2010,mcv1,68,777447,528664,248783,emr,gavi
yem,Yemen,2010,dtp3,76,777447,590860,186587,emr,gavi
yem,Yemen,2010,mcv2,43,734764,315949,418815,emr,gavi
yem,Yemen,2011,mcv1,66,790353,521633,268720,emr,gavi
yem,Yemen,2011,dtp1,79,790353,624379,165974,emr,gavi
yem,Yemen,2011,dtp3,69,790353,545344,245009,emr,gavi
yem,Yemen,2011,mcv2,46,750160,345074,405086,emr,gavi
yem,Yemen,2012,dtp3,67,802115,537417,264698,emr,gavi
yem,Yemen,2012,mcv1,63,802115,505332,296783,emr,gavi
yem,Yemen,2012,dtp1,77,802115,617629,184486,emr,gavi
yem,Yemen,2012,mcv2,40,765170,306068,459102,emr,gavi
yem,Yemen,2013,dtp3,73,812507,593130,219377,emr,gavi
yem,Yemen,2013,dtp1,82,812507,666256,146251,emr,gavi
yem,Yemen,2013,mcv1,70,812507,568755,243752,emr,gavi
yem,Yemen,2013,mcv2,47,778951,366107,412844,emr,gavi
yem,Yemen,2014,dtp3,73,821376,599604,221772,emr,gavi
yem,Yemen,2014,mcv1,67,821376,550322,271054,emr,gavi
yem,Yemen,2014,dtp1,82,821376,673528,147848,emr,gavi
yem,Yemen,2014,mcv2,45,791962,356383,435579,emr,gavi
yem,Yemen,2015,mcv1,67,828665,555206,273459,emr,gavi
yem,Yemen,2015,dtp3,69,828665,571779,256886,emr,gavi
yem,Yemen,2015,dtp1,77,828665,638072,190593,emr,gavi
yem,Yemen,2015,mcv2,41,803415,329400,474015,emr,gavi
yem,Yemen,2016,dtp3,71,834461,592467,241994,emr,gavi
yem,Yemen,2016,dtp1,76,834461,634190,200271,emr,gavi
yem,Yemen,2016,mcv1,70,834461,584123,250338,emr,gavi
yem,Yemen,2016,mcv2,49,816674,400170,416504,emr,gavi
zaf,South Africa,2000,dtp3,73,1046244,763758,282486,afr,mic_nongavi
zaf,South Africa,2000,mcv1,72,1046244,753296,292948,afr,mic_nongavi
zaf,South Africa,2000,dtp1,85,1046244,889307,156937,afr,mic_nongavi
zaf,South Africa,2000,mcv2,62,1027901,637299,390602,afr,mic_nongavi
zaf,South Africa,2001,dtp3,71,1050448,745818,304630,afr,mic_nongavi
zaf,South Africa,2001,dtp1,82,1050448,861367,189081,afr,mic_nongavi
zaf,South Africa,2001,mcv1,69,1050448,724809,325639,afr,mic_nongavi
zaf,South Africa,2001,mcv2,54,1037581,560294,477287,afr,mic_nongavi
zaf,South Africa,2002,dtp1,80,1055061,844049,211012,afr,mic_nongavi
zaf,South Africa,2002,mcv1,65,1055061,685790,369271,afr,mic_nongavi
zaf,South Africa,2002,dtp3,70,1055061,738543,316518,afr,mic_nongavi
zaf,South Africa,2002,mcv2,46,1046701,481482,565219,afr,mic_nongavi
zaf,South Africa,2003,dtp1,77,1060094,816272,243822,afr,mic_nongavi
zaf,South Africa,2003,mcv1,62,1060094,657258,402836,afr,mic_nongavi
zaf,South Africa,2003,dtp3,69,1060094,731465,328629,afr,mic_nongavi
zaf,South Africa,2003,mcv2,52,1040426,541022,499404,afr,mic_nongavi
zaf,South Africa,2004,dtp1,80,1065553,852442,213111,afr,mic_nongavi
zaf,South Africa,2004,mcv1,62,1065553,660643,404910,afr,mic_nongavi
zaf,South Africa,2004,dtp3,74,1065553,788509,277044,afr,mic_nongavi
zaf,South Africa,2004,mcv2,51,1045047,532974,512073,afr,mic_nongavi
zaf,South Africa,2005,dtp1,83,1071666,889483,182183,afr,mic_nongavi
zaf,South Africa,2005,dtp3,79,1071666,846616,225050,afr,mic_nongavi
zaf,South Africa,2005,mcv1,62,1071666,664433,407233,afr,mic_nongavi
zaf,South Africa,2005,mcv2,49,1049230,514123,535107,afr,mic_nongavi
zaf,South Africa,2006,dtp3,82,1078741,884568,194173,afr,mic_nongavi
zaf,South Africa,2006,mcv1,65,1078741,701182,377559,afr,mic_nongavi
zaf,South Africa,2006,dtp1,82,1078741,884568,194173,afr,mic_nongavi
zaf,South Africa,2006,mcv2,55,1056353,580994,475359,afr,mic_nongavi
zaf,South Africa,2007,dtp3,82,1086814,891187,195627,afr,mic_nongavi
zaf,South Africa,2007,mcv1,63,1086814,684693,402121,afr,mic_nongavi
zaf,South Africa,2007,dtp1,83,1086814,902056,184758,afr,mic_nongavi
zaf,South Africa,2007,mcv2,52,1062972,552745,510227,afr,mic_nongavi
zaf,South Africa,2008,dtp3,79,1095695,865599,230096,afr,mic_nongavi
zaf,South Africa,2008,dtp1,81,1095695,887513,208182,afr,mic_nongavi
zaf,South Africa,2008,mcv1,67,1095695,734116,361579,afr,mic_nongavi
zaf,South Africa,2008,mcv2,57,1064102,606538,457564,afr,mic_nongavi
zaf,South Africa,2009,dtp1,81,1105013,895061,209952,afr,mic_nongavi
zaf,South Africa,2009,mcv1,70,1105013,773509,331504,afr,mic_nongavi
zaf,South Africa,2009,dtp3,76,1105013,839810,265203,afr,mic_nongavi
zaf,South Africa,2009,mcv2,66,1071033,706882,364151,afr,mic_nongavi
zaf,South Africa,2010,dtp1,80,1114157,891326,222831,afr,mic_nongavi
zaf,South Africa,2010,mcv1,64,1114157,713060,401097,afr,mic_nongavi
zaf,South Africa,2010,dtp3,72,1114157,802193,311964,afr,mic_nongavi
zaf,South Africa,2010,mcv2,59,1080498,637494,443004,afr,mic_nongavi
zaf,South Africa,2011,mcv1,68,1122421,763246,359175,afr,mic_nongavi
zaf,South Africa,2011,dtp1,80,1122421,897937,224484,afr,mic_nongavi
zaf,South Africa,2011,dtp3,69,1122421,774470,347951,afr,mic_nongavi
zaf,South Africa,2011,mcv2,58,1090263,632353,457910,afr,mic_nongavi
zaf,South Africa,2012,dtp3,65,1129224,733996,395228,afr,mic_nongavi
zaf,South Africa,2012,mcv1,68,1129224,767872,361352,afr,mic_nongavi
zaf,South Africa,2012,dtp1,72,1129224,813041,316183,afr,mic_nongavi
zaf,South Africa,2012,mcv2,59,1101263,649745,451518,afr,mic_nongavi
zaf,South Africa,2013,dtp3,73,1134148,827928,306220,afr,mic_nongavi
zaf,South Africa,2013,dtp1,81,1134148,918660,215488,afr,mic_nongavi
zaf,South Africa,2013,mcv1,66,1134148,748538,385610,afr,mic_nongavi
zaf,South Africa,2013,mcv2,56,1113722,623684,490038,afr,mic_nongavi
zaf,South Africa,2014,dtp3,77,1136998,875488,261510,afr,mic_nongavi
zaf,South Africa,2014,mcv1,71,1136998,807269,329729,afr,mic_nongavi
zaf,South Africa,2014,dtp1,85,1136998,966448,170550,afr,mic_nongavi
zaf,South Africa,2014,mcv2,62,1124615,697261,427354,afr,mic_nongavi
zaf,South Africa,2015,mcv1,76,1137763,864700,273063,afr,mic_nongavi
zaf,South Africa,2015,dtp3,75,1137763,853322,284441,afr,mic_nongavi
zaf,South Africa,2015,dtp1,83,1137763,944343,193420,afr,mic_nongavi
zaf,South Africa,2015,mcv2,66,1132596,747513,385083,afr,mic_nongavi
zaf,South Africa,2016,dtp3,66,1136666,750200,386466,afr,mic_nongavi
zaf,South Africa,2016,dtp1,78,1136666,886599,250067,afr,mic_nongavi
zaf,South Africa,2016,mcv1,75,1136666,852500,284166,afr,mic_nongavi
zaf,South Africa,2016,mcv2,70,1143823,800676,343147,afr,mic_nongavi
zmb,Zambia,2000,dtp3,85,428807,364486,64321,afr,gavi
zmb,Zambia,2000,mcv1,85,428807,364486,64321,afr,gavi
zmb,Zambia,2000,dtp1,94,428807,403079,25728,afr,gavi
zmb,Zambia,2001,dtp3,85,440268,374228,66040,afr,gavi
zmb,Zambia,2001,dtp1,94,440268,413852,26416,afr,gavi
zmb,Zambia,2001,mcv1,84,440268,369825,70443,afr,gavi
zmb,Zambia,2002,dtp1,94,451203,424131,27072,afr,gavi
zmb,Zambia,2002,mcv1,84,451203,379011,72192,afr,gavi
zmb,Zambia,2002,dtp3,84,451203,379011,72192,afr,gavi
zmb,Zambia,2003,dtp1,93,461584,429273,32311,afr,gavi
zmb,Zambia,2003,mcv1,84,461584,387731,73853,afr,gavi
zmb,Zambia,2003,dtp3,83,461584,383115,78469,afr,gavi
zmb,Zambia,2004,dtp1,93,471432,438432,33000,afr,gavi
zmb,Zambia,2004,mcv1,85,471432,400717,70715,afr,gavi
zmb,Zambia,2004,dtp3,83,471432,391289,80143,afr,gavi
zmb,Zambia,2005,dtp1,92,480831,442365,38466,afr,gavi
zmb,Zambia,2005,dtp3,82,480831,394281,86550,afr,gavi
zmb,Zambia,2005,mcv1,85,480831,408706,72125,afr,gavi
zmb,Zambia,2006,dtp3,81,489933,396846,93087,afr,gavi
zmb,Zambia,2006,mcv1,85,489933,416443,73490,afr,gavi
zmb,Zambia,2006,dtp1,92,489933,450738,39195,afr,gavi
zmb,Zambia,2007,dtp3,80,499006,399205,99801,afr,gavi
zmb,Zambia,2007,mcv1,93,499006,464076,34930,afr,gavi
zmb,Zambia,2007,dtp1,93,499006,464076,34930,afr,gavi
zmb,Zambia,2008,dtp3,87,508306,442226,66080,afr,gavi
zmb,Zambia,2008,dtp1,95,508306,482891,25415,afr,gavi
zmb,Zambia,2008,mcv1,87,508306,442226,66080,afr,gavi
zmb,Zambia,2009,dtp1,96,518011,497291,20720,afr,gavi
zmb,Zambia,2009,mcv1,90,518011,466210,51801,afr,gavi
zmb,Zambia,2009,dtp3,94,518011,486930,31081,afr,gavi
zmb,Zambia,2010,dtp1,92,528292,486029,42263,afr,gavi
zmb,Zambia,2010,mcv1,96,528292,507160,21132,afr,gavi
zmb,Zambia,2010,dtp3,83,528292,438482,89810,afr,gavi
zmb,Zambia,2011,mcv1,83,539259,447585,91674,afr,gavi
zmb,Zambia,2011,dtp1,87,539259,469155,70104,afr,gavi
zmb,Zambia,2011,dtp3,81,539259,436800,102459,afr,gavi
zmb,Zambia,2012,dtp3,78,550889,429693,121196,afr,gavi
zmb,Zambia,2012,mcv1,82,550889,451729,99160,afr,gavi
zmb,Zambia,2012,dtp1,86,550889,473765,77124,afr,gavi
zmb,Zambia,2013,dtp3,79,563137,444878,118259,afr,gavi
zmb,Zambia,2013,dtp1,86,563137,484298,78839,afr,gavi
zmb,Zambia,2013,mcv1,80,563137,450510,112627,afr,gavi
zmb,Zambia,2014,dtp3,86,575992,495353,80639,afr,gavi
zmb,Zambia,2014,mcv1,85,575992,489593,86399,afr,gavi
zmb,Zambia,2014,dtp1,96,575992,552952,23040,afr,gavi
zmb,Zambia,2014,mcv2,33,536410,177015,359395,afr,gavi
zmb,Zambia,2015,mcv1,90,589418,530476,58942,afr,gavi
zmb,Zambia,2015,dtp3,90,589418,530476,58942,afr,gavi
zmb,Zambia,2015,dtp1,97,589418,571735,17683,afr,gavi
zmb,Zambia,2015,mcv2,47,548603,257843,290760,afr,gavi
zmb,Zambia,2016,dtp3,91,603358,549056,54302,afr,gavi
zmb,Zambia,2016,dtp1,99,603358,597324,6034,afr,gavi
zmb,Zambia,2016,mcv1,93,603358,561123,42235,afr,gavi
zmb,Zambia,2016,mcv2,58,562823,326437,236386,afr,gavi
zwe,Zimbabwe,2000,dtp3,78,380650,296907,83743,afr,gavi
zwe,Zimbabwe,2000,mcv1,75,380650,285488,95162,afr,gavi
zwe,Zimbabwe,2000,dtp1,84,380650,319746,60904,afr,gavi
zwe,Zimbabwe,2001,dtp3,75,386676,290007,96669,afr,gavi
zwe,Zimbabwe,2001,dtp1,83,386676,320941,65735,afr,gavi
zwe,Zimbabwe,2001,mcv1,73,386676,282273,104403,afr,gavi
zwe,Zimbabwe,2002,dtp1,81,393992,319134,74858,afr,gavi
zwe,Zimbabwe,2002,mcv1,70,393992,275794,118198,afr,gavi
zwe,Zimbabwe,2002,dtp3,71,393992,279734,114258,afr,gavi
zwe,Zimbabwe,2003,dtp1,79,402533,318001,84532,afr,gavi
zwe,Zimbabwe,2003,mcv1,68,402533,273722,128811,afr,gavi
zwe,Zimbabwe,2003,dtp3,68,402533,273722,128811,afr,gavi
zwe,Zimbabwe,2004,dtp1,77,412188,317385,94803,afr,gavi
zwe,Zimbabwe,2004,mcv1,66,412188,272044,140144,afr,gavi
zwe,Zimbabwe,2004,dtp3,65,412188,267922,144266,afr,gavi
zwe,Zimbabwe,2005,dtp1,80,422930,338344,84586,afr,gavi
zwe,Zimbabwe,2005,dtp3,68,422930,287592,135338,afr,gavi
zwe,Zimbabwe,2005,mcv1,67,422930,283363,139567,afr,gavi
zwe,Zimbabwe,2006,dtp3,70,434719,304303,130416,afr,gavi
zwe,Zimbabwe,2006,mcv1,68,434719,295609,139110,afr,gavi
zwe,Zimbabwe,2006,dtp1,83,434719,360817,73902,afr,gavi
zwe,Zimbabwe,2007,dtp3,73,447223,326473,120750,afr,gavi
zwe,Zimbabwe,2007,mcv1,69,447223,308584,138639,afr,gavi
zwe,Zimbabwe,2007,dtp1,86,447223,384612,62611,afr,gavi
zwe,Zimbabwe,2008,dtp3,75,459966,344974,114992,afr,gavi
zwe,Zimbabwe,2008,dtp1,89,459966,409370,50596,afr,gavi
zwe,Zimbabwe,2008,mcv1,70,459966,321976,137990,afr,gavi
zwe,Zimbabwe,2009,dtp1,87,472438,411021,61417,afr,gavi
zwe,Zimbabwe,2009,mcv1,76,472438,359053,113385,afr,gavi
zwe,Zimbabwe,2009,dtp3,73,472438,344880,127558,afr,gavi
zwe,Zimbabwe,2010,dtp1,95,483923,459727,24196,afr,gavi
zwe,Zimbabwe,2010,mcv1,90,483923,435531,48392,afr,gavi
zwe,Zimbabwe,2010,dtp3,89,483923,430691,53232,afr,gavi
zwe,Zimbabwe,2011,mcv1,92,493717,454220,39497,afr,gavi
zwe,Zimbabwe,2011,dtp1,99,493717,488780,4937,afr,gavi
zwe,Zimbabwe,2011,dtp3,93,493717,459157,34560,afr,gavi
zwe,Zimbabwe,2012,dtp3,95,501488,476414,25074,afr,gavi
zwe,Zimbabwe,2012,mcv1,97,501488,486443,15045,afr,gavi
zwe,Zimbabwe,2012,dtp1,99,501488,496473,5015,afr,gavi
zwe,Zimbabwe,2013,dtp3,95,507105,481750,25355,afr,gavi
zwe,Zimbabwe,2013,dtp1,98,507105,496963,10142,afr,gavi
zwe,Zimbabwe,2013,mcv1,93,507105,471608,35497,afr,gavi
zwe,Zimbabwe,2014,dtp3,91,510578,464626,45952,afr,gavi
zwe,Zimbabwe,2014,mcv1,92,510578,469732,40846,afr,gavi
zwe,Zimbabwe,2014,dtp1,98,510578,500366,10212,afr,gavi
zwe,Zimbabwe,2015,mcv1,86,512130,440432,71698,afr,gavi
zwe,Zimbabwe,2015,dtp3,87,512130,445553,66577,afr,gavi
zwe,Zimbabwe,2015,dtp1,94,512130,481402,30728,afr,gavi
zwe,Zimbabwe,2016,dtp3,90,512200,460980,51220,afr,gavi
zwe,Zimbabwe,2016,dtp1,94,512200,481468,30732,afr,gavi
zwe,Zimbabwe,2016,mcv1,95,512200,486590,25610,afr,gavi
zwe,Zimbabwe,2016,mcv2,63,510980,321917,189063,afr,gavi
