Group,Affiliation,Year,Vaccine,Target,Vaccinated,Coverage,Unvaccinated
Global,Global,1980,bcg,118869073,18195486,15,100673587
Global,Global,1980,dtp1,115990758,36302200,31,79688558
Global,Global,1980,mcv1,115990758,20112131,17,95878627
Global,Global,1980,pol3,115990758,26044480,22,89946278
Global,Global,1980,rcv1,115990758,3484807,3,112505951
Global,Global,1980,dtp3,115990758,24412665,21,91578093
Global,Global,1981,bcg,120692994,25551709,21,95141285
Global,Global,1981,dtp1,117979001,42939105,36,75039896
Global,Global,1981,dtp3,117979001,28798352,24,89180649
Global,Global,1981,mcv1,117979001,23682807,20,94296194
Global,Global,1981,pol3,117979001,28041620,24,89937381
Global,Global,1981,rcv1,117979001,4049758,3,113929243
Global,Global,1982,bcg,122809323,28131850,23,94677473
Global,Global,1982,dtp3,120250647,31749989,26,88500658
Global,Global,1982,mcv1,120250647,25388784,21,94861863
Global,Global,1982,dtp1,120250647,47034286,39,73216361
Global,Global,1982,pol3,120250647,50217195,42,70033452
Global,Global,1982,rcv1,120250647,4398465,4,115852182
Global,Global,1983,bcg,124969461,46104397,37,78865064
Global,Global,1983,dtp3,122653829,47621076,39,75032753
Global,Global,1983,dtp1,122653829,69261452,56,53392377
Global,Global,1983,rcv1,122653829,5350796,4,117303033
Global,Global,1983,pol3,122653829,54145525,44,68508304
Global,Global,1983,mcv1,122653829,46328144,38,76325685
Global,Global,1984,bcg,127214645,56330350,44,70884295
Global,Global,1984,dtp3,125044962,56524392,45,68520570
Global,Global,1984,pol3,125044962,59878336,48,65166626
Global,Global,1984,mcv1,125044962,52657278,42,72387684
Global,Global,1984,rcv1,125044962,5929076,5,119115886
Global,Global,1984,dtp1,125044962,78552522,63,46492440
Global,Global,1985,bcg,129180402,63243503,49,65936899
Global,Global,1985,pol3,127210461,66542737,52,60667724
Global,Global,1985,dtp3,127210461,63171984,50,64038477
Global,Global,1985,dtp1,127210461,85807425,67,41403036
Global,Global,1985,hepb3,127210461,0,0,127210461
Global,Global,1985,mcv1,127210461,60948050,48,66262411
Global,Global,1985,rcv1,127210461,6480233,5,120730228
Global,Global,1986,bcg,130750242,68971392,53,61778850
Global,Global,1986,dtp3,128931742,67302333,52,61629409
Global,Global,1986,pol3,128931742,65795591,51,63136151
Global,Global,1986,rcv1,128931742,6829410,5,122102332
Global,Global,1986,dtp1,128931742,90507268,70,38424474
Global,Global,1986,hepb3,128931742,0,0,128931742
Global,Global,1986,mcv1,128931742,60608683,47,68323059
Global,Global,1987,bcg,131757227,80912600,61,50844627
Global,Global,1987,dtp1,130097073,96644264,74,33452809
Global,Global,1987,hepb3,130097073,0,0,130097073
Global,Global,1987,dtp3,130097073,72590495,56,57506578
Global,Global,1987,rcv1,130097073,6741146,5,123355927
Global,Global,1987,pol3,130097073,74585716,57,55511357
Global,Global,1987,mcv1,130097073,70200803,54,59896270
Global,Global,1988,bcg,132143546,88347551,67,43795995
Global,Global,1988,dtp3,130650714,83445271,64,47205443
Global,Global,1988,mcv1,130650714,82113172,63,48537542
Global,Global,1988,dtp1,130650714,103671122,79,26979592
Global,Global,1988,hepb3,130650714,0,0,130650714
Global,Global,1988,pol3,130650714,84930237,65,45720477
Global,Global,1988,rcv1,130650714,8039857,6,122610857
Global,Global,1989,bcg,131915185,93119222,71,38795963
Global,Global,1989,dtp3,130598206,89281162,68,41317044
Global,Global,1989,pol3,130598206,92032105,70,38566101
Global,Global,1989,dtp1,130598206,108962412,83,21635794
Global,Global,1989,mcv1,130598206,88820903,68,41777303
Global,Global,1989,rcv1,130598206,9398343,7,121199863
Global,Global,1989,hepb3,130598206,340837,0,130257369
Global,Global,1990,bcg,131050078,106404411,81,24645667
Global,Global,1990,pol3,130003518,97943124,75,32060394
Global,Global,1990,rcv1,130003518,9911990,8,120091528
Global,Global,1990,hib3,130003518,0,0,130003518
Global,Global,1990,dtp3,130003518,98022285,75,31981233
Global,Global,1990,mcv1,130003518,95050613,73,34952905
Global,Global,1990,dtp1,130003518,114772540,88,15230978
Global,Global,1990,hepb3,130003518,882004,1,129121514
Global,Global,1991,bcg,129914584,101735743,78,28178841
Global,Global,1991,dtp3,129047709,92457059,72,36590650
Global,Global,1991,hib3,129047709,556332,0,128491377
Global,Global,1991,rcv1,129047709,10950334,8,118097375
Global,Global,1991,dtp1,129047709,110534639,86,18513070
Global,Global,1991,pol3,129047709,92599738,72,36447971
Global,Global,1991,mcv1,129047709,89093206,69,39954503
Global,Global,1991,hepb3,129047709,1679631,1,127368078
Global,Global,1992,bcg,127143570,99537243,78,27606327
Global,Global,1992,hib3,126283600,764169,1,125519431
Global,Global,1992,rcv1,126283600,10905163,9,115378437
Global,Global,1992,dtp1,126283600,107377749,85,18905851
Global,Global,1992,mcv1,126283600,87100623,69,39182977
Global,Global,1992,hepb3,126283600,3398029,3,122885571
Global,Global,1992,pol3,126283600,88627589,70,37656011
Global,Global,1992,dtp3,126283600,88433738,70,37849862
Global,Global,1993,bcg,126049335,99773874,79,26275461
Global,Global,1993,hib3,125355867,1564998,1,123790869
Global,Global,1993,mcv1,125355867,87478978,70,37876889
Global,Global,1993,pol3,125355867,88364531,70,36991336
Global,Global,1993,dtp1,125355867,106535703,85,18820164
Global,Global,1993,rcv1,125355867,11951897,10,113403970
Global,Global,1993,hepb3,125355867,5608435,4,119747432
Global,Global,1993,dtp3,125355867,88054071,70,37301796
Global,Global,1994,bcg,123619374,98526477,80,25092897
Global,Global,1994,hepb3,124320555,9442474,8,114878081
Global,Global,1994,rcv1,124320555,12574975,10,111745580
Global,Global,1994,mcv1,124320555,88888734,71,35431821
Global,Global,1994,hib3,124320555,1697519,1,122623036
Global,Global,1994,dtp1,124320555,106557148,86,17763407
Global,Global,1994,pol3,124320555,90891963,73,33428592
Global,Global,1994,dtp3,124320555,90418463,73,33902092
Global,Global,1995,bcg,122018461,98262955,81,23755506
Global,Global,1995,hepb3,123528613,14175238,11,109353375
Global,Global,1995,dtp3,123528613,90256990,73,33271623
Global,Global,1995,dtp1,123528613,106964331,87,16564282
Global,Global,1995,mcv1,123528613,90647550,73,32881063
Global,Global,1995,hib3,123528613,5310217,4,118218396
Global,Global,1995,rcv1,123528613,14498403,12,109030210
Global,Global,1995,pol3,123528613,91129941,74,32398672
Global,Global,1996,bcg,121366936,97435977,80,23930959
Global,Global,1996,pol3,123033544,90733595,74,32299949
Global,Global,1996,dtp1,123033544,105431524,86,17602020
Global,Global,1996,rcv1,123033544,14955325,12,108078219
Global,Global,1996,hib3,123033544,5942410,5,117091134
Global,Global,1996,dtp3,123033544,88980481,72,34053063
Global,Global,1996,hepb3,123033544,16699803,14,106333741
Global,Global,1996,mcv1,123033544,90057123,73,32976421
Global,Global,1997,bcg,120968289,94398499,78,26569790
Global,Global,1997,dtp1,122800469,105978250,86,16822219
Global,Global,1997,hepb3,122800469,18063239,15,104737230
Global,Global,1997,dtp3,122800469,87705849,71,35094620
Global,Global,1997,pol3,122800469,90257234,73,32543235
Global,Global,1997,mcv1,122800469,87354076,71,35446393
Global,Global,1997,rcv1,122800469,15365168,13,107435301
Global,Global,1997,hib3,122800469,6560968,5,116239501
Global,Global,1998,bcg,120795914,95098899,79,25697015
Global,Global,1998,dtp3,122795186,88040115,72,34755071
Global,Global,1998,dtp1,122795186,103279960,84,19515226
Global,Global,1998,hib3,122795186,8717121,7,114078065
Global,Global,1998,rcv1,122795186,18768166,15,104027020
Global,Global,1998,pol3,122795186,89665201,73,33129985
Global,Global,1998,mcv1,122795186,86850586,71,35944600
Global,Global,1998,hepb3,122795186,19044897,16,103750289
Global,Global,1999,bcg,120847956,96346900,80,24501056
Global,Global,1999,pol3,123023374,90001647,73,33021727
Global,Global,1999,dtp3,123023374,88206805,72,34816569
Global,Global,1999,dtp1,123023374,101804244,83,21219130
Global,Global,1999,hib3,123023374,9796965,8,113226409
Global,Global,1999,rcv1,123023374,20743853,17,102279521
Global,Global,1999,hepb3,123023374,22739957,18,100283417
Global,Global,1999,mcv1,123023374,87833409,71,35189965
Global,Global,2000,bcg,121122195,97123939,80,23998256
Global,Global,2000,hepbb,130492208,7585324,6,122906884
Global,Global,2000,pol3,123487062,90433245,73,33053817
Global,Global,2000,rcv1,123487062,26072852,21,97414210
Global,Global,2000,dtp1,123487062,102349638,83,21137424
Global,Global,2000,dtp3,123487062,89510516,72,33976546
Global,Global,2000,hib3,123487062,16802861,14,106684201
Global,Global,2000,mcv1,123487062,88958581,72,34528481
Global,Global,2000,hepb3,123487062,36394169,29,87092893
Global,Global,2000,mcv2,121372962,18328408,15,103044554
Global,Global,2001,hepbb,130993072,8433154,6,122559918
Global,Global,2001,bcg,121604132,97689782,80,23914350
Global,Global,2001,dtp3,124175959,90751902,73,33424057
Global,Global,2001,pol3,124175959,91502107,74,32673852
Global,Global,2001,mcv1,124175959,90270125,73,33905834
Global,Global,2001,dtp1,124175959,103425394,83,20750565
Global,Global,2001,hib3,124175959,17755682,14,106420277
Global,Global,2001,rcv1,124175959,27542016,22,96633943
Global,Global,2001,hepb3,124175959,39638227,32,84537732
Global,Global,2001,mcv2,122395881,21020755,17,101375126
Global,Global,2002,bcg,122449262,98473188,80,23976074
Global,Global,2002,hepbb,131676989,10325043,8,121351946
Global,Global,2002,dtp3,125079687,91159542,73,33920145
Global,Global,2002,hib3,125079687,21549195,17,103530492
Global,Global,2002,mcv1,125079687,90477836,72,34601851
Global,Global,2002,dtp1,125079687,103978636,83,21101051
Global,Global,2002,pol3,125079687,93310140,75,31769547
Global,Global,2002,hepb3,125079687,47368413,38,77711274
Global,Global,2002,rcv1,125079687,27735895,22,97343792
Global,Global,2002,mcv2,123478276,21540790,17,101937486
Global,Global,2003,bcg,123207724,100240622,81,22967102
Global,Global,2003,hepbb,132489051,12631332,10,119857719
Global,Global,2003,hib3,126071635,22721582,18,103350053
Global,Global,2003,hepb3,126071635,55752176,44,70319459
Global,Global,2003,mcv1,126071635,93164153,74,32907482
Global,Global,2003,pol3,126071635,95079964,75,30991671
Global,Global,2003,dtp3,126071635,93945545,75,32126090
Global,Global,2003,rcv1,126071635,28583039,23,97488596
Global,Global,2003,dtp1,126071635,106021814,84,20049821
Global,Global,2003,mcv2,122424772,22495189,18,99929583
Global,Global,2004,bcg,124039231,102706206,83,21333025
Global,Global,2004,hepbb,133384097,28219183,21,105164914
Global,Global,2004,hib3,127142751,24724857,19,102417894
Global,Global,2004,pol3,127142751,96641569,76,30501182
Global,Global,2004,mcv1,127142751,96553783,76,30588968
Global,Global,2004,rcv1,127142751,30798681,24,96344070
Global,Global,2004,hepb3,127142751,61912135,49,65230616
Global,Global,2004,dtp3,127142751,97164577,76,29978174
Global,Global,2004,dtp1,127142751,108212360,85,18930391
Global,Global,2004,mcv2,123411295,24246194,20,99165101
Global,Global,2005,bcg,124893498,105906666,85,18986832
Global,Global,2005,hepbb,134320202,30391662,23,103928540
Global,Global,2005,mcv1,128251232,99504568,78,28746664
Global,Global,2005,dtp1,128251232,111209849,87,17041383
Global,Global,2005,rcv1,128251232,31054323,24,97196909
Global,Global,2005,pol3,128251232,100969172,79,27282060
Global,Global,2005,hepb3,128251232,69471147,54,58780085
Global,Global,2005,hib3,128251232,26292331,21,101958901
Global,Global,2005,dtp3,128251232,99844655,78,28406577
Global,Global,2005,mcv2,124296184,37590079,30,86706105
Global,Global,2006,hepbb,135264517,31057857,23,104206660
Global,Global,2006,bcg,125838868,108824694,86,17014174
Global,Global,2006,rcv1,129364516,33256402,26,96108114
Global,Global,2006,hib3,129364516,27681296,21,101683220
Global,Global,2006,pol3,129364516,103801856,80,25562660
Global,Global,2006,mcv1,129364516,102643120,79,26721396
Global,Global,2006,dtp3,129364516,102514956,79,26849560
Global,Global,2006,rotac,129364516,1627442,1,127737074
Global,Global,2006,hepb3,129364516,75689983,59,53674533
Global,Global,2006,dtp1,129364516,113311780,88,16052736
Global,Global,2006,mcv2,125725060,40741155,32,84983905
Global,Global,2007,hepbb,136193437,32216105,24,103977332
Global,Global,2007,bcg,127795933,111558584,87,16237349
Global,Global,2007,hib3,130458972,32547877,25,97911095
Global,Global,2007,rotac,130458972,2852964,2,127606008
Global,Global,2007,hepb3,130458972,83438508,64,47020464
Global,Global,2007,dtp3,130458972,103988085,80,26470887
Global,Global,2007,mcv1,130458972,104292095,80,26166877
Global,Global,2007,pol3,130458972,106189549,81,24269423
Global,Global,2007,dtp1,130458972,115007094,88,15451878
Global,Global,2007,rcv1,130458972,33627996,26,96830976
Global,Global,2007,mcv2,126989900,42040195,33,84949705
Global,Global,2008,bcg,127887814,112813566,88,15074248
Global,Global,2008,hepbb,137079436,36693608,27,100385828
Global,Global,2008,rcv1,131506808,33598201,26,97908607
Global,Global,2008,hepb3,131506808,91349166,69,40157642
Global,Global,2008,dtp1,131506808,116989783,89,14517025
Global,Global,2008,pcv3,131506808,5519571,4,125987237
Global,Global,2008,hib3,131506808,36879157,28,94627651
Global,Global,2008,rotac,131506808,4785647,4,126721161
Global,Global,2008,mcv1,131506808,107190249,82,24316559
Global,Global,2008,pol3,131506808,108992922,83,22513886
Global,Global,2008,dtp3,131506808,107569867,82,23936941
Global,Global,2008,mcv2,127115624,44844856,35,82270768
Global,Global,2009,hepbb,137890204,38249236,28,99640968
Global,Global,2009,bcg,128714135,115316406,90,13397729
Global,Global,2009,rcv1,132475199,33919892,26,98555307
Global,Global,2009,dtp1,132475199,119811003,90,12664196
Global,Global,2009,hepb3,132475199,98348862,74,34126337
Global,Global,2009,rotac,132475199,8922095,7,123553104
Global,Global,2009,mcv1,132475199,110676749,84,21798450
Global,Global,2009,pol3,132475199,111947491,85,20527708
Global,Global,2009,hib3,132475199,52105069,39,80370130
Global,Global,2009,pcv3,132475199,8941373,7,123533826
Global,Global,2009,dtp3,132475199,111352771,84,21122428
Global,Global,2009,mcv2,128131239,48158591,38,79972648
Global,Global,2010,bcg,129341413,116474480,90,12866933
Global,Global,2010,hepbb,138597170,40349795,29,98247375
Global,Global,2010,pol3,133334690,113139821,85,20194869
Global,Global,2010,pcv3,133334690,14150944,11,119183746
Global,Global,2010,hib3,133334690,55363719,42,77970971
Global,Global,2010,rotac,133334690,10534265,8,122800425
Global,Global,2010,hepb3,133334690,98715359,74,34619331
Global,Global,2010,dtp1,133334690,120196424,90,13138266
Global,Global,2010,mcv1,133334690,112991830,85,20342860
Global,Global,2010,rcv1,133334690,46399778,35,86934912
Global,Global,2010,dtp3,133334690,113241350,85,20093340
Global,Global,2010,mcv2,129180182,50846720,39,78333462
Global,Global,2011,bcg,129968711,116565104,90,13403607
Global,Global,2011,hepbb,139183930,42796118,31,96387812
Global,Global,2011,dtp3,134067870,114398592,85,19669278
Global,Global,2011,pcv3,134067870,20478382,15,113589488
Global,Global,2011,dtp1,134067870,121868383,91,12199487
Global,Global,2011,pol3,134067870,113564662,85,20503208
Global,Global,2011,hib3,134067870,57285216,43,76782654
Global,Global,2011,rcv1,134067870,51083582,38,82984288
Global,Global,2011,rotac,134067870,12439731,9,121628139
Global,Global,2011,mcv1,134067870,113774013,85,20293857
Global,Global,2011,hepb3,134067870,100746460,75,33321410
Global,Global,2011,mcv2,130461050,59989804,46,70471246
Global,Global,2012,bcg,130477854,116894151,90,13583703
Global,Global,2012,hepbb,139658300,47103981,34,92554319
Global,Global,2012,pol3,134681922,113881591,85,20800331
Global,Global,2012,dtp3,134681922,114498270,85,20183652
Global,Global,2012,dtp1,134681922,121576634,90,13105288
Global,Global,2012,pcv3,134681922,25637819,19,109044103
Global,Global,2012,mcv1,134681922,113577356,84,21104566
Global,Global,2012,rcv1,134681922,53455750,40,81226172
Global,Global,2012,rotac,134681922,14930932,11,119750990
Global,Global,2012,hepb3,134681922,108329066,80,26352856
Global,Global,2012,hib3,134681922,59845344,44,74836578
Global,Global,2012,mcv2,131608133,63971632,49,67636501
Global,Global,2013,bcg,130868193,116765657,89,14102536
Global,Global,2013,hepbb,140029436,51239578,37,88789858
Global,Global,2013,hepb3,135185719,108321339,80,26864380
Global,Global,2013,pol3,135185719,114345090,85,20840629
Global,Global,2013,dtp3,135185719,114507274,85,20678445
Global,Global,2013,pcv3,135185719,34705772,26,100479947
Global,Global,2013,dtp1,135185719,122207192,90,12978527
Global,Global,2013,hib3,135185719,69189156,51,65996563
Global,Global,2013,rcv1,135185719,57438953,42,77746766
Global,Global,2013,mcv1,135185719,113514202,84,21671517
Global,Global,2013,rotac,135185719,19298968,14,115886751
Global,Global,2013,mcv2,132209014,71067659,54,61141355
Global,Global,2014,hepbb,140298692,51914894,37,88383798
Global,Global,2014,bcg,131137505,116608482,89,14529023
Global,Global,2014,hib3,135580585,75033772,55,60546813
Global,Global,2014,dtp1,135580585,122912368,91,12668217
Global,Global,2014,rcv1,135580585,60317983,44,75262602
Global,Global,2014,dtp3,135580585,115197092,85,20383493
Global,Global,2014,pcv3,135580585,43327646,32,92252939
Global,Global,2014,pol3,135580585,115238179,85,20342406
Global,Global,2014,rotac,135580585,25426144,19,110154441
Global,Global,2014,hepb3,135580585,110984372,82,24596213
Global,Global,2014,mcv1,135580585,114150888,84,21429697
Global,Global,2014,mcv2,133015521,74811022,56,58204499
Global,Global,2015,bcg,131287276,114887548,88,16399728
Global,Global,2015,hepbb,140467757,53694217,38,86773540
Global,Global,2015,hepb3,135868530,112864180,83,23004350
Global,Global,2015,hib3,135868530,86075525,63,49793005
Global,Global,2015,rcv1,135868530,63966370,47,71902160
Global,Global,2015,dtp1,135868530,122717444,90,13151086
Global,Global,2015,dtp3,135868530,115617487,85,20251043
Global,Global,2015,rotac,135868530,30925947,23,104942583
Global,Global,2015,pol3,135868530,115935266,85,19933264
Global,Global,2015,pcv3,135868530,50040685,37,85827845
Global,Global,2015,mcv1,135868530,114821327,85,21047203
Global,Global,2015,mcv2,133771348,80057294,60,53714054
Global,Global,2016,bcg,131326248,115936522,88,15389726
Global,Global,2016,hepbb,140541608,54184396,39,86357212
Global,Global,2016,pol3,136055096,115683777,85,20371319
Global,Global,2016,rotac,136055096,33595366,25,102459730
Global,Global,2016,rcv1,136055096,64368756,47,71686340
Global,Global,2016,dtp3,136055096,116530362,86,19524734
Global,Global,2016,dtp1,136055096,123162933,91,12892163
Global,Global,2016,pcv3,136055096,56498406,42,79556690
Global,Global,2016,hepb3,136055096,113912543,84,22142553
Global,Global,2016,hib3,136055096,95566083,70,40489013
Global,Global,2016,mcv1,136055096,115208071,85,20847025
Global,Global,2016,mcv2,134392384,85933883,64,48458501
WHO Regions,emr,1980,bcg,11637962,2108789,18,9529173
WHO Regions,emr,1980,dtp1,10635921,3887773,37,6748148
WHO Regions,emr,1980,mcv1,10635921,1647231,15,8988690
WHO Regions,emr,1980,pol3,10635921,2180549,21,8455372
WHO Regions,emr,1980,rcv1,10635921,5089,0,10630832
WHO Regions,emr,1980,dtp3,10635921,1922256,18,8713665
WHO Regions,emr,1981,bcg,11968985,2424308,20,9544677
WHO Regions,emr,1981,dtp1,10976791,4051934,37,6924857
WHO Regions,emr,1981,dtp3,10976791,2106274,19,8870517
WHO Regions,emr,1981,mcv1,10976791,1881187,17,9095604
WHO Regions,emr,1981,pol3,10976791,2581676,24,8395115
WHO Regions,emr,1981,rcv1,10976791,5909,0,10970882
WHO Regions,emr,1982,bcg,12293565,3357724,27,8935841
WHO Regions,emr,1982,dtp3,11313078,2787229,25,8525849
WHO Regions,emr,1982,mcv1,11313078,2605268,23,8707810
WHO Regions,emr,1982,dtp1,11313078,5132968,45,6180110
WHO Regions,emr,1982,pol3,11313078,3519334,31,7793744
WHO Regions,emr,1982,rcv1,11313078,6646,0,11306432
WHO Regions,emr,1983,bcg,12603830,4592150,36,8011680
WHO Regions,emr,1983,dtp3,11637104,3318909,29,8318195
WHO Regions,emr,1983,dtp1,11637104,5869613,50,5767491
WHO Regions,emr,1983,rcv1,11637104,7532,0,11629572
WHO Regions,emr,1983,pol3,11637104,3506856,30,8130248
WHO Regions,emr,1983,mcv1,11637104,3135315,27,8501789
WHO Regions,emr,1984,bcg,12891345,5716005,44,7175340
WHO Regions,emr,1984,dtp3,11940509,4373750,37,7566759
WHO Regions,emr,1984,pol3,11940509,4526856,38,7413653
WHO Regions,emr,1984,mcv1,11940509,4096505,34,7844004
WHO Regions,emr,1984,rcv1,11940509,8566,0,11931943
WHO Regions,emr,1984,dtp1,11940509,6929301,58,5011208
WHO Regions,emr,1985,bcg,13145179,8269196,63,4875983
WHO Regions,emr,1985,pol3,12212159,5861453,48,6350706
WHO Regions,emr,1985,dtp3,12212159,5636583,46,6575576
WHO Regions,emr,1985,dtp1,12212159,8107776,66,4104383
WHO Regions,emr,1985,hepb3,12212159,0,0,12212159
WHO Regions,emr,1985,mcv1,12212159,5778487,47,6433672
WHO Regions,emr,1985,rcv1,12212159,35444,0,12176715
WHO Regions,emr,1986,bcg,13355624,8565451,64,4790173
WHO Regions,emr,1986,dtp3,12441928,6358949,51,6082979
WHO Regions,emr,1986,pol3,12441928,6538195,53,5903733
WHO Regions,emr,1986,rcv1,12441928,39721,0,12402207
WHO Regions,emr,1986,dtp1,12441928,8761334,70,3680594
WHO Regions,emr,1986,hepb3,12441928,0,0,12441928
WHO Regions,emr,1986,mcv1,12441928,6253171,50,6188757
WHO Regions,emr,1987,bcg,13520835,8994680,67,4526155
WHO Regions,emr,1987,dtp1,12627415,9274707,73,3352708
WHO Regions,emr,1987,hepb3,12627415,0,0,12627415
WHO Regions,emr,1987,dtp3,12627415,6813589,54,5813826
WHO Regions,emr,1987,rcv1,12627415,42638,0,12584777
WHO Regions,emr,1987,pol3,12627415,6836325,54,5791090
WHO Regions,emr,1987,mcv1,12627415,6736150,53,5891265
WHO Regions,emr,1988,bcg,13642116,10495295,77,3146821
WHO Regions,emr,1988,dtp3,12769512,7954363,62,4815149
WHO Regions,emr,1988,mcv1,12769512,8034284,63,4735228
WHO Regions,emr,1988,dtp1,12769512,10122440,79,2647072
WHO Regions,emr,1988,hepb3,12769512,0,0,12769512
WHO Regions,emr,1988,pol3,12769512,8022927,63,4746585
WHO Regions,emr,1988,rcv1,12769512,44966,0,12724546
WHO Regions,emr,1989,bcg,13721973,11040388,80,2681585
WHO Regions,emr,1989,dtp3,12870614,8477548,66,4393066
WHO Regions,emr,1989,pol3,12870614,8487207,66,4383407
WHO Regions,emr,1989,dtp1,12870614,10537359,82,2333255
WHO Regions,emr,1989,mcv1,12870614,8452623,66,4417991
WHO Regions,emr,1989,rcv1,12870614,48595,0,12822019
WHO Regions,emr,1989,hepb3,12870614,0,0,12870614
WHO Regions,emr,1990,bcg,13764942,11433720,83,2331222
WHO Regions,emr,1990,pol3,12935592,9185402,71,3750190
WHO Regions,emr,1990,rcv1,12935592,50389,0,12885203
WHO Regions,emr,1990,hib3,12935592,0,0,12935592
WHO Regions,emr,1990,dtp3,12935592,9206063,71,3729529
WHO Regions,emr,1990,mcv1,12935592,8671188,67,4264404
WHO Regions,emr,1990,dtp1,12935592,11062705,86,1872887
WHO Regions,emr,1990,hepb3,12935592,369772,3,12565820
WHO Regions,emr,1991,bcg,13777953,11128752,81,2649201
WHO Regions,emr,1991,dtp3,12971960,8516729,66,4455231
WHO Regions,emr,1991,hib3,12971960,0,0,12971960
WHO Regions,emr,1991,rcv1,12971960,587225,5,12384735
WHO Regions,emr,1991,dtp1,12971960,10645018,82,2326942
WHO Regions,emr,1991,pol3,12971960,8700474,67,4271486
WHO Regions,emr,1991,mcv1,12971960,8633054,67,4338906
WHO Regions,emr,1991,hepb3,12971960,556476,4,12415484
WHO Regions,emr,1992,bcg,13772530,11086424,80,2686106
WHO Regions,emr,1992,hib3,12991568,0,0,12991568
WHO Regions,emr,1992,rcv1,12991568,558652,4,12432916
WHO Regions,emr,1992,dtp1,12991568,10399166,80,2592402
WHO Regions,emr,1992,mcv1,12991568,8722082,67,4269486
WHO Regions,emr,1992,hepb3,12991568,728860,6,12262708
WHO Regions,emr,1992,pol3,12991568,8477711,65,4513857
WHO Regions,emr,1992,dtp3,12991568,8307977,64,4683591
WHO Regions,emr,1993,bcg,13869432,10968224,79,2901208
WHO Regions,emr,1993,hib3,13111577,0,0,13111577
WHO Regions,emr,1993,mcv1,13111577,8812543,67,4299034
WHO Regions,emr,1993,pol3,13111577,8340661,64,4770916
WHO Regions,emr,1993,dtp1,13111577,10232179,78,2879398
WHO Regions,emr,1993,rcv1,13111577,576871,4,12534706
WHO Regions,emr,1993,hepb3,13111577,897823,7,12213754
WHO Regions,emr,1993,dtp3,13111577,8207070,63,4904507
WHO Regions,emr,1994,bcg,13862599,10753611,78,3108988
WHO Regions,emr,1994,hepb3,13132525,3247131,25,9885394
WHO Regions,emr,1994,rcv1,13132525,646795,5,12485730
WHO Regions,emr,1994,mcv1,13132525,8911465,68,4221060
WHO Regions,emr,1994,hib3,13132525,0,0,13132525
WHO Regions,emr,1994,dtp1,13132525,10108142,77,3024383
WHO Regions,emr,1994,pol3,13132525,8126834,62,5005691
WHO Regions,emr,1994,dtp3,13132525,8017649,61,5114876
WHO Regions,emr,1995,bcg,13863062,10807256,78,3055806
WHO Regions,emr,1995,hepb3,13161036,3793962,29,9367074
WHO Regions,emr,1995,dtp3,13161036,9062576,69,4098460
WHO Regions,emr,1995,dtp1,13161036,10673564,81,2487472
WHO Regions,emr,1995,mcv1,13161036,8748723,66,4412313
WHO Regions,emr,1995,hib3,13161036,0,0,13161036
WHO Regions,emr,1995,rcv1,13161036,1425827,11,11735209
WHO Regions,emr,1995,pol3,13161036,9071339,69,4089697
WHO Regions,emr,1996,bcg,13872765,10374422,75,3498343
WHO Regions,emr,1996,pol3,13197990,8845206,67,4352784
WHO Regions,emr,1996,dtp1,13197990,10419632,79,2778358
WHO Regions,emr,1996,rcv1,13197990,1440458,11,11757532
WHO Regions,emr,1996,hib3,13197990,0,0,13197990
WHO Regions,emr,1996,dtp3,13197990,8820516,67,4377474
WHO Regions,emr,1996,hepb3,13197990,4089600,31,9108390
WHO Regions,emr,1996,mcv1,13197990,9144279,69,4053711
WHO Regions,emr,1997,bcg,13891602,10350800,75,3540802
WHO Regions,emr,1997,dtp1,13242325,10458050,79,2784275
WHO Regions,emr,1997,hepb3,13242325,4587315,35,8655010
WHO Regions,emr,1997,dtp3,13242325,8935106,67,4307219
WHO Regions,emr,1997,pol3,13242325,9057750,68,4184575
WHO Regions,emr,1997,mcv1,13242325,9098771,69,4143554
WHO Regions,emr,1997,rcv1,13242325,828952,6,12413373
WHO Regions,emr,1997,hib3,13242325,9890,0,13232435
WHO Regions,emr,1998,bcg,13921925,10582066,76,3339859
WHO Regions,emr,1998,dtp3,13295702,9229501,69,4066201
WHO Regions,emr,1998,dtp1,13295702,10545877,79,2749825
WHO Regions,emr,1998,hib3,13295702,55969,0,13239733
WHO Regions,emr,1998,rcv1,13295702,831012,6,12464690
WHO Regions,emr,1998,pol3,13295702,9469144,71,3826558
WHO Regions,emr,1998,mcv1,13295702,9392259,71,3903443
WHO Regions,emr,1998,hepb3,13295702,4247268,32,9048434
WHO Regions,emr,1999,bcg,13969686,11027987,79,2941699
WHO Regions,emr,1999,pol3,13363748,9884881,74,3478867
WHO Regions,emr,1999,dtp3,13363748,9583793,72,3779955
WHO Regions,emr,1999,dtp1,13363748,10788628,81,2575120
WHO Regions,emr,1999,hib3,13363748,113009,1,13250739
WHO Regions,emr,1999,rcv1,13363748,2852759,21,10510989
WHO Regions,emr,1999,hepb3,13363748,4952636,37,8411112
WHO Regions,emr,1999,mcv1,13363748,9536754,71,3826994
WHO Regions,emr,2000,bcg,14043063,11087033,79,2956030
WHO Regions,emr,2000,hepbb,14323446,2021384,14,12302062
WHO Regions,emr,2000,pol3,13454486,10084884,75,3369602
WHO Regions,emr,2000,rcv1,13454486,3155752,23,10298734
WHO Regions,emr,2000,dtp1,13454486,11046510,82,2407976
WHO Regions,emr,2000,dtp3,13454486,9909463,74,3545023
WHO Regions,emr,2000,hib3,13454486,115188,1,13339298
WHO Regions,emr,2000,mcv1,13454486,9729327,72,3725159
WHO Regions,emr,2000,hepb3,13454486,5405774,40,8048712
WHO Regions,emr,2000,mcv2,13126586,3797711,29,9328875
WHO Regions,emr,2001,hepbb,14430928,2461538,17,11969390
WHO Regions,emr,2001,bcg,14149792,11473549,81,2676243
WHO Regions,emr,2001,dtp3,13575802,10226800,75,3349002
WHO Regions,emr,2001,pol3,13575802,10353974,76,3221828
WHO Regions,emr,2001,mcv1,13575802,9891490,73,3684312
WHO Regions,emr,2001,dtp1,13575802,11400021,84,2175781
WHO Regions,emr,2001,hib3,13575802,636612,5,12939190
WHO Regions,emr,2001,rcv1,13575802,3638788,27,9937014
WHO Regions,emr,2001,hepb3,13575802,5697407,42,7878395
WHO Regions,emr,2001,mcv2,13230970,4788533,36,8442437
WHO Regions,emr,2002,bcg,14454828,11822985,82,2631843
WHO Regions,emr,2002,hepbb,14574848,2557992,18,12016856
WHO Regions,emr,2002,dtp3,13731197,10348375,75,3382822
WHO Regions,emr,2002,hib3,13731197,1274624,9,12456573
WHO Regions,emr,2002,mcv1,13731197,10100417,74,3630780
WHO Regions,emr,2002,dtp1,13731197,11502672,84,2228525
WHO Regions,emr,2002,pol3,13731197,10465524,76,3265673
WHO Regions,emr,2002,hepb3,13731197,5898942,43,7832255
WHO Regions,emr,2002,rcv1,13731197,3638601,26,10092596
WHO Regions,emr,2002,mcv2,13335257,4740465,36,8594792
WHO Regions,emr,2003,bcg,14636397,12046866,82,2589531
WHO Regions,emr,2003,hepbb,14756022,2557598,17,12198424
WHO Regions,emr,2003,hib3,13921811,1487273,11,12434538
WHO Regions,emr,2003,hepb3,13921811,8592801,62,5329010
WHO Regions,emr,2003,mcv1,13921811,10227072,73,3694739
WHO Regions,emr,2003,pol3,13921811,10640751,76,3281060
WHO Regions,emr,2003,dtp3,13921811,10565291,76,3356520
WHO Regions,emr,2003,rcv1,13921811,3680110,26,10241701
WHO Regions,emr,2003,dtp1,13921811,11806624,85,2115187
WHO Regions,emr,2003,mcv2,13195809,4638294,35,8557515
WHO Regions,emr,2004,bcg,14854016,12094749,81,2759267
WHO Regions,emr,2004,hepbb,14973727,3437229,23,11536498
WHO Regions,emr,2004,hib3,14147158,1507706,11,12639452
WHO Regions,emr,2004,pol3,14147158,10802541,76,3344617
WHO Regions,emr,2004,mcv1,14147158,10781836,76,3365322
WHO Regions,emr,2004,rcv1,14147158,5432780,38,8714378
WHO Regions,emr,2004,hepb3,14147158,8820307,62,5326851
WHO Regions,emr,2004,dtp3,14147158,10843951,77,3303207
WHO Regions,emr,2004,dtp1,14147158,11993006,85,2154152
WHO Regions,emr,2004,mcv2,13375648,5259278,39,8116370
WHO Regions,emr,2005,bcg,15109149,12564113,83,2545036
WHO Regions,emr,2005,hepbb,15229765,3474032,23,11755733
WHO Regions,emr,2005,mcv1,14409144,11252673,78,3156471
WHO Regions,emr,2005,dtp1,14409144,12546218,87,1862926
WHO Regions,emr,2005,rcv1,14409144,5667818,39,8741326
WHO Regions,emr,2005,pol3,14409144,11760358,82,2648786
WHO Regions,emr,2005,hepb3,14409144,9818354,68,4590790
WHO Regions,emr,2005,hib3,14409144,1805439,13,12603705
WHO Regions,emr,2005,dtp3,14409144,11656315,81,2752829
WHO Regions,emr,2005,mcv2,13480420,5589969,41,7890451
WHO Regions,emr,2006,hepbb,15525095,3530339,23,11994756
WHO Regions,emr,2006,bcg,15454178,13116206,85,2337972
WHO Regions,emr,2006,rcv1,14708813,5757160,39,8951653
WHO Regions,emr,2006,hib3,14708813,1923903,13,12784910
WHO Regions,emr,2006,pol3,14708813,11883384,81,2825429
WHO Regions,emr,2006,mcv1,14708813,11418275,78,3290538
WHO Regions,emr,2006,dtp3,14708813,11874514,81,2834299
WHO Regions,emr,2006,rotac,14708813,0,0,14708813
WHO Regions,emr,2006,hepb3,14708813,10890941,74,3817872
WHO Regions,emr,2006,dtp1,14708813,13069689,89,1639124
WHO Regions,emr,2006,mcv2,13651542,5815413,43,7836129
WHO Regions,emr,2007,hepbb,15850733,3791681,24,12059052
WHO Regions,emr,2007,bcg,15778582,13437741,85,2340841
WHO Regions,emr,2007,hib3,15037578,2752436,18,12285142
WHO Regions,emr,2007,rotac,15037578,0,0,15037578
WHO Regions,emr,2007,hepb3,15037578,11901986,79,3135592
WHO Regions,emr,2007,dtp3,15037578,12208096,81,2829482
WHO Regions,emr,2007,mcv1,15037578,11625840,77,3411738
WHO Regions,emr,2007,pol3,15037578,12372963,82,2664615
WHO Regions,emr,2007,dtp1,15037578,13467431,90,1570147
WHO Regions,emr,2007,rcv1,15037578,6005501,40,9032077
WHO Regions,emr,2007,mcv2,13829332,5918040,43,7911292
WHO Regions,emr,2008,bcg,16118424,13784719,86,2333705
WHO Regions,emr,2008,hepbb,16193031,3899643,24,12293388
WHO Regions,emr,2008,rcv1,15382380,5608482,36,9773898
WHO Regions,emr,2008,hepb3,15382380,11866362,77,3516018
WHO Regions,emr,2008,dtp1,15382380,13579644,88,1802736
WHO Regions,emr,2008,pcv3,15382380,57336,0,15325044
WHO Regions,emr,2008,hib3,15382380,4066025,26,11316355
WHO Regions,emr,2008,rotac,15382380,9112,0,15373268
WHO Regions,emr,2008,mcv1,15382380,11964438,78,3417942
WHO Regions,emr,2008,pol3,15382380,12452020,81,2930360
WHO Regions,emr,2008,dtp3,15382380,12016048,78,3366332
WHO Regions,emr,2008,mcv2,14292532,5842305,41,8450227
WHO Regions,emr,2009,hepbb,16537455,3637893,22,12899562
WHO Regions,emr,2009,bcg,16459233,13873737,84,2585496
WHO Regions,emr,2009,rcv1,15729359,5970843,38,9758516
WHO Regions,emr,2009,dtp1,15729359,14092315,90,1637044
WHO Regions,emr,2009,hepb3,15729359,12743312,81,2986047
WHO Regions,emr,2009,rotac,15729359,28238,0,15701121
WHO Regions,emr,2009,mcv1,15729359,12001202,76,3728157
WHO Regions,emr,2009,pol3,15729359,12731825,81,2997534
WHO Regions,emr,2009,hib3,15729359,8268193,53,7461166
WHO Regions,emr,2009,pcv3,15729359,738771,5,14990588
WHO Regions,emr,2009,dtp3,15729359,12770949,81,2958410
WHO Regions,emr,2009,mcv2,14616245,7477752,51,7138493
WHO Regions,emr,2010,bcg,16781375,14903578,89,1877797
WHO Regions,emr,2010,hepbb,16864191,3473866,21,13390325
WHO Regions,emr,2010,pol3,16059619,13757240,86,2302379
WHO Regions,emr,2010,pcv3,16059619,841619,5,15218000
WHO Regions,emr,2010,hib3,16059619,8775941,55,7283678
WHO Regions,emr,2010,rotac,16059619,35960,0,16023659
WHO Regions,emr,2010,hepb3,16059619,13257573,83,2802046
WHO Regions,emr,2010,dtp1,16059619,14490782,90,1568837
WHO Regions,emr,2010,mcv1,16059619,12983205,81,3076414
WHO Regions,emr,2010,rcv1,16059619,6052580,38,10007039
WHO Regions,emr,2010,dtp3,16059619,13717674,85,2341945
WHO Regions,emr,2010,mcv2,14962263,8634043,58,6328220
WHO Regions,emr,2011,bcg,16670876,14474149,87,2196727
WHO Regions,emr,2011,hepbb,16758965,3403135,20,13355830
WHO Regions,emr,2011,dtp3,15991769,13232033,83,2759736
WHO Regions,emr,2011,pcv3,15991769,1329004,8,14662765
WHO Regions,emr,2011,dtp1,15991769,14228184,89,1763585
WHO Regions,emr,2011,pol3,15991769,13261711,83,2730058
WHO Regions,emr,2011,hib3,15991769,8466865,53,7524904
WHO Regions,emr,2011,rcv1,15991769,6187491,39,9804278
WHO Regions,emr,2011,rotac,15991769,900633,6,15091136
WHO Regions,emr,2011,mcv1,15991769,12599139,79,3392630
WHO Regions,emr,2011,hepb3,15991769,12963970,81,3027799
WHO Regions,emr,2011,mcv2,15050627,8966971,60,6083656
WHO Regions,emr,2012,bcg,16895835,14764211,87,2131624
WHO Regions,emr,2012,hepbb,16989406,3445118,20,13544288
WHO Regions,emr,2012,pol3,16229713,13035699,80,3194014
WHO Regions,emr,2012,dtp3,16229713,12982811,80,3246902
WHO Regions,emr,2012,dtp1,16229713,13981756,86,2247957
WHO Regions,emr,2012,pcv3,16229713,1926003,12,14303710
WHO Regions,emr,2012,mcv1,16229713,12324349,76,3905364
WHO Regions,emr,2012,rcv1,16229713,6214267,38,10015446
WHO Regions,emr,2012,rotac,16229713,2062070,13,14167643
WHO Regions,emr,2012,hepb3,16229713,12654072,78,3575641
WHO Regions,emr,2012,hib3,16229713,8797923,54,7431790
WHO Regions,emr,2012,mcv2,15443125,9166721,59,6276404
WHO Regions,emr,2013,bcg,17065286,15027240,88,2038046
WHO Regions,emr,2013,hepbb,17164097,3620068,21,13544029
WHO Regions,emr,2013,hepb3,16414272,13355127,81,3059145
WHO Regions,emr,2013,pol3,16414272,13243537,81,3170735
WHO Regions,emr,2013,dtp3,16414272,13226122,81,3188150
WHO Regions,emr,2013,pcv3,16414272,5831586,36,10582686
WHO Regions,emr,2013,dtp1,16414272,14112157,86,2302115
WHO Regions,emr,2013,hib3,16414272,9492430,58,6921842
WHO Regions,emr,2013,rcv1,16414272,6227264,38,10187008
WHO Regions,emr,2013,mcv1,16414272,12488377,76,3925895
WHO Regions,emr,2013,rotac,16414272,3180994,19,13233278
WHO Regions,emr,2013,mcv2,15680165,9813589,63,5866576
WHO Regions,emr,2014,hepbb,17279980,3609290,21,13670690
WHO Regions,emr,2014,bcg,17176475,15079214,88,2097261
WHO Regions,emr,2014,hib3,16542391,11873537,72,4668854
WHO Regions,emr,2014,dtp1,16542391,14179527,86,2362864
WHO Regions,emr,2014,rcv1,16542391,6908369,42,9634022
WHO Regions,emr,2014,dtp3,16542391,13217355,80,3325036
WHO Regions,emr,2014,pcv3,16542391,7543202,46,8999189
WHO Regions,emr,2014,pol3,16542391,13223880,80,3318511
WHO Regions,emr,2014,rotac,16542391,3251590,20,13290801
WHO Regions,emr,2014,hepb3,16542391,13212493,80,3329898
WHO Regions,emr,2014,mcv1,16542391,12457075,75,4085316
WHO Regions,emr,2014,mcv2,15994191,10418889,65,5575302
WHO Regions,emr,2015,bcg,17231689,14625213,85,2606476
WHO Regions,emr,2015,hepbb,17339084,3739400,22,13599684
WHO Regions,emr,2015,hepb3,16615822,13129082,79,3486740
WHO Regions,emr,2015,hib3,16615822,13152588,79,3463234
WHO Regions,emr,2015,rcv1,16615822,7456433,45,9159389
WHO Regions,emr,2015,dtp1,16615822,14073412,85,2542410
WHO Regions,emr,2015,dtp3,16615822,13152588,79,3463234
WHO Regions,emr,2015,rotac,16615822,3540462,21,13075360
WHO Regions,emr,2015,pol3,16615822,13162552,79,3453270
WHO Regions,emr,2015,pcv3,16615822,7859089,47,8756733
WHO Regions,emr,2015,mcv1,16615822,12503125,75,4112697
WHO Regions,emr,2015,mcv2,16238241,10920528,67,5317713
WHO Regions,emr,2016,bcg,17239304,15074849,87,2164455
WHO Regions,emr,2016,hepbb,17349642,3832850,22,13516792
WHO Regions,emr,2016,pol3,16642238,13299828,80,3342410
WHO Regions,emr,2016,rotac,16642238,3790728,23,12851510
WHO Regions,emr,2016,rcv1,16642238,7585955,46,9056283
WHO Regions,emr,2016,dtp3,16642238,13302629,80,3339609
WHO Regions,emr,2016,dtp1,16642238,14125993,85,2516245
WHO Regions,emr,2016,pcv3,16642238,7965749,48,8676489
WHO Regions,emr,2016,hepb3,16642238,13310922,80,3331316
WHO Regions,emr,2016,hib3,16642238,13302629,80,3339609
WHO Regions,emr,2016,mcv1,16642238,12737655,77,3904583
WHO Regions,emr,2016,mcv2,16508731,11380156,69,5128575
WHO Regions,afr,1980,bcg,17594132,1627140,9,15966992
WHO Regions,afr,1980,mcv1,15528226,929471,6,14598755
WHO Regions,afr,1980,pol3,15528226,879371,6,14648855
WHO Regions,afr,1980,dtp1,15528226,1166069,8,14362157
WHO Regions,afr,1980,rcv1,15528226,0,0,15528226
WHO Regions,afr,1980,dtp3,15528226,785571,5,14742655
WHO Regions,afr,1981,bcg,18016352,4288741,24,13727611
WHO Regions,afr,1981,dtp3,15928208,1734035,11,14194173
WHO Regions,afr,1981,mcv1,15928208,1914037,12,14014171
WHO Regions,afr,1981,pol3,15928208,1758735,11,14169473
WHO Regions,afr,1981,rcv1,15928208,519,0,15927689
WHO Regions,afr,1981,dtp1,15928208,3232606,20,12695602
WHO Regions,afr,1982,bcg,18438264,4535572,25,13902692
WHO Regions,afr,1982,dtp1,16326807,3602798,22,12724009
WHO Regions,afr,1982,dtp3,16326807,1899071,12,14427736
WHO Regions,afr,1982,rcv1,16326807,1142,0,16325665
WHO Regions,afr,1982,pol3,16326807,2093946,13,14232861
WHO Regions,afr,1982,mcv1,16326807,2271805,14,14055002
WHO Regions,afr,1983,bcg,18859389,6048395,32,12810994
WHO Regions,afr,1983,dtp3,16723409,3062542,18,13660867
WHO Regions,afr,1983,pol3,16723409,3212303,19,13511106
WHO Regions,afr,1983,mcv1,16723409,3491985,21,13231424
WHO Regions,afr,1983,rcv1,16723409,1737,0,16721672
WHO Regions,afr,1983,dtp1,16723409,5207967,31,11515442
WHO Regions,afr,1984,bcg,19279306,6815818,35,12463488
WHO Regions,afr,1984,dtp3,17117326,4144175,24,12973151
WHO Regions,afr,1984,mcv1,17117326,4406066,26,12711260
WHO Regions,afr,1984,rcv1,17117326,1352,0,17115974
WHO Regions,afr,1984,dtp1,17117326,7274455,42,9842871
WHO Regions,afr,1984,pol3,17117326,4100698,24,13016628
WHO Regions,afr,1985,bcg,19696837,8998048,46,10698789
WHO Regions,afr,1985,dtp1,17506342,9194820,53,8311522
WHO Regions,afr,1985,dtp3,17506342,5584876,32,11921466
WHO Regions,afr,1985,rcv1,17506342,1566,0,17504776
WHO Regions,afr,1985,hepb3,17506342,0,0,17506342
WHO Regions,afr,1985,mcv1,17506342,6134282,35,11372060
WHO Regions,afr,1985,pol3,17506342,5538695,32,11967647
WHO Regions,afr,1986,bcg,20110892,10397310,52,9713582
WHO Regions,afr,1986,dtp1,17888122,10337943,58,7550179
WHO Regions,afr,1986,mcv1,17888122,7479729,42,10408393
WHO Regions,afr,1986,pol3,17888122,6599870,37,11288252
WHO Regions,afr,1986,dtp3,17888122,6580288,37,11307834
WHO Regions,afr,1986,hepb3,17888122,0,0,17888122
WHO Regions,afr,1986,rcv1,17888122,1635,0,17886487
WHO Regions,afr,1987,bcg,20522543,12058205,59,8464338
WHO Regions,afr,1987,rcv1,18263604,1617,0,18261987
WHO Regions,afr,1987,pol3,18263604,7795156,43,10468448
WHO Regions,afr,1987,hepb3,18263604,0,0,18263604
WHO Regions,afr,1987,mcv1,18263604,8375500,46,9888104
WHO Regions,afr,1987,dtp3,18263604,7818120,43,10445484
WHO Regions,afr,1987,dtp1,18263604,11570444,63,6693160
WHO Regions,afr,1988,bcg,20933977,12748587,61,8185390
WHO Regions,afr,1988,hepb3,18635639,0,0,18635639
WHO Regions,afr,1988,mcv1,18635639,9326756,50,9308883
WHO Regions,afr,1988,dtp3,18635639,8578321,46,10057318
WHO Regions,afr,1988,pol3,18635639,8507044,46,10128595
WHO Regions,afr,1988,dtp1,18635639,12400501,67,6235138
WHO Regions,afr,1988,rcv1,18635639,1499,0,18634140
WHO Regions,afr,1989,bcg,21347766,14403868,67,6943898
WHO Regions,afr,1989,dtp3,19008069,9714699,51,9293370
WHO Regions,afr,1989,pol3,19008069,9667515,51,9340554
WHO Regions,afr,1989,mcv1,19008069,10633470,56,8374599
WHO Regions,afr,1989,rcv1,19008069,1484,0,19006585
WHO Regions,afr,1989,dtp1,19008069,13631353,72,5376716
WHO Regions,afr,1989,hepb3,19008069,0,0,19008069
WHO Regions,afr,1990,bcg,21767703,16249522,75,5518181
WHO Regions,afr,1990,pol3,19386583,11178802,58,8207781
WHO Regions,afr,1990,hib3,19386583,0,0,19386583
WHO Regions,afr,1990,rcv1,19386583,1419,0,19385164
WHO Regions,afr,1990,dtp3,19386583,11106845,57,8279738
WHO Regions,afr,1990,hepb3,19386583,0,0,19386583
WHO Regions,afr,1990,mcv1,19386583,11183209,58,8203374
WHO Regions,afr,1990,dtp1,19386583,14896479,77,4490104
WHO Regions,afr,1991,bcg,22252730,14222978,64,8029752
WHO Regions,afr,1991,dtp3,19828908,9816578,50,10012330
WHO Regions,afr,1991,mcv1,19828908,10771384,54,9057524
WHO Regions,afr,1991,pol3,19828908,10079468,51,9749440
WHO Regions,afr,1991,rcv1,19828908,1451,0,19827457
WHO Regions,afr,1991,dtp1,19828908,13727743,69,6101165
WHO Regions,afr,1991,hepb3,19828908,31964,0,19796944
WHO Regions,afr,1991,hib3,19828908,0,0,19828908
WHO Regions,afr,1992,bcg,22697107,14568187,64,8128920
WHO Regions,afr,1992,dtp3,20238343,10167064,50,10071279
WHO Regions,afr,1992,hepb3,20238343,0,0,20238343
WHO Regions,afr,1992,rcv1,20238343,1479,0,20236864
WHO Regions,afr,1992,hib3,20238343,0,0,20238343
WHO Regions,afr,1992,dtp1,20238343,14142328,70,6096015
WHO Regions,afr,1992,mcv1,20238343,10380685,51,9857658
WHO Regions,afr,1992,pol3,20238343,10132492,50,10105851
WHO Regions,afr,1993,bcg,23277134,15338570,66,7938564
WHO Regions,afr,1993,rcv1,20778498,1455,0,20777043
WHO Regions,afr,1993,hepb3,20778498,24346,0,20754152
WHO Regions,afr,1993,dtp1,20778498,14608767,70,6169731
WHO Regions,afr,1993,hib3,20778498,0,0,20778498
WHO Regions,afr,1993,pol3,20778498,10306694,50,10471804
WHO Regions,afr,1993,mcv1,20778498,10853630,52,9924868
WHO Regions,afr,1993,dtp3,20778498,10420654,50,10357844
WHO Regions,afr,1994,bcg,23750592,16500753,69,7249839
WHO Regions,afr,1994,rcv1,21231389,1431,0,21229958
WHO Regions,afr,1994,hib3,21231389,0,0,21231389
WHO Regions,afr,1994,hepb3,21231389,25476,0,21205913
WHO Regions,afr,1994,dtp1,21231389,15908781,75,5322608
WHO Regions,afr,1994,mcv1,21231389,11856006,56,9375383
WHO Regions,afr,1994,pol3,21231389,11755109,55,9476280
WHO Regions,afr,1994,dtp3,21231389,11692980,55,9538409
WHO Regions,afr,1995,bcg,24239951,16367267,68,7872684
WHO Regions,afr,1995,hepb3,21708358,77506,0,21630852
WHO Regions,afr,1995,hib3,21708358,0,0,21708358
WHO Regions,afr,1995,dtp3,21708358,11739595,54,9968763
WHO Regions,afr,1995,rcv1,21708358,1485,0,21706873
WHO Regions,afr,1995,dtp1,21708358,15909395,73,5798963
WHO Regions,afr,1995,pol3,21708358,11788464,54,9919894
WHO Regions,afr,1995,mcv1,21708358,12050833,56,9657525
WHO Regions,afr,1996,bcg,24743321,16158561,65,8584760
WHO Regions,afr,1996,mcv1,22207472,12188378,55,10019094
WHO Regions,afr,1996,hib3,22207472,0,0,22207472
WHO Regions,afr,1996,rcv1,22207472,14252,0,22193220
WHO Regions,afr,1996,pol3,22207472,11799338,53,10408134
WHO Regions,afr,1996,dtp1,22207472,15791399,71,6416073
WHO Regions,afr,1996,hepb3,22207472,128107,1,22079365
WHO Regions,afr,1996,dtp3,22207472,11428025,51,10779447
WHO Regions,afr,1997,bcg,25257761,15888407,63,9369354
WHO Regions,afr,1997,hepb3,22724475,942455,4,21782020
WHO Regions,afr,1997,rcv1,22724475,19428,0,22705047
WHO Regions,afr,1997,hib3,22724475,0,0,22724475
WHO Regions,afr,1997,dtp1,22724475,17056415,75,5668060
WHO Regions,afr,1997,pol3,22724475,12191373,54,10533102
WHO Regions,afr,1997,mcv1,22724475,12423528,55,10300947
WHO Regions,afr,1997,dtp3,22724475,11385824,50,11338651
WHO Regions,afr,1998,bcg,25781277,17089921,66,8691356
WHO Regions,afr,1998,dtp1,23256089,15919795,68,7336294
WHO Regions,afr,1998,hepb3,23256089,982723,4,22273366
WHO Regions,afr,1998,dtp3,23256089,11790760,51,11465329
WHO Regions,afr,1998,rcv1,23256089,18670,0,23237419
WHO Regions,afr,1998,mcv1,23256089,12320301,53,10935788
WHO Regions,afr,1998,pol3,23256089,12054512,52,11201577
WHO Regions,afr,1998,hib3,23256089,48233,0,23207856
WHO Regions,afr,1999,bcg,26313741,17578653,67,8735088
WHO Regions,afr,1999,dtp1,23801570,15489177,65,8312393
WHO Regions,afr,1999,dtp3,23801570,11741708,49,12059862
WHO Regions,afr,1999,hepb3,23801570,1006856,4,22794714
WHO Regions,afr,1999,pol3,23801570,12415767,52,11385803
WHO Regions,afr,1999,mcv1,23801570,12118377,51,11683193
WHO Regions,afr,1999,rcv1,23801570,17527,0,23784043
WHO Regions,afr,1999,hib3,23801570,48024,0,23753546
WHO Regions,afr,2000,hepbb,26857190,0,0,26857190
WHO Regions,afr,2000,bcg,26857190,18526299,69,8330891
WHO Regions,afr,2000,dtp1,24362509,16116089,66,8246420
WHO Regions,afr,2000,hepb3,24362509,1195439,5,23167070
WHO Regions,afr,2000,dtp3,24362509,12659775,52,11702734
WHO Regions,afr,2000,pol3,24362509,13286558,55,11075951
WHO Regions,afr,2000,hib3,24362509,811011,3,23551498
WHO Regions,afr,2000,rcv1,24362509,18085,0,24344424
WHO Regions,afr,2000,mcv1,24362509,12982402,53,11380107
WHO Regions,afr,2000,mcv2,22320392,1200663,5,21119729
WHO Regions,afr,2001,bcg,27414777,18776941,68,8637836
WHO Regions,afr,2001,hepbb,27414777,0,0,27414777
WHO Regions,afr,2001,dtp1,24941747,16644078,67,8297669
WHO Regions,afr,2001,mcv1,24941747,13413554,54,11528193
WHO Regions,afr,2001,hepb3,24941747,1435138,6,23506609
WHO Regions,afr,2001,pol3,24941747,13824935,55,11116812
WHO Regions,afr,2001,hib3,24941747,792761,3,24148986
WHO Regions,afr,2001,rcv1,24941747,18995,0,24922752
WHO Regions,afr,2001,dtp3,24941747,13003356,52,11938391
WHO Regions,afr,2001,mcv2,23007569,1097012,5,21910557
WHO Regions,afr,2002,bcg,27988264,19143695,68,8844569
WHO Regions,afr,2002,hepbb,27988264,9570,0,27978694
WHO Regions,afr,2002,dtp1,25540666,17392521,68,8148145
WHO Regions,afr,2002,hib3,25540666,3234530,13,22306136
WHO Regions,afr,2002,dtp3,25540666,13714478,54,11826188
WHO Regions,afr,2002,rcv1,25540666,17610,0,25523056
WHO Regions,afr,2002,mcv1,25540666,13965776,55,11574890
WHO Regions,afr,2002,hepb3,25540666,6261884,25,19278782
WHO Regions,afr,2002,pol3,25540666,15232580,60,10308086
WHO Regions,afr,2002,mcv2,23675617,1163867,5,22511750
WHO Regions,afr,2003,bcg,28577532,19998667,70,8578865
WHO Regions,afr,2003,hepbb,28577532,9356,0,28568176
WHO Regions,afr,2003,dtp1,26158546,18344889,70,7813657
WHO Regions,afr,2003,rcv1,26158546,18615,0,26139931
WHO Regions,afr,2003,dtp3,26158546,14773955,56,11384591
WHO Regions,afr,2003,hib3,26158546,3451191,13,22707355
WHO Regions,afr,2003,hepb3,26158546,7407760,28,18750786
WHO Regions,afr,2003,mcv1,26158546,14976817,57,11181729
WHO Regions,afr,2003,pol3,26158546,16131432,62,10027114
WHO Regions,afr,2003,mcv2,23962515,1210855,5,22751660
WHO Regions,afr,2004,hepbb,29180506,652174,2,28528332
WHO Regions,afr,2004,bcg,29180506,21148225,72,8032281
WHO Regions,afr,2004,dtp1,26792595,19345088,72,7447507
WHO Regions,afr,2004,dtp3,26792595,16005453,60,10787142
WHO Regions,afr,2004,hepb3,26792595,8913696,33,17878899
WHO Regions,afr,2004,pol3,26792595,16874947,63,9917648
WHO Regions,afr,2004,mcv1,26792595,15876679,59,10915916
WHO Regions,afr,2004,rcv1,26792595,19479,0,26773116
WHO Regions,afr,2004,hib3,26792595,4433231,17,22359364
WHO Regions,afr,2004,mcv2,24557208,1182805,5,23374403
WHO Regions,afr,2005,bcg,29795105,22264506,75,7530599
WHO Regions,afr,2005,hepbb,29795105,683768,2,29111337
WHO Regions,afr,2005,pol3,27440162,17958068,65,9482094
WHO Regions,afr,2005,hib3,27440162,4927925,18,22512237
WHO Regions,afr,2005,dtp3,27440162,17192142,63,10248020
WHO Regions,afr,2005,mcv1,27440162,16787562,61,10652600
WHO Regions,afr,2005,hepb3,27440162,11482926,42,15957236
WHO Regions,afr,2005,dtp1,27440162,20164894,73,7275268
WHO Regions,afr,2005,rcv1,27440162,18969,0,27421193
WHO Regions,afr,2005,mcv2,25170459,1147959,5,24022500
WHO Regions,afr,2006,hepbb,30418789,722074,2,29696715
WHO Regions,afr,2006,bcg,30418789,23275876,77,7142913
WHO Regions,afr,2006,mcv1,28098333,17976570,64,10121763
WHO Regions,afr,2006,dtp1,28098333,21154903,75,6943430
WHO Regions,afr,2006,dtp3,28098333,18267400,65,9830933
WHO Regions,afr,2006,hib3,28098333,6113970,22,21984363
WHO Regions,afr,2006,pol3,28098333,18907008,67,9191325
WHO Regions,afr,2006,rcv1,28098333,18581,0,28079752
WHO Regions,afr,2006,hepb3,28098333,12974977,46,15123356
WHO Regions,afr,2006,rotac,28098333,0,0,28098333
WHO Regions,afr,2006,mcv2,25844437,1232111,5,24612326
WHO Regions,afr,2007,bcg,31046697,24405389,79,6641308
WHO Regions,afr,2007,hepbb,31046697,904851,3,30141846
WHO Regions,afr,2007,dtp3,28761998,19561115,68,9200883
WHO Regions,afr,2007,dtp1,28761998,22340396,78,6421602
WHO Regions,afr,2007,pol3,28761998,20497607,71,8264391
WHO Regions,afr,2007,rcv1,28761998,17823,0,28744175
WHO Regions,afr,2007,rotac,28761998,0,0,28761998
WHO Regions,afr,2007,hib3,28761998,8800192,31,19961806
WHO Regions,afr,2007,mcv1,28761998,19021841,66,9740157
WHO Regions,afr,2007,hepb3,28761998,18446807,64,10315191
WHO Regions,afr,2007,mcv2,26509773,1179870,4,25329903
WHO Regions,afr,2008,hepbb,31673133,1518156,5,30154977
WHO Regions,afr,2008,bcg,31673133,25750061,81,5923072
WHO Regions,afr,2008,pcv3,29425034,0,0,29425034
WHO Regions,afr,2008,pol3,29425034,21217701,72,8207333
WHO Regions,afr,2008,dtp3,29425034,20707262,70,8717772
WHO Regions,afr,2008,hib3,29425034,11124757,38,18300277
WHO Regions,afr,2008,mcv1,29425034,20066533,68,9358501
WHO Regions,afr,2008,dtp1,29425034,23515877,80,5909157
WHO Regions,afr,2008,rcv1,29425034,17242,0,29407792
WHO Regions,afr,2008,rotac,29425034,0,0,29425034
WHO Regions,afr,2008,hepb3,29425034,19089677,65,10335357
WHO Regions,afr,2008,mcv2,26996536,1242918,5,25753618
WHO Regions,afr,2009,bcg,32292812,27366750,85,4926062
WHO Regions,afr,2009,hepbb,32292812,2154324,7,30138488
WHO Regions,afr,2009,dtp1,30081560,25101821,83,4979739
WHO Regions,afr,2009,pcv3,30081560,110501,0,29971059
WHO Regions,afr,2009,mcv1,30081560,21901639,73,8179921
WHO Regions,afr,2009,hib3,30081560,18201007,61,11880553
WHO Regions,afr,2009,rotac,30081560,187852,1,29893708
WHO Regions,afr,2009,dtp3,30081560,22146150,74,7935410
WHO Regions,afr,2009,rcv1,30081560,16805,0,30064755
WHO Regions,afr,2009,pol3,30081560,22726151,76,7355409
WHO Regions,afr,2009,hepb3,30081560,21962870,73,8118690
WHO Regions,afr,2009,mcv2,27647218,1365265,5,26281953
WHO Regions,afr,2010,bcg,32899034,27174428,83,5724606
WHO Regions,afr,2010,hepbb,32899034,2807949,9,30091085
WHO Regions,afr,2010,pcv3,30724385,1047094,3,29677291
WHO Regions,afr,2010,dtp1,30724385,24967131,81,5757254
WHO Regions,afr,2010,rotac,30724385,668494,2,30055891
WHO Regions,afr,2010,rcv1,30724385,16323,0,30708062
WHO Regions,afr,2010,mcv1,30724385,22415252,73,8309133
WHO Regions,afr,2010,pol3,30724385,22853759,74,7870626
WHO Regions,afr,2010,dtp3,30724385,22236377,72,8488008
WHO Regions,afr,2010,hepb3,30724385,21905497,71,8818888
WHO Regions,afr,2010,hib3,30724385,18933726,62,11790659
WHO Regions,afr,2010,mcv2,28314380,1295399,5,27018981
WHO Regions,afr,2011,bcg,33880371,26911894,79,6968477
WHO Regions,afr,2011,hepbb,33880371,3005542,9,30874829
WHO Regions,afr,2011,dtp3,31709765,22939832,72,8769933
WHO Regions,afr,2011,mcv1,31709765,22619701,71,9090064
WHO Regions,afr,2011,rotac,31709765,752022,2,30957743
WHO Regions,afr,2011,hib3,31709765,19750138,62,11959627
WHO Regions,afr,2011,dtp1,31709765,25864927,82,5844838
WHO Regions,afr,2011,pcv3,31709765,3784157,12,27925608
WHO Regions,afr,2011,pol3,31709765,22861497,72,8848268
WHO Regions,afr,2011,hepb3,31709765,22655908,71,9053857
WHO Regions,afr,2011,rcv1,31709765,26931,0,31682834
WHO Regions,afr,2011,mcv2,29384817,1333243,5,28051574
WHO Regions,afr,2012,bcg,34456310,27735659,80,6720651
WHO Regions,afr,2012,hepbb,34456310,3129373,9,31326937
WHO Regions,afr,2012,hib3,32321216,20994506,65,11326710
WHO Regions,afr,2012,pol3,32321216,23307774,72,9013442
WHO Regions,afr,2012,dtp3,32321216,23258395,72,9062821
WHO Regions,afr,2012,rotac,32321216,1448960,4,30872256
WHO Regions,afr,2012,dtp1,32321216,26050715,81,6270501
WHO Regions,afr,2012,mcv1,32321216,23080220,71,9240996
WHO Regions,afr,2012,hepb3,32321216,23037376,71,9283840
WHO Regions,afr,2012,rcv1,32321216,25910,0,32295306
WHO Regions,afr,2012,pcv3,32321216,6894562,21,25426654
WHO Regions,afr,2012,mcv2,30115558,1805860,6,28309698
WHO Regions,afr,2013,hepbb,35011700,3174772,9,31836928
WHO Regions,afr,2013,bcg,35011700,27889813,80,7121887
WHO Regions,afr,2013,rotac,32911371,4079520,12,28831851
WHO Regions,afr,2013,pol3,32911371,23706793,72,9204578
WHO Regions,afr,2013,dtp3,32911371,23866822,73,9044549
WHO Regions,afr,2013,rcv1,32911371,1174911,4,31736460
WHO Regions,afr,2013,hib3,32911371,22753461,69,10157910
WHO Regions,afr,2013,dtp1,32911371,26901037,82,6010334
WHO Regions,afr,2013,mcv1,32911371,23319885,71,9591486
WHO Regions,afr,2013,hepb3,32911371,23745351,72,9166020
WHO Regions,afr,2013,pcv3,32911371,11664406,35,21246965
WHO Regions,afr,2013,mcv2,30673040,2061066,7,28611974
WHO Regions,afr,2014,bcg,35547599,28987644,82,6559955
WHO Regions,afr,2014,hepbb,35547599,3211195,9,32336404
WHO Regions,afr,2014,rcv1,33480977,3135142,9,30345835
WHO Regions,afr,2014,pol3,33480977,24794005,74,8686972
WHO Regions,afr,2014,hepb3,33480977,24782018,74,8698959
WHO Regions,afr,2014,rotac,33480977,9848770,29,23632207
WHO Regions,afr,2014,dtp1,33480977,28065486,84,5415491
WHO Regions,afr,2014,pcv3,33480977,16872955,50,16608022
WHO Regions,afr,2014,hib3,33480977,24747908,74,8733069
WHO Regions,afr,2014,mcv1,33480977,24188098,72,9292879
WHO Regions,afr,2014,dtp3,33480977,24900120,74,8580857
WHO Regions,afr,2014,mcv2,31359311,3300609,11,28058702
WHO Regions,afr,2015,hepbb,36067054,3371382,9,32695672
WHO Regions,afr,2015,bcg,36067054,28818153,80,7248901
WHO Regions,afr,2015,rcv1,34032800,3963137,12,30069663
WHO Regions,afr,2015,pcv3,34032800,19909245,59,14123555
WHO Regions,afr,2015,hib3,34032800,25135130,74,8897670
WHO Regions,afr,2015,rotac,34032800,13167797,39,20865003
WHO Regions,afr,2015,hepb3,34032800,25135145,74,8897655
WHO Regions,afr,2015,mcv1,34032800,24613690,72,9419110
WHO Regions,afr,2015,dtp1,34032800,28260821,83,5771979
WHO Regions,afr,2015,dtp3,34032800,25134798,74,8898002
WHO Regions,afr,2015,pol3,34032800,24976397,73,9056403
WHO Regions,afr,2015,mcv2,32025816,5812327,18,26213489
WHO Regions,afr,2016,hepbb,36574871,3709451,10,32865420
WHO Regions,afr,2016,bcg,36574871,29454676,81,7120195
WHO Regions,afr,2016,dtp1,34571456,28669297,83,5902159
WHO Regions,afr,2016,pcv3,34571456,22583634,65,11987822
WHO Regions,afr,2016,rcv1,34571456,4643652,13,29927804
WHO Regions,afr,2016,dtp3,34571456,25523247,74,9048209
WHO Regions,afr,2016,hib3,34571456,25523247,74,9048209
WHO Regions,afr,2016,rotac,34571456,14854327,43,19717129
WHO Regions,afr,2016,mcv1,34571456,24944806,72,9626650
WHO Regions,afr,2016,pol3,34571456,25123174,73,9448282
WHO Regions,afr,2016,hepb3,34571456,25520082,74,9051374
WHO Regions,afr,2016,mcv2,32722167,7885136,24,24837031
WHO Regions,eur,1980,bcg,12349059,2193554,18,10155505
WHO Regions,eur,1980,rcv1,14594225,519430,4,14074795
WHO Regions,eur,1980,mcv1,14594225,8759268,60,5834957
WHO Regions,eur,1980,dtp1,14594225,10708680,73,3885545
WHO Regions,eur,1980,pol3,14594225,10962771,75,3631454
WHO Regions,eur,1980,dtp3,14594225,9780771,67,4813454
WHO Regions,eur,1981,bcg,12398123,3275459,26,9122664
WHO Regions,eur,1981,mcv1,14649408,9908763,68,4740645
WHO Regions,eur,1981,dtp1,14649408,11888778,81,2760630
WHO Regions,eur,1981,pol3,14649408,11615580,79,3033828
WHO Regions,eur,1981,dtp3,14649408,11332494,77,3316914
WHO Regions,eur,1981,rcv1,14649408,650674,4,13998734
WHO Regions,eur,1982,bcg,12438595,3318853,27,9119742
WHO Regions,eur,1982,mcv1,14701258,10293638,70,4407620
WHO Regions,eur,1982,pol3,14701258,11438519,78,3262739
WHO Regions,eur,1982,rcv1,14701258,867831,6,13833427
WHO Regions,eur,1982,dtp1,14701258,11925367,81,2775891
WHO Regions,eur,1982,dtp3,14701258,11235117,76,3466141
WHO Regions,eur,1983,bcg,12368556,9760498,79,2608058
WHO Regions,eur,1983,dtp1,14739970,11995043,81,2744927
WHO Regions,eur,1983,pol3,14739970,11961880,81,2778090
WHO Regions,eur,1983,rcv1,14739970,1348275,9,13391695
WHO Regions,eur,1983,dtp3,14739970,11140863,76,3599107
WHO Regions,eur,1983,mcv1,14739970,10902758,74,3837212
WHO Regions,eur,1984,bcg,12366354,9993909,81,2372445
WHO Regions,eur,1984,dtp3,14755432,11725449,79,3029983
WHO Regions,eur,1984,rcv1,14755432,1661749,11,13093683
WHO Regions,eur,1984,dtp1,14755432,12548917,85,2206515
WHO Regions,eur,1984,mcv1,14755432,11286829,76,3468603
WHO Regions,eur,1984,pol3,14755432,12437348,84,2318084
WHO Regions,eur,1985,bcg,12271179,10088120,82,2183059
WHO Regions,eur,1985,dtp1,14731581,12750144,87,1981437
WHO Regions,eur,1985,rcv1,14731581,1985083,13,12746498
WHO Regions,eur,1985,dtp3,14731581,11567821,79,3163760
WHO Regions,eur,1985,hepb3,14731581,0,0,14731581
WHO Regions,eur,1985,mcv1,14731581,11525942,78,3205639
WHO Regions,eur,1985,pol3,14731581,13351071,91,1380510
WHO Regions,eur,1986,bcg,12176323,10379991,85,1796332
WHO Regions,eur,1986,hepb3,14652297,0,0,14652297
WHO Regions,eur,1986,dtp1,14652297,12524791,85,2127506
WHO Regions,eur,1986,mcv1,14652297,10668114,73,3984183
WHO Regions,eur,1986,dtp3,14652297,11219386,77,3432911
WHO Regions,eur,1986,rcv1,14652297,2140593,15,12511704
WHO Regions,eur,1986,pol3,14652297,11970164,82,2682133
WHO Regions,eur,1987,bcg,12025141,10285766,86,1739375
WHO Regions,eur,1987,dtp3,14512886,11261693,78,3251193
WHO Regions,eur,1987,pol3,14512886,12098920,83,2413966
WHO Regions,eur,1987,hepb3,14512886,0,0,14512886
WHO Regions,eur,1987,mcv1,14512886,10983806,76,3529080
WHO Regions,eur,1987,dtp1,14512886,12648642,87,1864244
WHO Regions,eur,1987,rcv1,14512886,2242087,15,12270799
WHO Regions,eur,1988,bcg,11820225,10181874,86,1638351
WHO Regions,eur,1988,dtp3,14315015,10921137,76,3393878
WHO Regions,eur,1988,dtp1,14315015,12342979,86,1972036
WHO Regions,eur,1988,mcv1,14315015,11229944,78,3085071
WHO Regions,eur,1988,pol3,14315015,11831900,83,2483115
WHO Regions,eur,1988,hepb3,14315015,0,0,14315015
WHO Regions,eur,1988,rcv1,14315015,2900090,20,11414925
WHO Regions,eur,1989,bcg,11567760,9851998,85,1715762
WHO Regions,eur,1989,dtp3,14064424,10512843,75,3551581
WHO Regions,eur,1989,rcv1,14064424,3158739,22,10905685
WHO Regions,eur,1989,mcv1,14064424,11197609,80,2866815
WHO Regions,eur,1989,pol3,14064424,11400551,81,2663873
WHO Regions,eur,1989,dtp1,14064424,12003623,85,2060801
WHO Regions,eur,1989,hepb3,14064424,0,0,14064424
WHO Regions,eur,1990,bcg,11188643,9490809,85,1697834
WHO Regions,eur,1990,pol3,13771452,11428016,83,2343436
WHO Regions,eur,1990,mcv1,13771452,11412272,83,2359180
WHO Regions,eur,1990,rcv1,13771452,3519562,26,10251890
WHO Regions,eur,1990,dtp3,13771452,10820787,79,2950665
WHO Regions,eur,1990,hepb3,13771452,0,0,13771452
WHO Regions,eur,1990,dtp1,13771452,12301380,89,1470072
WHO Regions,eur,1990,hib3,13771452,0,0,13771452
WHO Regions,eur,1991,bcg,10873231,9219439,85,1653792
WHO Regions,eur,1991,hib3,13450587,556332,4,12894255
WHO Regions,eur,1991,pol3,13450587,10953861,81,2496726
WHO Regions,eur,1991,hepb3,13450587,542731,4,12907856
WHO Regions,eur,1991,rcv1,13450587,4107251,31,9343336
WHO Regions,eur,1991,mcv1,13450587,11056775,82,2393812
WHO Regions,eur,1991,dtp1,13450587,12318628,92,1131959
WHO Regions,eur,1991,dtp3,13450587,11219539,83,2231048
WHO Regions,eur,1992,bcg,9158670,7540868,82,1617802
WHO Regions,eur,1992,dtp1,11556688,10812756,94,743932
WHO Regions,eur,1992,hib3,11556688,764169,7,10792519
WHO Regions,eur,1992,hepb3,11556688,706001,6,10850687
WHO Regions,eur,1992,dtp3,11556688,9850061,85,1706627
WHO Regions,eur,1992,rcv1,11556688,4255340,37,7301348
WHO Regions,eur,1992,mcv1,11556688,9423114,82,2133574
WHO Regions,eur,1992,pol3,11556688,9818656,85,1738032
WHO Regions,eur,1993,bcg,8884251,7208575,81,1675676
WHO Regions,eur,1993,mcv1,11283900,9322534,83,1961366
WHO Regions,eur,1993,hib3,11283900,1564998,14,9718902
WHO Regions,eur,1993,rcv1,11283900,4388123,39,6895777
WHO Regions,eur,1993,dtp1,11283900,10353760,92,930140
WHO Regions,eur,1993,pol3,11283900,9545221,85,1738679
WHO Regions,eur,1993,hepb3,11283900,828609,7,10455291
WHO Regions,eur,1993,dtp3,11283900,9127690,81,2156210
WHO Regions,eur,1994,bcg,8599252,7170055,83,1429197
WHO Regions,eur,1994,hepb3,11002078,1035790,9,9966288
WHO Regions,eur,1994,hib3,11002078,1697519,15,9304559
WHO Regions,eur,1994,mcv1,11002078,9095059,83,1907019
WHO Regions,eur,1994,rcv1,11002078,4546139,41,6455939
WHO Regions,eur,1994,pol3,11002078,9706661,88,1295417
WHO Regions,eur,1994,dtp1,11002078,10446399,95,555679
WHO Regions,eur,1994,dtp3,11002078,9653775,88,1348303
WHO Regions,eur,1995,bcg,7700784,7008891,91,691893
WHO Regions,eur,1995,pol3,10754502,9538092,89,1216410
WHO Regions,eur,1995,dtp3,10754502,9317304,87,1437198
WHO Regions,eur,1995,rcv1,10754502,4729470,44,6025032
WHO Regions,eur,1995,hepb3,10754502,1239519,12,9514983
WHO Regions,eur,1995,dtp1,10754502,10135469,94,619033
WHO Regions,eur,1995,hib3,10754502,1736223,16,9018279
WHO Regions,eur,1995,mcv1,10754502,9016422,84,1738080
WHO Regions,eur,1996,bcg,7493791,6818958,91,674833
WHO Regions,eur,1996,pol3,10546044,9615661,91,930383
WHO Regions,eur,1996,hepb3,10546044,2077159,20,8468885
WHO Regions,eur,1996,rcv1,10546044,4855491,46,5690553
WHO Regions,eur,1996,dtp1,10546044,10036444,95,509600
WHO Regions,eur,1996,mcv1,10546044,9088581,86,1457463
WHO Regions,eur,1996,hib3,10546044,1833257,17,8712787
WHO Regions,eur,1996,dtp3,10546044,9398008,89,1148036
WHO Regions,eur,1997,bcg,7318618,6698645,92,619973
WHO Regions,eur,1997,hepb3,10374373,2399105,23,7975268
WHO Regions,eur,1997,dtp1,10374373,9968945,96,405428
WHO Regions,eur,1997,mcv1,10374373,9136371,88,1238002
WHO Regions,eur,1997,pol3,10374373,9597499,93,776874
WHO Regions,eur,1997,hib3,10374373,2066975,20,8307398
WHO Regions,eur,1997,dtp3,10374373,9432487,91,941886
WHO Regions,eur,1997,rcv1,10374373,4815164,46,5559209
WHO Regions,eur,1998,bcg,7183420,6611510,92,571910
WHO Regions,eur,1998,pol3,10236832,9504061,93,732771
WHO Regions,eur,1998,hepb3,10236832,2875014,28,7361818
WHO Regions,eur,1998,dtp1,10236832,9866021,96,370811
WHO Regions,eur,1998,dtp3,10236832,9382208,92,854624
WHO Regions,eur,1998,hib3,10236832,3176342,31,7060490
WHO Regions,eur,1998,rcv1,10236832,4711732,46,5525100
WHO Regions,eur,1998,mcv1,10236832,9014292,88,1222540
WHO Regions,eur,1999,bcg,7085514,6596722,93,488792
WHO Regions,eur,1999,dtp1,10137413,9811842,97,325571
WHO Regions,eur,1999,hepb3,10137413,2999257,30,7138156
WHO Regions,eur,1999,dtp3,10137413,9411067,93,726346
WHO Regions,eur,1999,pol3,10137413,9449141,93,688272
WHO Regions,eur,1999,rcv1,10137413,4754272,47,5383141
WHO Regions,eur,1999,mcv1,10137413,9068920,89,1068493
WHO Regions,eur,1999,hib3,10137413,3454728,34,6682685
WHO Regions,eur,2000,hepbb,10266910,1303776,13,8963134
WHO Regions,eur,2000,bcg,7028911,6570822,93,458089
WHO Regions,eur,2000,pol3,10082713,9474936,94,607777
WHO Regions,eur,2000,rcv1,10082713,6028890,60,4053823
WHO Regions,eur,2000,hib3,10082713,3828016,38,6254697
WHO Regions,eur,2000,mcv1,10082713,9151174,91,931539
WHO Regions,eur,2000,dtp1,10082713,9713336,96,369377
WHO Regions,eur,2000,hepb3,10082713,4209888,42,5872825
WHO Regions,eur,2000,dtp3,10082713,9367634,93,715079
WHO Regions,eur,2000,mcv2,10830846,5175231,48,5655615
WHO Regions,eur,2001,hepbb,10253566,1527358,15,8726208
WHO Regions,eur,2001,bcg,7016715,6545429,93,471286
WHO Regions,eur,2001,dtp3,10078933,9470537,94,608396
WHO Regions,eur,2001,hib3,10078933,3959464,39,6119469
WHO Regions,eur,2001,pol3,10078933,9521529,94,557404
WHO Regions,eur,2001,mcv1,10078933,9236691,92,842242
WHO Regions,eur,2001,dtp1,10078933,9757330,97,321603
WHO Regions,eur,2001,hepb3,10078933,4963149,49,5115784
WHO Regions,eur,2001,rcv1,10078933,6619632,66,3459301
WHO Regions,eur,2001,mcv2,10682124,6639966,62,4042158
WHO Regions,eur,2002,bcg,7045357,6529122,93,516235
WHO Regions,eur,2002,hepbb,10290240,2631114,26,7659126
WHO Regions,eur,2002,pol3,10123848,9457246,93,666602
WHO Regions,eur,2002,dtp1,10123848,9647562,95,476286
WHO Regions,eur,2002,mcv1,10123848,9211723,91,912125
WHO Regions,eur,2002,dtp3,10123848,9405807,93,718041
WHO Regions,eur,2002,hib3,10123848,4197851,41,5925997
WHO Regions,eur,2002,rcv1,10123848,7011249,69,3112599
WHO Regions,eur,2002,hepb3,10123848,6353325,63,3770523
WHO Regions,eur,2002,mcv2,10469308,7312374,70,3156934
WHO Regions,eur,2003,bcg,7108479,6566228,92,542251
WHO Regions,eur,2003,hepbb,10370136,3742133,36,6628003
WHO Regions,eur,2003,mcv1,10210961,9244573,91,966388
WHO Regions,eur,2003,rcv1,10210961,7188614,70,3022347
WHO Regions,eur,2003,hib3,10210961,4295932,42,5915029
WHO Regions,eur,2003,pol3,10210961,9340893,91,870068
WHO Regions,eur,2003,dtp3,10210961,9329652,91,881309
WHO Regions,eur,2003,dtp1,10210961,9665702,95,545259
WHO Regions,eur,2003,hepb3,10210961,6904915,68,3306046
WHO Regions,eur,2003,mcv2,10372969,7569275,73,2803694
WHO Regions,eur,2004,bcg,7199215,6480261,90,718954
WHO Regions,eur,2004,hepbb,10484752,4116587,39,6368165
WHO Regions,eur,2004,hib3,10331970,4468320,43,5863650
WHO Regions,eur,2004,mcv1,10331970,9461713,92,870257
WHO Regions,eur,2004,pol3,10331970,9784916,95,547054
WHO Regions,eur,2004,rcv1,10331970,7616198,74,2715772
WHO Regions,eur,2004,dtp1,10331970,9888933,96,443037
WHO Regions,eur,2004,dtp3,10331970,9703475,94,628495
WHO Regions,eur,2004,hepb3,10331970,7576804,73,2755166
WHO Regions,eur,2004,mcv2,10323242,7969374,77,2353868
WHO Regions,eur,2005,hepbb,10623438,4343491,41,6279947
WHO Regions,eur,2005,bcg,7291695,6565476,90,726219
WHO Regions,eur,2005,hib3,10476414,4597448,44,5878966
WHO Regions,eur,2005,rcv1,10476414,7768823,74,2707591
WHO Regions,eur,2005,mcv1,10476414,9752433,93,723981
WHO Regions,eur,2005,dtp1,10476414,10171172,97,305242
WHO Regions,eur,2005,dtp3,10476414,9953793,95,522621
WHO Regions,eur,2005,pol3,10476414,9955603,95,520811
WHO Regions,eur,2005,hepb3,10476414,7833029,75,2643385
WHO Regions,eur,2005,mcv2,10234788,7826885,76,2407903
WHO Regions,eur,2006,hepbb,10774689,4401579,41,6373110
WHO Regions,eur,2006,bcg,7416353,6840916,92,575437
WHO Regions,eur,2006,pol3,10632964,10106769,95,526195
WHO Regions,eur,2006,rcv1,10632964,9780036,92,852928
WHO Regions,eur,2006,hib3,10632964,4824676,45,5808288
WHO Regions,eur,2006,rotac,10632964,0,0,10632964
WHO Regions,eur,2006,hepb3,10632964,8022151,75,2610813
WHO Regions,eur,2006,dtp3,10632964,10125632,95,507332
WHO Regions,eur,2006,dtp1,10632964,10329760,97,303204
WHO Regions,eur,2006,mcv1,10632964,10041897,94,591067
WHO Regions,eur,2006,mcv2,10183951,7631548,75,2552403
WHO Regions,eur,2007,bcg,7487555,6931057,93,556498
WHO Regions,eur,2007,hepbb,10925950,4457578,41,6468372
WHO Regions,eur,2007,hib3,10789164,6267277,58,4521887
WHO Regions,eur,2007,rcv1,10789164,10055837,93,733327
WHO Regions,eur,2007,hepb3,10789164,8387314,78,2401850
WHO Regions,eur,2007,mcv1,10789164,10225130,95,564034
WHO Regions,eur,2007,dtp1,10789164,10558403,98,230761
WHO Regions,eur,2007,pol3,10789164,10343108,96,446056
WHO Regions,eur,2007,rotac,10789164,0,0,10789164
WHO Regions,eur,2007,dtp3,10789164,10337337,96,451827
WHO Regions,eur,2007,mcv2,10186594,7757760,76,2428834
WHO Regions,eur,2008,bcg,6828403,6430300,94,398103
WHO Regions,eur,2008,hepbb,11064990,4515516,41,6549474
WHO Regions,eur,2008,hib3,10932904,7038032,64,3894872
WHO Regions,eur,2008,rcv1,10932904,10192158,93,740746
WHO Regions,eur,2008,dtp1,10932904,10664792,98,268112
WHO Regions,eur,2008,pcv3,10932904,922343,8,10010561
WHO Regions,eur,2008,rotac,10932904,36317,0,10896587
WHO Regions,eur,2008,mcv1,10932904,10369773,95,563131
WHO Regions,eur,2008,dtp3,10932904,10468978,96,463926
WHO Regions,eur,2008,pol3,10932904,10464917,96,467987
WHO Regions,eur,2008,hepb3,10932904,8447644,77,2485260
WHO Regions,eur,2008,mcv2,10185057,7649548,75,2535509
WHO Regions,eur,2009,hepbb,11181862,4548724,41,6633138
WHO Regions,eur,2009,bcg,6943056,6535956,94,407100
WHO Regions,eur,2009,rcv1,11054357,10362828,94,691529
WHO Regions,eur,2009,hepb3,11054357,8558662,77,2495695
WHO Regions,eur,2009,hib3,11054357,7946672,72,3107685
WHO Regions,eur,2009,mcv1,11054357,10362828,94,691529
WHO Regions,eur,2009,dtp1,11054357,10687023,97,367334
WHO Regions,eur,2009,pcv3,11054357,2654729,24,8399628
WHO Regions,eur,2009,dtp3,11054357,10502786,95,551571
WHO Regions,eur,2009,pol3,11054357,10524154,95,530203
WHO Regions,eur,2009,rotac,11054357,52238,0,11002119
WHO Regions,eur,2009,mcv2,10229089,7445986,73,2783103
WHO Regions,eur,2010,hepbb,11268235,4227784,38,7040451
WHO Regions,eur,2010,bcg,6924058,6557156,95,366902
WHO Regions,eur,2010,pol3,11145274,10541215,95,604059
WHO Regions,eur,2010,pcv3,11145274,4175421,37,6969853
WHO Regions,eur,2010,rcv1,11145274,10420567,93,724707
WHO Regions,eur,2010,rotac,11145274,107625,1,11037649
WHO Regions,eur,2010,dtp1,11145274,10672104,96,473170
WHO Regions,eur,2010,hib3,11145274,8227429,74,2917845
WHO Regions,eur,2010,mcv1,11145274,10420567,93,724707
WHO Regions,eur,2010,hepb3,11145274,8748467,78,2396807
WHO Regions,eur,2010,dtp3,11145274,10519383,94,625891
WHO Regions,eur,2010,mcv2,10301198,8286522,80,2014676
WHO Regions,eur,2011,bcg,6991012,6589011,94,402001
WHO Regions,eur,2011,hepbb,11320014,4545375,40,6774639
WHO Regions,eur,2011,hepb3,11201572,8875204,79,2326368
WHO Regions,eur,2011,rcv1,11201572,10566617,94,634955
WHO Regions,eur,2011,pol3,11201572,10592108,95,609464
WHO Regions,eur,2011,dtp3,11201572,10586540,95,615032
WHO Regions,eur,2011,dtp1,11201572,10714631,96,486941
WHO Regions,eur,2011,pcv3,11201572,4583596,41,6617976
WHO Regions,eur,2011,rotac,11201572,108122,1,11093450
WHO Regions,eur,2011,hib3,11201572,8467634,76,2733938
WHO Regions,eur,2011,mcv1,11201572,10566617,94,634955
WHO Regions,eur,2011,mcv2,10392085,8579561,83,1812524
WHO Regions,eur,2012,bcg,7030287,6658831,95,371456
WHO Regions,eur,2012,hepbb,11341270,4573441,40,6767829
WHO Regions,eur,2012,pol3,11227263,10729174,96,498089
WHO Regions,eur,2012,pcv3,11227263,4951066,44,6276197
WHO Regions,eur,2012,hib3,11227263,8888596,79,2338667
WHO Regions,eur,2012,dtp3,11227263,10749978,96,477285
WHO Regions,eur,2012,rotac,11227263,361011,3,10866252
WHO Regions,eur,2012,rcv1,11227263,10636304,95,590959
WHO Regions,eur,2012,dtp1,11227263,10855091,97,372172
WHO Regions,eur,2012,mcv1,11227263,10636304,95,590959
WHO Regions,eur,2012,hepb3,11227263,9067313,81,2159950
WHO Regions,eur,2012,mcv2,10594123,8802051,83,1792072
WHO Regions,eur,2013,bcg,7042283,6642195,94,400088
WHO Regions,eur,2013,hepbb,11336381,4593312,41,6743069
WHO Regions,eur,2013,rotac,11226675,416354,4,10810321
WHO Regions,eur,2013,dtp3,11226675,10772705,96,453970
WHO Regions,eur,2013,mcv1,11226675,10667770,95,558905
WHO Regions,eur,2013,dtp1,11226675,10889378,97,337297
WHO Regions,eur,2013,pol3,11226675,10753481,96,473194
WHO Regions,eur,2013,hepb3,11226675,9126215,81,2100460
WHO Regions,eur,2013,pcv3,11226675,5056197,45,6170478
WHO Regions,eur,2013,hib3,11226675,8896323,79,2330352
WHO Regions,eur,2013,rcv1,11226675,10667770,95,558905
WHO Regions,eur,2013,mcv2,10755464,9557586,89,1197878
WHO Regions,eur,2014,hepbb,11306751,4571822,40,6734929
WHO Regions,eur,2014,bcg,7026775,6337966,90,688809
WHO Regions,eur,2014,rcv1,11201211,10487603,94,713608
WHO Regions,eur,2014,pcv3,11201211,5248379,47,5952832
WHO Regions,eur,2014,hepb3,11201211,9091370,81,2109841
WHO Regions,eur,2014,hib3,11201211,8591830,77,2609381
WHO Regions,eur,2014,dtp3,11201211,10435245,93,765966
WHO Regions,eur,2014,dtp1,11201211,10737151,96,464060
WHO Regions,eur,2014,mcv1,11201211,10487603,94,713608
WHO Regions,eur,2014,pol3,11201211,10519668,94,681543
WHO Regions,eur,2014,rotac,11201211,1309130,12,9892081
WHO Regions,eur,2014,mcv2,10880465,9663077,89,1217388
WHO Regions,eur,2015,bcg,6985248,6263405,90,721843
WHO Regions,eur,2015,hepbb,11254566,4533313,40,6721253
WHO Regions,eur,2015,rcv1,11153068,10479106,94,673962
WHO Regions,eur,2015,dtp3,11153068,10407844,93,745224
WHO Regions,eur,2015,pcv3,11153068,5444761,49,5708307
WHO Regions,eur,2015,pol3,11153068,10512697,94,640371
WHO Regions,eur,2015,hib3,11153068,8563521,77,2589547
WHO Regions,eur,2015,rotac,11153068,2526829,23,8626239
WHO Regions,eur,2015,mcv1,11153068,10479106,94,673962
WHO Regions,eur,2015,dtp1,11153068,10713109,96,439959
WHO Regions,eur,2015,hepb3,11153068,9079270,81,2073798
WHO Regions,eur,2015,mcv2,11032489,9778878,89,1253611
WHO Regions,eur,2016,bcg,6921229,6314105,91,607124
WHO Regions,eur,2016,hepbb,11182889,4384108,39,6798781
WHO Regions,eur,2016,dtp3,11085315,10241042,92,844273
WHO Regions,eur,2016,rcv1,11085315,10316812,93,768503
WHO Regions,eur,2016,pol3,11085315,10394683,94,690632
WHO Regions,eur,2016,dtp1,11085315,10560917,95,524398
WHO Regions,eur,2016,rotac,11085315,2567641,23,8517674
WHO Regions,eur,2016,mcv1,11085315,10316812,93,768503
WHO Regions,eur,2016,hepb3,11085315,8984603,81,2100712
WHO Regions,eur,2016,pcv3,11085315,6888214,62,4197101
WHO Regions,eur,2016,hib3,11085315,8485058,77,2600257
WHO Regions,eur,2016,mcv2,11138311,9784035,88,1354276
WHO Regions,amr,1980,bcg,11554251,6150404,53,5403847
WHO Regions,amr,1980,mcv1,14602679,7442946,51,7159733
WHO Regions,amr,1980,rcv1,14602679,2920017,20,11682662
WHO Regions,amr,1980,dtp3,14602679,7273999,50,7328680
WHO Regions,amr,1980,dtp1,14602679,9903210,68,4699469
WHO Regions,amr,1980,pol3,14602679,9710514,66,4892165
WHO Regions,amr,1981,bcg,11633182,6713159,58,4920023
WHO Regions,amr,1981,rcv1,14767667,3354086,23,11413581
WHO Regions,amr,1981,dtp3,14767667,7928574,54,6839093
WHO Regions,amr,1981,pol3,14767667,9011035,61,5756632
WHO Regions,amr,1981,mcv1,14767667,8647300,59,6120367
WHO Regions,amr,1981,dtp1,14767667,10596249,72,4171418
WHO Regions,amr,1982,bcg,11698909,7254806,62,4444103
WHO Regions,amr,1982,rcv1,14923985,3447509,23,11476476
WHO Regions,amr,1982,pol3,14923985,9855431,66,5068554
WHO Regions,amr,1982,mcv1,14923985,8742372,59,6181613
WHO Regions,amr,1982,dtp3,14923985,8520559,57,6403426
WHO Regions,amr,1982,dtp1,14923985,11107446,74,3816539
WHO Regions,amr,1983,bcg,11751473,7511629,64,4239844
WHO Regions,amr,1983,mcv1,15067789,8788759,58,6279030
WHO Regions,amr,1983,dtp3,15067789,8966759,60,6101030
WHO Regions,amr,1983,rcv1,15067789,3553270,24,11514519
WHO Regions,amr,1983,pol3,15067789,10131692,67,4936097
WHO Regions,amr,1983,dtp1,15067789,11485201,76,3582588
WHO Regions,amr,1984,bcg,11791110,7886079,67,3905031
WHO Regions,amr,1984,pol3,15196283,10992117,72,4204166
WHO Regions,amr,1984,mcv1,15196283,9348700,62,5847583
WHO Regions,amr,1984,dtp3,15196283,9795076,64,5401207
WHO Regions,amr,1984,dtp1,15196283,12164319,80,3031964
WHO Regions,amr,1984,rcv1,15196283,3618594,24,11577689
WHO Regions,amr,1985,bcg,11818559,6919642,59,4898917
WHO Regions,amr,1985,dtp3,15308523,9778689,64,5529834
WHO Regions,amr,1985,pol3,15308523,10144964,66,5163559
WHO Regions,amr,1985,dtp1,15308523,12243773,80,3064750
WHO Regions,amr,1985,hepb3,15308523,0,0,15308523
WHO Regions,amr,1985,rcv1,15308523,3640450,24,11668073
WHO Regions,amr,1985,mcv1,15308523,10319464,67,4989059
WHO Regions,amr,1986,bcg,11835181,7929109,67,3906072
WHO Regions,amr,1986,dtp1,15405649,12451308,81,2954341
WHO Regions,amr,1986,rcv1,15405649,3849821,25,11555828
WHO Regions,amr,1986,mcv1,15405649,10531999,68,4873650
WHO Regions,amr,1986,hepb3,15405649,0,0,15405649
WHO Regions,amr,1986,dtp3,15405649,9968354,65,5437295
WHO Regions,amr,1986,pol3,15405649,11015537,72,4390112
WHO Regions,amr,1987,bcg,11843375,8437911,71,3405464
WHO Regions,amr,1987,rcv1,15490655,3708488,24,11782167
WHO Regions,amr,1987,dtp1,15490655,13086024,84,2404631
WHO Regions,amr,1987,dtp3,15490655,10667062,69,4823593
WHO Regions,amr,1987,pol3,15490655,11735430,76,3755225
WHO Regions,amr,1987,hepb3,15490655,0,0,15490655
WHO Regions,amr,1987,mcv1,15490655,10194292,66,5296363
WHO Regions,amr,1988,bcg,11845513,9009777,76,2835736
WHO Regions,amr,1988,dtp3,15565557,11133863,72,4431694
WHO Regions,amr,1988,pol3,15565557,12404854,80,3160703
WHO Regions,amr,1988,rcv1,15565557,4400067,28,11165490
WHO Regions,amr,1988,dtp1,15565557,13458585,86,2106972
WHO Regions,amr,1988,hepb3,15565557,0,0,15565557
WHO Regions,amr,1988,mcv1,15565557,11557049,74,4008508
WHO Regions,amr,1989,bcg,11843256,9197273,78,2645983
WHO Regions,amr,1989,dtp3,15630134,11254637,72,4375497
WHO Regions,amr,1989,dtp1,15630134,13624755,87,2005379
WHO Regions,amr,1989,pol3,15630134,12108431,77,3521703
WHO Regions,amr,1989,rcv1,15630134,4296900,27,11333234
WHO Regions,amr,1989,mcv1,15630134,11891616,76,3738518
WHO Regions,amr,1989,hepb3,15630134,0,0,15630134
WHO Regions,amr,1990,bcg,11838707,9392400,79,2446307
WHO Regions,amr,1990,hib3,15682631,0,0,15682631
WHO Regions,amr,1990,rcv1,15682631,4469382,28,11213249
WHO Regions,amr,1990,hepb3,15682631,0,0,15682631
WHO Regions,amr,1990,mcv1,15682631,12503234,80,3179397
WHO Regions,amr,1990,dtp3,15682631,11598577,74,4084054
WHO Regions,amr,1990,pol3,15682631,11663206,74,4019425
WHO Regions,amr,1990,dtp1,15682631,13893316,89,1789315
WHO Regions,amr,1991,bcg,11833579,10185888,86,1647691
WHO Regions,amr,1991,dtp3,15720555,12590608,80,3129947
WHO Regions,amr,1991,hib3,15720555,0,0,15720555
WHO Regions,amr,1991,dtp1,15720555,14492736,92,1227819
WHO Regions,amr,1991,rcv1,15720555,4410687,28,11309868
WHO Regions,amr,1991,mcv1,15720555,12942220,82,2778335
WHO Regions,amr,1991,pol3,15720555,12103097,77,3617458
WHO Regions,amr,1991,hepb3,15720555,0,0,15720555
WHO Regions,amr,1992,bcg,11827672,10531216,89,1296456
WHO Regions,amr,1992,pol3,15742561,11980992,76,3761569
WHO Regions,amr,1992,dtp3,15742561,12434766,79,3307795
WHO Regions,amr,1992,hib3,15742561,0,0,15742561
WHO Regions,amr,1992,dtp1,15742561,14423982,92,1318579
WHO Regions,amr,1992,rcv1,15742561,4273404,27,11469157
WHO Regions,amr,1992,mcv1,15742561,13067224,83,2675337
WHO Regions,amr,1992,hepb3,15742561,0,0,15742561
WHO Regions,amr,1993,bcg,11820115,10842943,92,977172
WHO Regions,amr,1993,dtp1,15748686,14648353,93,1100333
WHO Regions,amr,1993,hib3,15748686,0,0,15748686
WHO Regions,amr,1993,dtp3,15748686,12788540,81,2960146
WHO Regions,amr,1993,mcv1,15748686,13046416,83,2702270
WHO Regions,amr,1993,hepb3,15748686,770412,5,14978274
WHO Regions,amr,1993,rcv1,15748686,4376825,28,11371861
WHO Regions,amr,1993,pol3,15748686,12164615,77,3584071
WHO Regions,amr,1994,bcg,11809905,11079475,94,730430
WHO Regions,amr,1994,mcv1,15740316,13292336,84,2447980
WHO Regions,amr,1994,dtp3,15740316,13199442,84,2540874
WHO Regions,amr,1994,pol3,15740316,12823779,81,2916537
WHO Regions,amr,1994,rcv1,15740316,4568248,29,11172068
WHO Regions,amr,1994,hepb3,15740316,1954542,12,13785774
WHO Regions,amr,1994,hib3,15740316,0,0,15740316
WHO Regions,amr,1994,dtp1,15740316,13317363,85,2422953
WHO Regions,amr,1995,bcg,11794640,11333034,96,461606
WHO Regions,amr,1995,rcv1,15719938,5337059,34,10382879
WHO Regions,amr,1995,dtp1,15719938,14620788,93,1099150
WHO Regions,amr,1995,hib3,15719938,3573994,23,12145944
WHO Regions,amr,1995,mcv1,15719938,13646177,87,2073761
WHO Regions,amr,1995,dtp3,15719938,13548273,86,2171665
WHO Regions,amr,1995,pol3,15719938,13370916,85,2349022
WHO Regions,amr,1995,hepb3,15719938,3786741,24,11933197
WHO Regions,amr,1996,bcg,11771245,11350991,96,420254
WHO Regions,amr,1996,rcv1,15690726,5381368,34,10309358
WHO Regions,amr,1996,hepb3,15690726,4697051,30,10993675
WHO Regions,amr,1996,hib3,15690726,4109153,26,11581573
WHO Regions,amr,1996,mcv1,15690726,13509968,86,2180758
WHO Regions,amr,1996,pol3,15690726,13490576,86,2200150
WHO Regions,amr,1996,dtp3,15690726,13364469,85,2326257
WHO Regions,amr,1996,dtp1,15690726,14198945,90,1491781
WHO Regions,amr,1997,bcg,11737356,11299686,96,437670
WHO Regions,amr,1997,hepb3,15656256,4416430,28,11239826
WHO Regions,amr,1997,hib3,15656256,4223382,27,11432874
WHO Regions,amr,1997,pol3,15656256,13780300,88,1875956
WHO Regions,amr,1997,dtp3,15656256,13494421,86,2161835
WHO Regions,amr,1997,rcv1,15656256,6488863,41,9167393
WHO Regions,amr,1997,mcv1,15656256,13994698,89,1661558
WHO Regions,amr,1997,dtp1,15656256,14996651,96,659605
WHO Regions,amr,1998,bcg,11691687,11074449,95,617238
WHO Regions,amr,1998,hepb3,15619625,4822381,31,10797244
WHO Regions,amr,1998,hib3,15619625,5167935,33,10451690
WHO Regions,amr,1998,mcv1,15619625,14261933,91,1357692
WHO Regions,amr,1998,rcv1,15619625,9516416,61,6103209
WHO Regions,amr,1998,pol3,15619625,13854525,89,1765100
WHO Regions,amr,1998,dtp1,15619625,15054666,96,564959
WHO Regions,amr,1998,dtp3,15619625,13807246,88,1812379
WHO Regions,amr,1999,bcg,11634243,11148017,96,486226
WHO Regions,amr,1999,pol3,15582788,14151720,91,1431068
WHO Regions,amr,1999,hib3,15582788,5896571,38,9686217
WHO Regions,amr,1999,dtp1,15582788,15161500,97,421288
WHO Regions,amr,1999,mcv1,15582788,14365584,92,1217204
WHO Regions,amr,1999,hepb3,15582788,7524528,48,8058260
WHO Regions,amr,1999,dtp3,15582788,14104021,91,1478767
WHO Regions,amr,1999,rcv1,15582788,9433775,61,6149013
WHO Regions,amr,2000,hepbb,15907341,3727826,23,12179515
WHO Regions,amr,2000,bcg,11564816,11139818,96,424998
WHO Regions,amr,2000,pol3,15546687,14145145,91,1401542
WHO Regions,amr,2000,dtp3,15546687,14213338,91,1333349
WHO Regions,amr,2000,dtp1,15546687,15087124,97,459563
WHO Regions,amr,2000,hepb3,15546687,10903845,70,4642842
WHO Regions,amr,2000,rcv1,15546687,13205988,85,2340699
WHO Regions,amr,2000,mcv1,15546687,14445967,93,1100720
WHO Regions,amr,2000,hib3,15546687,11754301,76,3792386
WHO Regions,amr,2000,mcv2,15578037,6776139,43,8801898
WHO Regions,amr,2001,hepbb,15855043,3863336,24,11991707
WHO Regions,amr,2001,bcg,11483807,10940152,95,543655
WHO Regions,amr,2001,pol3,15511026,14107665,91,1403361
WHO Regions,amr,2001,rcv1,15511026,13632160,88,1878866
WHO Regions,amr,2001,mcv1,15511026,14536745,94,974281
WHO Regions,amr,2001,dtp3,15511026,14105938,91,1405088
WHO Regions,amr,2001,hib3,15511026,12058975,78,3452051
WHO Regions,amr,2001,dtp1,15511026,14844670,96,666356
WHO Regions,amr,2001,hepb3,15511026,11175907,72,4335119
WHO Regions,amr,2001,mcv2,15500566,6899150,45,8601416
WHO Regions,amr,2002,hepbb,15802487,4594660,29,11207827
WHO Regions,amr,2002,bcg,11394407,10881670,96,512737
WHO Regions,amr,2002,hepb3,15474073,11662369,75,3811704
WHO Regions,amr,2002,hib3,15474073,12525264,81,2948809
WHO Regions,amr,2002,mcv1,15474073,14368484,93,1105589
WHO Regions,amr,2002,dtp1,15474073,14840056,96,634017
WHO Regions,amr,2002,dtp3,15474073,14221114,92,1252959
WHO Regions,amr,2002,rcv1,15474073,13478059,87,1996014
WHO Regions,amr,2002,pol3,15474073,14194929,92,1279144
WHO Regions,amr,2002,mcv2,15420750,6421044,42,8999706
WHO Regions,amr,2003,hepbb,15748648,5651681,36,10096967
WHO Regions,amr,2003,bcg,11300738,10926193,97,374545
WHO Regions,amr,2003,hib3,15434571,13167252,85,2267319
WHO Regions,amr,2003,hepb3,15434571,12860666,83,2573905
WHO Regions,amr,2003,dtp3,15434571,14418887,93,1015684
WHO Regions,amr,2003,rcv1,15434571,14137327,92,1297244
WHO Regions,amr,2003,pol3,15434571,14336944,93,1097627
WHO Regions,amr,2003,dtp1,15434571,14934110,97,500461
WHO Regions,amr,2003,mcv1,15434571,14455771,94,978800
WHO Regions,amr,2003,mcv2,15591313,6271999,40,9319314
WHO Regions,amr,2004,bcg,11206674,10837357,97,369317
WHO Regions,amr,2004,hepbb,15693580,6631625,42,9061955
WHO Regions,amr,2004,hib3,15392491,13659435,89,1733056
WHO Regions,amr,2004,mcv1,15392491,14327817,93,1064674
WHO Regions,amr,2004,dtp1,15392491,14862276,97,530215
WHO Regions,amr,2004,rcv1,15392491,14184371,92,1208120
WHO Regions,amr,2004,dtp3,15392491,14448790,94,943701
WHO Regions,amr,2004,pol3,15392491,14192525,92,1199966
WHO Regions,amr,2004,hepb3,15392491,13103909,85,2288582
WHO Regions,amr,2004,mcv2,15592866,6423656,41,9169210
WHO Regions,amr,2005,hepbb,15636563,6820254,44,8816309
WHO Regions,amr,2005,bcg,11117859,10747894,97,369965
WHO Regions,amr,2005,dtp3,15347086,14457647,94,889439
WHO Regions,amr,2005,dtp1,15347086,14964257,98,382829
WHO Regions,amr,2005,hib3,15347086,14222212,93,1124874
WHO Regions,amr,2005,hepb3,15347086,13683674,89,1663412
WHO Regions,amr,2005,mcv1,15347086,14199940,93,1147146
WHO Regions,amr,2005,pol3,15347086,14165208,92,1181878
WHO Regions,amr,2005,rcv1,15347086,14053556,92,1293530
WHO Regions,amr,2005,mcv2,15575781,6266613,40,9309168
WHO Regions,amr,2006,bcg,11039900,10644749,96,395151
WHO Regions,amr,2006,hepbb,15576651,6808234,44,8768417
WHO Regions,amr,2006,rcv1,15297484,14170296,93,1127188
WHO Regions,amr,2006,dtp1,15297484,14751886,96,545598
WHO Regions,amr,2006,mcv1,15297484,14319583,94,977901
WHO Regions,amr,2006,pol3,15297484,14311225,94,986259
WHO Regions,amr,2006,hib3,15297484,14034671,92,1262813
WHO Regions,amr,2006,rotac,15297484,1627442,11,13670042
WHO Regions,amr,2006,dtp3,15297484,14398857,94,898627
WHO Regions,amr,2006,hepb3,15297484,13766250,90,1531234
WHO Regions,amr,2006,mcv2,15637676,6085777,39,9551899
WHO Regions,amr,2007,hepbb,15514029,6979490,45,8534539
WHO Regions,amr,2007,bcg,10975168,10533018,96,442150
WHO Regions,amr,2007,mcv1,15244113,14221168,93,1022945
WHO Regions,amr,2007,pol3,15244113,14182319,93,1061794
WHO Regions,amr,2007,hepb3,15244113,13623995,89,1620118
WHO Regions,amr,2007,hib3,15244113,13918488,91,1325625
WHO Regions,amr,2007,rotac,15244113,2852964,19,12391149
WHO Regions,amr,2007,dtp3,15244113,14278543,94,965570
WHO Regions,amr,2007,dtp1,15244113,14605316,96,638797
WHO Regions,amr,2007,rcv1,15244113,14069078,92,1175035
WHO Regions,amr,2007,mcv2,15666664,5772230,37,9894434
WHO Regions,amr,2008,hepbb,15449717,7152056,46,8297661
WHO Regions,amr,2008,bcg,10924248,10583000,97,341248
WHO Regions,amr,2008,hib3,15188283,13770601,91,1417682
WHO Regions,amr,2008,pol3,15188283,14216489,94,971794
WHO Regions,amr,2008,pcv3,15188283,4275698,28,10912585
WHO Regions,amr,2008,mcv1,15188283,14299033,94,889250
WHO Regions,amr,2008,dtp1,15188283,14740048,97,448235
WHO Regions,amr,2008,dtp3,15188283,14142801,93,1045482
WHO Regions,amr,2008,hepb3,15188283,13576772,89,1611511
WHO Regions,amr,2008,rotac,15188283,4505085,30,10683198
WHO Regions,amr,2008,rcv1,15188283,14299033,94,889250
WHO Regions,amr,2008,mcv2,15447012,6090552,39,9356460
WHO Regions,amr,2009,hepbb,15385331,7276610,47,8108721
WHO Regions,amr,2009,bcg,10886509,10513069,97,373440
WHO Regions,amr,2009,pol3,15131783,14083715,93,1048068
WHO Regions,amr,2009,mcv1,15131783,14047246,93,1084537
WHO Regions,amr,2009,hepb3,15131783,13737677,91,1394106
WHO Regions,amr,2009,dtp3,15131783,14220086,94,911697
WHO Regions,amr,2009,rcv1,15131783,14047246,93,1084537
WHO Regions,amr,2009,pcv3,15131783,5105007,34,10026776
WHO Regions,amr,2009,dtp1,15131783,14596003,96,535780
WHO Regions,amr,2009,hib3,15131783,13592344,90,1539439
WHO Regions,amr,2009,rotac,15131783,8410678,56,6721105
WHO Regions,amr,2009,mcv2,15383805,6489872,42,8893933
WHO Regions,amr,2010,bcg,10859144,10446538,96,412606
WHO Regions,amr,2010,hepbb,15324037,9471672,62,5852365
WHO Regions,amr,2010,pol3,15077986,13990790,93,1087196
WHO Regions,amr,2010,rcv1,15077986,14002344,93,1075642
WHO Regions,amr,2010,mcv1,15077986,14002344,93,1075642
WHO Regions,amr,2010,dtp1,15077986,14530063,96,547923
WHO Regions,amr,2010,hib3,15077986,13725874,91,1352112
WHO Regions,amr,2010,pcv3,15077986,7745861,51,7332125
WHO Regions,amr,2010,rotac,15077986,9468588,63,5609398
WHO Regions,amr,2010,hepb3,15077986,13549431,90,1528555
WHO Regions,amr,2010,dtp3,15077986,14111691,94,966295
WHO Regions,amr,2010,mcv2,15336651,6549841,43,8786810
WHO Regions,amr,2011,hepbb,15269480,10097703,66,5171777
WHO Regions,amr,2011,bcg,10837561,10403189,96,434372
WHO Regions,amr,2011,hib3,15030685,13760991,92,1269694
WHO Regions,amr,2011,rcv1,15030685,14068533,94,962152
WHO Regions,amr,2011,dtp3,15030685,14056790,94,973895
WHO Regions,amr,2011,dtp1,15030685,14507951,97,522734
WHO Regions,amr,2011,pcv3,15030685,10427776,69,4602909
WHO Regions,amr,2011,mcv1,15030685,14068533,94,962152
WHO Regions,amr,2011,pol3,15030685,13947241,93,1083444
WHO Regions,amr,2011,rotac,15030685,10420514,69,4610171
WHO Regions,amr,2011,hepb3,15030685,13603664,91,1427021
WHO Regions,amr,2011,mcv2,15289392,7246106,47,8043286
WHO Regions,amr,2012,hepbb,15223739,10009178,66,5214561
WHO Regions,amr,2012,bcg,10815737,10453254,97,362483
WHO Regions,amr,2012,hib3,14992035,13763144,92,1228891
WHO Regions,amr,2012,pol3,14992035,13934581,93,1057454
WHO Regions,amr,2012,rcv1,14992035,14116196,94,875839
WHO Regions,amr,2012,dtp1,14992035,14434027,96,558008
WHO Regions,amr,2012,mcv1,14992035,14116196,94,875839
WHO Regions,amr,2012,rotac,14992035,10686570,71,4305465
WHO Regions,amr,2012,hepb3,14992035,13598619,91,1393416
WHO Regions,amr,2012,dtp3,14992035,14008236,93,983799
WHO Regions,amr,2012,pcv3,14992035,11504679,77,3487356
WHO Regions,amr,2012,mcv2,15231951,7429467,49,7802484
WHO Regions,amr,2013,bcg,10788649,10172599,94,616050
WHO Regions,amr,2013,hepbb,15187554,10076699,66,5110855
WHO Regions,amr,2013,rcv1,14962837,13716813,92,1246024
WHO Regions,amr,2013,hib3,14962837,13564188,91,1398649
WHO Regions,amr,2013,rotac,14962837,10701861,72,4260976
WHO Regions,amr,2013,dtp1,14962837,14232950,95,729887
WHO Regions,amr,2013,pcv3,14962837,11769400,79,3193437
WHO Regions,amr,2013,mcv1,14962837,13716813,92,1246024
WHO Regions,amr,2013,hepb3,14962837,13275007,89,1687830
WHO Regions,amr,2013,pol3,14962837,13377469,89,1585368
WHO Regions,amr,2013,dtp3,14962837,13597201,91,1365636
WHO Regions,amr,2013,mcv2,15072248,6856533,45,8215715
WHO Regions,amr,2014,hepbb,15160361,10084816,67,5075545
WHO Regions,amr,2014,bcg,10753668,10287018,96,466650
WHO Regions,amr,2014,dtp3,14942592,13486013,90,1456579
WHO Regions,amr,2014,dtp1,14942592,14261530,95,681062
WHO Regions,amr,2014,rotac,14942592,10715645,72,4226947
WHO Regions,amr,2014,hib3,14942592,13453643,90,1488949
WHO Regions,amr,2014,pol3,14942592,13409427,90,1533165
WHO Regions,amr,2014,mcv1,14942592,13792337,92,1150255
WHO Regions,amr,2014,hepb3,14942592,13240564,89,1702028
WHO Regions,amr,2014,pcv3,14942592,12345320,83,2597272
WHO Regions,amr,2014,rcv1,14942592,13792337,92,1150255
WHO Regions,amr,2014,mcv2,14990205,8085641,54,6904564
WHO Regions,amr,2015,bcg,10709334,10287226,96,422108
WHO Regions,amr,2015,hepbb,15140380,10395357,69,4745023
WHO Regions,amr,2015,mcv1,14929548,13791547,92,1138001
WHO Regions,amr,2015,rotac,14929548,11331919,76,3597629
WHO Regions,amr,2015,dtp3,14929548,13645511,91,1284037
WHO Regions,amr,2015,rcv1,14929548,13791547,92,1138001
WHO Regions,amr,2015,pcv3,14929548,12693220,85,2236328
WHO Regions,amr,2015,hib3,14929548,13548218,91,1381330
WHO Regions,amr,2015,pol3,14929548,13677602,92,1251946
WHO Regions,amr,2015,dtp1,14929548,14401066,96,528482
WHO Regions,amr,2015,hepb3,14929548,13265899,89,1663649
WHO Regions,amr,2015,mcv2,14937941,7914709,53,7023232
WHO Regions,amr,2016,hepbb,15124715,10019858,66,5104857
WHO Regions,amr,2016,bcg,10655874,10173494,95,482380
WHO Regions,amr,2016,mcv1,14920769,13753486,92,1167283
WHO Regions,amr,2016,rcv1,14920769,13753486,92,1167283
WHO Regions,amr,2016,pcv3,14920769,12550665,84,2370104
WHO Regions,amr,2016,hib3,14920769,13478419,90,1442350
WHO Regions,amr,2016,dtp3,14920769,13584890,91,1335879
WHO Regions,amr,2016,rotac,14920769,11050481,74,3870288
WHO Regions,amr,2016,dtp1,14920769,14204474,95,716295
WHO Regions,amr,2016,pol3,14920769,13787634,92,1133135
WHO Regions,amr,2016,hepb3,14920769,13262634,89,1658135
WHO Regions,amr,2016,mcv2,14851606,8088799,54,6762807
WHO Regions,wpr,1980,pol3,27076199,1280255,5,25795944
WHO Regions,wpr,1980,mcv1,27076199,1228508,5,25847691
WHO Regions,wpr,1980,dtp1,27076199,3240074,12,23836125
WHO Regions,wpr,1980,dtp3,27076199,2278955,8,24797244
WHO Regions,wpr,1980,rcv1,27076199,40271,0,27035928
WHO Regions,wpr,1981,pol3,27575062,1809593,7,25765469
WHO Regions,wpr,1981,rcv1,27575062,38570,0,27536492
WHO Regions,wpr,1981,dtp1,27575062,4159457,15,23415605
WHO Regions,wpr,1981,dtp3,27575062,3131451,11,24443611
WHO Regions,wpr,1981,mcv1,27575062,1203514,4,26371548
WHO Regions,wpr,1982,dtp1,28420827,4217789,15,24203038
WHO Regions,wpr,1982,dtp3,28420827,3262719,11,25158108
WHO Regions,wpr,1982,pol3,28420827,20485819,72,7935008
WHO Regions,wpr,1982,mcv1,28420827,1320110,5,27100717
WHO Regions,wpr,1982,rcv1,28420827,75337,0,28345490
WHO Regions,wpr,1983,dtp1,29499909,22413222,76,7086687
WHO Regions,wpr,1983,dtp3,29499909,16263276,55,13236633
WHO Regions,wpr,1983,pol3,29499909,21729861,74,7770048
WHO Regions,wpr,1983,mcv1,29499909,19521875,66,9978034
WHO Regions,wpr,1983,rcv1,29499909,439982,1,29059927
WHO Regions,wpr,1984,dtp1,30698651,25923010,84,4775641
WHO Regions,wpr,1984,mcv1,30698651,22560640,73,8138011
WHO Regions,wpr,1984,pol3,30698651,23502779,77,7195872
WHO Regions,wpr,1984,dtp3,30698651,20633482,67,10065169
WHO Regions,wpr,1984,rcv1,30698651,638815,2,30059836
WHO Regions,wpr,1985,mcv1,31836807,25015323,79,6821484
WHO Regions,wpr,1985,dtp1,31836807,28241953,89,3594854
WHO Regions,wpr,1985,rcv1,31836807,817690,3,31019117
WHO Regions,wpr,1985,hepb3,31836807,0,0,31836807
WHO Regions,wpr,1985,pol3,31836807,26246367,82,5590440
WHO Regions,wpr,1985,dtp3,31836807,23422607,74,8414200
WHO Regions,wpr,1986,pol3,32718595,22058061,67,10660534
WHO Regions,wpr,1986,dtp1,32718595,29240252,89,3478343
WHO Regions,wpr,1986,rcv1,32718595,797640,2,31920955
WHO Regions,wpr,1986,hepb3,32718595,0,0,32718595
WHO Regions,wpr,1986,mcv1,32718595,19988658,61,12729937
WHO Regions,wpr,1986,dtp3,32718595,24347467,74,8371128
WHO Regions,wpr,1987,pol3,33217793,25298070,76,7919723
WHO Regions,wpr,1987,dtp1,33217793,29598411,89,3619382
WHO Regions,wpr,1987,dtp3,33217793,24136103,73,9081690
WHO Regions,wpr,1987,mcv1,33217793,24316293,73,8901500
WHO Regions,wpr,1987,hepb3,33217793,0,0,33217793
WHO Regions,wpr,1987,rcv1,33217793,746316,2,32471477
WHO Regions,wpr,1988,dtp1,33253974,31781415,96,1472559
WHO Regions,wpr,1988,dtp3,33253974,29915208,90,3338766
WHO Regions,wpr,1988,pol3,33253974,30192204,91,3061770
WHO Regions,wpr,1988,hepb3,33253974,0,0,33253974
WHO Regions,wpr,1988,mcv1,33253974,29467614,89,3786360
WHO Regions,wpr,1988,rcv1,33253974,693235,2,32560739
WHO Regions,wpr,1989,pol3,32810803,30268022,92,2542781
WHO Regions,wpr,1989,dtp1,32810803,31758743,97,1052060
WHO Regions,wpr,1989,dtp3,32810803,30289109,92,2521694
WHO Regions,wpr,1989,hepb3,32810803,340837,1,32469966
WHO Regions,wpr,1989,rcv1,32810803,1892625,6,30918178
WHO Regions,wpr,1989,mcv1,32810803,29741210,91,3069593
WHO Regions,wpr,1990,pol3,31924448,30137884,94,1786564
WHO Regions,wpr,1990,hepb3,31924448,512232,2,31412216
WHO Regions,wpr,1990,rcv1,31924448,1871238,6,30053210
WHO Regions,wpr,1990,dtp1,31924448,30890590,97,1033858
WHO Regions,wpr,1990,dtp3,31924448,29936872,94,1987576
WHO Regions,wpr,1990,hib3,31924448,0,0,31924448
WHO Regions,wpr,1990,mcv1,31924448,29913176,94,2011272
WHO Regions,wpr,1991,mcv1,30692912,27338335,89,3354577
WHO Regions,wpr,1991,hepb3,30692912,548460,2,30144452
WHO Regions,wpr,1991,pol3,30692912,28346958,92,2345954
WHO Regions,wpr,1991,hib3,30692912,0,0,30692912
WHO Regions,wpr,1991,rcv1,30692912,1843720,6,28849192
WHO Regions,wpr,1991,dtp1,30692912,29464045,96,1228867
WHO Regions,wpr,1991,dtp3,30692912,28146334,92,2546578
WHO Regions,wpr,1992,rcv1,29297801,1816288,6,27481513
WHO Regions,wpr,1992,pol3,29297801,26356858,90,2940943
WHO Regions,wpr,1992,hib3,29297801,0,0,29297801
WHO Regions,wpr,1992,mcv1,29297801,24926060,85,4371741
WHO Regions,wpr,1992,hepb3,29297801,590587,2,28707214
WHO Regions,wpr,1992,dtp3,29297801,25910320,88,3387481
WHO Regions,wpr,1992,dtp1,29297801,27926323,95,1371478
WHO Regions,wpr,1993,hib3,27905270,0,0,27905270
WHO Regions,wpr,1993,rcv1,27905270,1794913,6,26110357
WHO Regions,wpr,1993,mcv1,27905270,22403570,80,5501700
WHO Regions,wpr,1993,dtp3,27905270,24010677,86,3894593
WHO Regions,wpr,1993,hepb3,27905270,636613,2,27268657
WHO Regions,wpr,1993,pol3,27905270,24426122,88,3479148
WHO Regions,wpr,1993,dtp1,27905270,26325450,94,1579820
WHO Regions,wpr,1994,mcv1,26611995,20523976,77,6088019
WHO Regions,wpr,1994,rcv1,26611995,1950068,7,24661927
WHO Regions,wpr,1994,hib3,26611995,0,0,26611995
WHO Regions,wpr,1994,dtp3,26611995,22323781,84,4288214
WHO Regions,wpr,1994,dtp1,26611995,24829846,93,1782149
WHO Regions,wpr,1994,pol3,26611995,22836233,86,3775762
WHO Regions,wpr,1994,hepb3,26611995,708708,3,25903287
WHO Regions,wpr,1995,mcv1,25496817,20708559,81,4788258
WHO Regions,wpr,1995,dtp3,25496817,20387397,80,5109420
WHO Regions,wpr,1995,rcv1,25496817,2106890,8,23389927
WHO Regions,wpr,1995,hib3,25496817,0,0,25496817
WHO Regions,wpr,1995,dtp1,25496817,23319442,91,2177375
WHO Regions,wpr,1995,hepb3,25496817,2217169,9,23279648
WHO Regions,wpr,1995,pol3,25496817,21006328,82,4490489
WHO Regions,wpr,1996,mcv1,24598914,20722054,84,3876860
WHO Regions,wpr,1996,rcv1,24598914,2071846,8,22527068
WHO Regions,wpr,1996,hib3,24598914,0,0,24598914
WHO Regions,wpr,1996,dtp1,24598914,22854827,93,1744087
WHO Regions,wpr,1996,pol3,24598914,20744540,84,3854374
WHO Regions,wpr,1996,dtp3,24598914,20542081,84,4056833
WHO Regions,wpr,1996,hepb3,24598914,2152783,9,22446131
WHO Regions,wpr,1997,mcv1,23889166,19996794,84,3892372
WHO Regions,wpr,1997,hib3,23889166,260721,1,23628445
WHO Regions,wpr,1997,dtp1,23889166,22235651,93,1653515
WHO Regions,wpr,1997,rcv1,23889166,2011629,8,21877537
WHO Regions,wpr,1997,dtp3,23889166,19818335,83,4070831
WHO Regions,wpr,1997,hepb3,23889166,2028550,8,21860616
WHO Regions,wpr,1997,pol3,23889166,20372182,85,3516984
WHO Regions,wpr,1998,rcv1,23340192,2477857,11,20862335
WHO Regions,wpr,1998,dtp3,23340192,19382628,83,3957564
WHO Regions,wpr,1998,mcv1,23340192,19577215,84,3762977
WHO Regions,wpr,1998,dtp1,23340192,21779359,93,1560833
WHO Regions,wpr,1998,pol3,23340192,19845460,85,3494732
WHO Regions,wpr,1998,hepb3,23340192,1943689,8,21396503
WHO Regions,wpr,1998,hib3,23340192,268642,1,23071550
WHO Regions,wpr,1999,mcv1,22953788,19468074,85,3485714
WHO Regions,wpr,1999,dtp3,22953788,19348951,84,3604837
WHO Regions,wpr,1999,rcv1,22953788,2485632,11,20468156
WHO Regions,wpr,1999,dtp1,22953788,21421236,93,1532552
WHO Regions,wpr,1999,hib3,22953788,284633,1,22669155
WHO Regions,wpr,1999,hepb3,22953788,2014196,9,20939592
WHO Regions,wpr,1999,pol3,22953788,19726469,86,3227319
WHO Regions,wpr,2000,hepbb,23383382,532338,2,22851044
WHO Regions,wpr,2000,rcv1,22724310,2482737,11,20241573
WHO Regions,wpr,2000,dtp1,22724310,21253183,94,1471127
WHO Regions,wpr,2000,pol3,22724310,19519049,86,3205261
WHO Regions,wpr,2000,dtp3,22724310,19288519,85,3435791
WHO Regions,wpr,2000,mcv1,22724310,19269848,85,3454462
WHO Regions,wpr,2000,hepb3,22724310,10931527,48,11792783
WHO Regions,wpr,2000,hib3,22724310,294345,1,22429965
WHO Regions,wpr,2000,mcv2,22946836,378253,2,22568583
WHO Regions,wpr,2001,hepbb,23256320,580922,2,22675398
WHO Regions,wpr,2001,pol3,22635774,19257538,85,3378236
WHO Regions,wpr,2001,dtp1,22635774,21373288,94,1262486
WHO Regions,wpr,2001,mcv1,22635774,19437679,86,3198095
WHO Regions,wpr,2001,rcv1,22635774,2462811,11,20172963
WHO Regions,wpr,2001,hepb3,22635774,12720773,56,9915001
WHO Regions,wpr,2001,dtp3,22635774,19491212,86,3144562
WHO Regions,wpr,2001,hib3,22635774,307870,1,22327904
WHO Regions,wpr,2001,mcv2,23096375,570290,2,22526085
WHO Regions,wpr,2002,hepbb,23238382,531707,2,22706675
WHO Regions,wpr,2002,mcv1,22653190,19448485,86,3204705
WHO Regions,wpr,2002,pol3,22653190,19313301,85,3339889
WHO Regions,wpr,2002,hib3,22653190,316926,1,22336264
WHO Regions,wpr,2002,dtp3,22653190,19210819,85,3442371
WHO Regions,wpr,2002,hepb3,22653190,13466450,59,9186740
WHO Regions,wpr,2002,rcv1,22653190,2430656,11,20222534
WHO Regions,wpr,2002,dtp1,22653190,21012516,93,1640674
WHO Regions,wpr,2002,mcv2,23394492,733074,3,22661418
WHO Regions,wpr,2003,hepbb,23293187,561402,2,22731785
WHO Regions,wpr,2003,rcv1,22741298,2390079,11,20351219
WHO Regions,wpr,2003,pol3,22741298,19916209,88,2825089
WHO Regions,wpr,2003,dtp3,22741298,19801211,87,2940087
WHO Regions,wpr,2003,hepb3,22741298,15687788,69,7053510
WHO Regions,wpr,2003,hib3,22741298,319934,1,22421364
WHO Regions,wpr,2003,dtp1,22741298,21409626,94,1331672
WHO Regions,wpr,2003,mcv1,22741298,19609986,86,3131312
WHO Regions,wpr,2003,mcv2,22195146,694452,3,21500694
WHO Regions,wpr,2004,hepbb,23395639,13003078,56,10392561
WHO Regions,wpr,2004,pol3,22875483,20044197,88,2831286
WHO Regions,wpr,2004,dtp1,22875483,21685665,95,1189818
WHO Regions,wpr,2004,rcv1,22875483,2395961,10,20479522
WHO Regions,wpr,2004,dtp3,22875483,20129471,88,2746012
WHO Regions,wpr,2004,hib3,22875483,656165,3,22219318
WHO Regions,wpr,2004,hepb3,22875483,16531838,72,6343645
WHO Regions,wpr,2004,mcv1,22875483,20113437,88,2762046
WHO Regions,wpr,2004,mcv2,22353082,901646,4,21451436
WHO Regions,wpr,2005,hepbb,23530336,14717475,63,8812861
WHO Regions,wpr,2005,dtp1,23040537,21813363,95,1227174
WHO Regions,wpr,2005,dtp3,23040537,20330191,88,2710346
WHO Regions,wpr,2005,rcv1,23040537,2391860,10,20648677
WHO Regions,wpr,2005,mcv1,23040537,20247527,88,2793010
WHO Regions,wpr,2005,hepb3,23040537,17548422,76,5492115
WHO Regions,wpr,2005,pol3,23040537,20286507,88,2754030
WHO Regions,wpr,2005,hib3,23040537,739307,3,22301230
WHO Regions,wpr,2005,mcv2,22565760,14510663,64,8055097
WHO Regions,wpr,2006,hepbb,23691782,15249087,64,8442695
WHO Regions,wpr,2006,rcv1,23230836,2371572,10,20859264
WHO Regions,wpr,2006,dtp3,23230836,21447768,92,1783068
WHO Regions,wpr,2006,mcv1,23230836,21521151,93,1709685
WHO Regions,wpr,2006,dtp1,23230836,22575923,97,654913
WHO Regions,wpr,2006,rotac,23230836,0,0,23230836
WHO Regions,wpr,2006,hepb3,23230836,19771388,85,3459448
WHO Regions,wpr,2006,pol3,23230836,21565781,93,1665055
WHO Regions,wpr,2006,hib3,23230836,784076,3,22446760
WHO Regions,wpr,2006,mcv2,23074367,16512688,72,6561679
WHO Regions,wpr,2007,hepbb,23877949,15734029,66,8143920
WHO Regions,wpr,2007,dtp3,23443890,21562637,92,1881253
WHO Regions,wpr,2007,hepb3,23443890,19928577,85,3515313
WHO Regions,wpr,2007,rcv1,23443890,2329099,10,21114791
WHO Regions,wpr,2007,rotac,23443890,0,0,23443890
WHO Regions,wpr,2007,mcv1,23443890,21670780,92,1773110
WHO Regions,wpr,2007,hib3,23443890,809484,3,22634406
WHO Regions,wpr,2007,dtp1,23443890,22719727,97,724163
WHO Regions,wpr,2007,pol3,23443890,21714201,93,1729689
WHO Regions,wpr,2007,mcv2,23444784,16880605,72,6564179
WHO Regions,wpr,2008,hepbb,24078824,17101639,71,6977185
WHO Regions,wpr,2008,hib3,23669380,879742,4,22789638
WHO Regions,wpr,2008,dtp3,23669380,22588936,95,1080444
WHO Regions,wpr,2008,rcv1,23669380,2323015,10,21346365
WHO Regions,wpr,2008,rotac,23669380,235133,1,23434247
WHO Regions,wpr,2008,pcv3,23669380,264194,1,23405186
WHO Regions,wpr,2008,dtp1,23669380,23141102,98,528278
WHO Regions,wpr,2008,mcv1,23669380,22544537,95,1124843
WHO Regions,wpr,2008,pol3,23669380,22938961,97,730419
WHO Regions,wpr,2008,hepb3,23669380,21011238,89,2658142
WHO Regions,wpr,2008,mcv2,23001020,18857965,82,4143055
WHO Regions,wpr,2009,hepbb,24274133,18151112,75,6123021
WHO Regions,wpr,2009,rcv1,23887076,2379231,10,21507845
WHO Regions,wpr,2009,pcv3,23887076,332365,1,23554711
WHO Regions,wpr,2009,pol3,23887076,23156000,97,731076
WHO Regions,wpr,2009,mcv1,23887076,23091355,97,795721
WHO Regions,wpr,2009,hib3,23887076,1049226,4,22837850
WHO Regions,wpr,2009,dtp1,23887076,23287416,97,599660
WHO Regions,wpr,2009,hepb3,23887076,21957365,92,1929711
WHO Regions,wpr,2009,dtp3,23887076,23120561,97,766515
WHO Regions,wpr,2009,rotac,23887076,243089,1,23643987
WHO Regions,wpr,2009,mcv2,23172608,20078250,87,3094358
WHO Regions,wpr,2010,hepbb,24439656,17914269,73,6525387
WHO Regions,wpr,2010,dtp1,24072733,23208617,96,864116
WHO Regions,wpr,2010,pol3,24072733,23070464,96,1002269
WHO Regions,wpr,2010,hib3,24072733,2427014,10,21645719
WHO Regions,wpr,2010,mcv1,24072733,23131079,96,941654
WHO Regions,wpr,2010,pcv3,24072733,340949,1,23731784
WHO Regions,wpr,2010,dtp3,24072733,23052004,96,1020729
WHO Regions,wpr,2010,rcv1,24072733,14772384,61,9300349
WHO Regions,wpr,2010,hepb3,24072733,21843882,91,2228851
WHO Regions,wpr,2010,rotac,24072733,253598,1,23819135
WHO Regions,wpr,2010,mcv2,23377588,20336366,87,3041222
WHO Regions,wpr,2011,hepbb,24553571,19313363,79,5240208
WHO Regions,wpr,2011,rcv1,24204523,19115175,79,5089348
WHO Regions,wpr,2011,rotac,24204523,258440,1,23946083
WHO Regions,wpr,2011,hib3,24204523,3274167,14,20930356
WHO Regions,wpr,2011,dtp1,24204523,23664451,98,540072
WHO Regions,wpr,2011,pol3,24204523,23424906,97,779617
WHO Regions,wpr,2011,hepb3,24204523,22365017,92,1839506
WHO Regions,wpr,2011,mcv1,24204523,23393059,97,811464
WHO Regions,wpr,2011,dtp3,24204523,23433118,97,771405
WHO Regions,wpr,2011,pcv3,24204523,353849,1,23850674
WHO Regions,wpr,2011,mcv2,23667338,21082242,89,2585096
WHO Regions,wpr,2012,hepbb,24605589,19677204,80,4928385
WHO Regions,wpr,2012,rotac,24272348,372321,2,23900027
WHO Regions,wpr,2012,pol3,24272348,23581331,97,691017
WHO Regions,wpr,2012,dtp1,24272348,23752835,98,519513
WHO Regions,wpr,2012,dtp3,24272348,23554086,97,718262
WHO Regions,wpr,2012,hepb3,24272348,22491771,93,1780577
WHO Regions,wpr,2012,mcv1,24272348,23487420,97,784928
WHO Regions,wpr,2012,rcv1,24272348,20840357,86,3431991
WHO Regions,wpr,2012,pcv3,24272348,361509,1,23910839
WHO Regions,wpr,2012,hib3,24272348,3542590,15,20729758
WHO Regions,wpr,2012,mcv2,23839369,21353552,90,2485817
WHO Regions,wpr,2013,hepbb,24589470,19986665,81,4602805
WHO Regions,wpr,2013,dtp3,24270255,22979631,95,1290624
WHO Regions,wpr,2013,rcv1,24270255,21290010,88,2980245
WHO Regions,wpr,2013,rotac,24270255,920239,4,23350016
WHO Regions,wpr,2013,mcv1,24270255,23512966,97,757289
WHO Regions,wpr,2013,pcv3,24270255,384183,2,23886072
WHO Regions,wpr,2013,pol3,24270255,23364663,96,905592
WHO Regions,wpr,2013,dtp1,24270255,23537571,97,732684
WHO Regions,wpr,2013,hib3,24270255,4559763,19,19710492
WHO Regions,wpr,2013,hepb3,24270255,21934785,90,2335470
WHO Regions,wpr,2013,mcv2,24213526,22090819,91,2122707
WHO Regions,wpr,2014,hepbb,24500971,19691699,80,4809272
WHO Regions,wpr,2014,dtp3,24194307,22959474,95,1234833
WHO Regions,wpr,2014,rotac,24194307,301009,1,23893298
WHO Regions,wpr,2014,rcv1,24194307,21580832,89,2613475
WHO Regions,wpr,2014,hepb3,24194307,21919896,91,2274411
WHO Regions,wpr,2014,pcv3,24194307,1317790,5,22876517
WHO Regions,wpr,2014,dtp1,24194307,23304563,96,889744
WHO Regions,wpr,2014,pol3,24194307,23217641,96,976666
WHO Regions,wpr,2014,hib3,24194307,5073400,21,19120907
WHO Regions,wpr,2014,mcv1,24194307,23268323,96,925984
WHO Regions,wpr,2014,mcv2,24359584,22507130,92,1852454
WHO Regions,wpr,2015,hepbb,24339832,20196455,83,4143377
WHO Regions,wpr,2015,hepb3,24044603,21667233,90,2377370
WHO Regions,wpr,2015,hib3,24044603,6001759,25,18042844
WHO Regions,wpr,2015,dtp1,24044603,22995579,96,1049024
WHO Regions,wpr,2015,rcv1,24044603,23157614,96,886989
WHO Regions,wpr,2015,mcv1,24044603,23157614,96,886989
WHO Regions,wpr,2015,dtp3,24044603,22689195,94,1355408
WHO Regions,wpr,2015,rotac,24044603,358940,1,23685663
WHO Regions,wpr,2015,pol3,24044603,23159637,96,884966
WHO Regions,wpr,2015,pcv3,24044603,2657857,11,21386746
WHO Regions,wpr,2015,mcv2,24401945,22678262,93,1723683
WHO Regions,wpr,2016,hepbb,24112187,20025691,83,4086496
WHO Regions,wpr,2016,hib3,23827594,6621312,28,17206282
WHO Regions,wpr,2016,hepb3,23827594,22040025,92,1787569
WHO Regions,wpr,2016,rotac,23827594,361106,2,23466488
WHO Regions,wpr,2016,pcv3,23827594,3217275,14,20610319
WHO Regions,wpr,2016,rcv1,23827594,22902327,96,925267
WHO Regions,wpr,2016,dtp3,23827594,23084277,97,743317
WHO Regions,wpr,2016,mcv1,23827594,22902327,96,925267
WHO Regions,wpr,2016,dtp1,23827594,23173082,97,654512
WHO Regions,wpr,2016,pol3,23827594,22732052,95,1095542
WHO Regions,wpr,2016,mcv2,24456823,22748772,93,1708051
WHO Regions,sear,1980,bcg,37576786,4544967,12,33031819
WHO Regions,sear,1980,pol3,33553508,1031020,3,32522488
WHO Regions,sear,1980,dtp3,33553508,2371113,7,31182395
WHO Regions,sear,1980,dtp1,33553508,7396394,22,26157114
WHO Regions,sear,1980,rcv1,33553508,0,0,33553508
WHO Regions,sear,1980,mcv1,33553508,104707,0,33448801
WHO Regions,sear,1981,bcg,38054877,5477606,14,32577271
WHO Regions,sear,1981,pol3,34081865,1265001,4,32816864
WHO Regions,sear,1981,dtp1,34081865,9010081,26,25071784
WHO Regions,sear,1981,mcv1,34081865,128006,0,33953859
WHO Regions,sear,1981,rcv1,34081865,0,0,34081865
WHO Regions,sear,1981,dtp3,34081865,2565524,8,31516341
WHO Regions,sear,1982,bcg,38484601,6018254,16,32466347
WHO Regions,sear,1982,mcv1,34564691,155591,0,34409100
WHO Regions,sear,1982,dtp1,34564691,11047918,32,23516773
WHO Regions,sear,1982,pol3,34564691,2824146,8,31740545
WHO Regions,sear,1982,rcv1,34564691,0,0,34564691
WHO Regions,sear,1982,dtp3,34564691,4045294,12,30519397
WHO Regions,sear,1983,bcg,38846069,6564045,17,32282024
WHO Regions,sear,1983,rcv1,34985648,0,0,34985648
WHO Regions,sear,1983,dtp1,34985648,12290406,35,22695242
WHO Regions,sear,1983,dtp3,34985648,4868727,14,30116921
WHO Regions,sear,1983,pol3,34985648,3602933,10,31382715
WHO Regions,sear,1983,mcv1,34985648,487452,1,34498196
WHO Regions,sear,1984,bcg,39130227,6866518,18,32263709
WHO Regions,sear,1984,dtp1,35336762,13712520,39,21624242
WHO Regions,sear,1984,pol3,35336762,4318538,12,31018224
WHO Regions,sear,1984,dtp3,35336762,5852460,17,29484302
WHO Regions,sear,1984,rcv1,35336762,0,0,35336762
WHO Regions,sear,1984,mcv1,35336762,958538,3,34378224
WHO Regions,sear,1985,bcg,39333685,7796949,20,31536736
WHO Regions,sear,1985,dtp1,35615049,15268959,43,20346090
WHO Regions,sear,1985,dtp3,35615049,7181408,20,28433641
WHO Regions,sear,1985,pol3,35615049,5400187,15,30214862
WHO Regions,sear,1985,rcv1,35615049,0,0,35615049
WHO Regions,sear,1985,mcv1,35615049,2174552,6,33440497
WHO Regions,sear,1985,hepb3,35615049,0,0,35615049
WHO Regions,sear,1986,bcg,39461669,8038588,20,31423081
WHO Regions,sear,1986,dtp1,35825150,17191640,48,18633510
WHO Regions,sear,1986,dtp3,35825150,8827889,25,26997261
WHO Regions,sear,1986,pol3,35825150,7613764,21,28211386
WHO Regions,sear,1986,rcv1,35825150,0,0,35825150
WHO Regions,sear,1986,hepb3,35825150,0,0,35825150
WHO Regions,sear,1986,mcv1,35825150,5687012,16,30138138
WHO Regions,sear,1987,bcg,39534101,12759311,32,26774790
WHO Regions,sear,1987,hepb3,35984719,0,0,35984719
WHO Regions,sear,1987,dtp1,35984719,20466036,57,15518683
WHO Regions,sear,1987,dtp3,35984719,11893928,33,24090791
WHO Regions,sear,1987,mcv1,35984719,9594762,27,26389957
WHO Regions,sear,1987,pol3,35984719,10821815,30,25162904
WHO Regions,sear,1987,rcv1,35984719,0,0,35984719
WHO Regions,sear,1988,bcg,39570432,13463292,34,26107140
WHO Regions,sear,1988,hepb3,36111018,0,0,36111018
WHO Regions,sear,1988,dtp1,36111018,23565202,65,12545816
WHO Regions,sear,1988,rcv1,36111018,0,0,36111018
WHO Regions,sear,1988,mcv1,36111018,12497525,35,23613493
WHO Regions,sear,1988,dtp3,36111018,14942379,41,21168639
WHO Regions,sear,1988,pol3,36111018,13971308,39,22139710
WHO Regions,sear,1989,bcg,39582015,16244188,41,23337827
WHO Regions,sear,1989,mcv1,36214162,16904375,47,19309787
WHO Regions,sear,1989,dtp3,36214162,19032326,53,17181836
WHO Regions,sear,1989,pol3,36214162,20100379,56,16113783
WHO Regions,sear,1989,rcv1,36214162,0,0,36214162
WHO Regions,sear,1989,hepb3,36214162,0,0,36214162
WHO Regions,sear,1989,dtp1,36214162,27406579,76,8807583
WHO Regions,sear,1990,bcg,39578754,28195978,71,11382776
WHO Regions,sear,1990,mcv1,36302812,21367534,59,14935278
WHO Regions,sear,1990,hepb3,36302812,0,0,36302812
WHO Regions,sear,1990,rcv1,36302812,0,0,36302812
WHO Regions,sear,1990,dtp1,36302812,31728070,87,4574742
WHO Regions,sear,1990,dtp3,36302812,25353141,70,10949671
WHO Regions,sear,1990,hib3,36302812,0,0,36302812
WHO Regions,sear,1990,pol3,36302812,24349814,67,11952998
WHO Regions,sear,1991,bcg,39567424,26892459,68,12674965
WHO Regions,sear,1991,rcv1,36382788,0,0,36382788
WHO Regions,sear,1991,dtp3,36382788,22167271,61,14215517
WHO Regions,sear,1991,hib3,36382788,0,0,36382788
WHO Regions,sear,1991,dtp1,36382788,29886469,82,6496319
WHO Regions,sear,1991,pol3,36382788,22415880,62,13966908
WHO Regions,sear,1991,mcv1,36382788,18351438,50,18031350
WHO Regions,sear,1991,hepb3,36382788,0,0,36382788
WHO Regions,sear,1992,bcg,39550838,27906418,71,11644420
WHO Regions,sear,1992,dtp3,36456638,21763550,60,14693088
WHO Regions,sear,1992,rcv1,36456638,0,0,36456638
WHO Regions,sear,1992,hib3,36456638,0,0,36456638
WHO Regions,sear,1992,mcv1,36456638,20581458,56,15875180
WHO Regions,sear,1992,hepb3,36456638,1372581,4,35084057
WHO Regions,sear,1992,dtp1,36456638,29673194,81,6783444
WHO Regions,sear,1992,pol3,36456638,21860880,60,14595758
WHO Regions,sear,1993,bcg,39532750,29260114,74,10272636
WHO Regions,sear,1993,mcv1,36527935,23040285,63,13487650
WHO Regions,sear,1993,pol3,36527935,23581218,65,12946717
WHO Regions,sear,1993,rcv1,36527935,813710,2,35714225
WHO Regions,sear,1993,dtp1,36527935,30367194,83,6160741
WHO Regions,sear,1993,hepb3,36527935,2450632,7,34077303
WHO Regions,sear,1993,dtp3,36527935,23499440,64,13028495
WHO Regions,sear,1993,hib3,36527935,0,0,36527935
WHO Regions,sear,1994,bcg,39519016,29816103,75,9702913
WHO Regions,sear,1994,mcv1,36602252,25209892,69,11392360
WHO Regions,sear,1994,pol3,36602252,25643347,70,10958905
WHO Regions,sear,1994,dtp3,36602252,25530836,70,11071416
WHO Regions,sear,1994,dtp1,36602252,31946617,87,4655635
WHO Regions,sear,1994,rcv1,36602252,862294,2,35739958
WHO Regions,sear,1994,hib3,36602252,0,0,36602252
WHO Regions,sear,1994,hepb3,36602252,2470827,7,34131425
WHO Regions,sear,1995,bcg,39517934,32542868,82,6975066
WHO Regions,sear,1995,hib3,36687962,0,0,36687962
WHO Regions,sear,1995,pol3,36687962,26354802,72,10333160
WHO Regions,sear,1995,rcv1,36687962,897672,2,35790290
WHO Regions,sear,1995,dtp3,36687962,26201845,71,10486117
WHO Regions,sear,1995,mcv1,36687962,26476836,72,10211126
WHO Regions,sear,1995,hepb3,36687962,3060341,8,33627621
WHO Regions,sear,1995,dtp1,36687962,32305673,88,4382289
WHO Regions,sear,1996,bcg,39536406,32352142,82,7184264
WHO Regions,sear,1996,pol3,36792398,26238274,71,10554124
WHO Regions,sear,1996,mcv1,36792398,25403863,69,11388535
WHO Regions,sear,1996,hib3,36792398,0,0,36792398
WHO Regions,sear,1996,dtp1,36792398,32130277,87,4662121
WHO Regions,sear,1996,dtp3,36792398,25427382,69,11365016
WHO Regions,sear,1996,rcv1,36792398,1191910,3,35600488
WHO Regions,sear,1996,hepb3,36792398,3555103,10,33237295
WHO Regions,sear,1997,bcg,39572053,30474601,77,9097452
WHO Regions,sear,1997,dtp3,36913874,24639676,67,12274198
WHO Regions,sear,1997,rcv1,36913874,1201132,3,35712742
WHO Regions,sear,1997,hib3,36913874,0,0,36913874
WHO Regions,sear,1997,dtp1,36913874,31262538,85,5651336
WHO Regions,sear,1997,pol3,36913874,25258130,68,11655744
WHO Regions,sear,1997,hepb3,36913874,3689384,10,33224490
WHO Regions,sear,1997,mcv1,36913874,22703914,62,14209960
WHO Regions,sear,1998,bcg,39618725,30676585,77,8942140
WHO Regions,sear,1998,rcv1,37046746,1212479,3,35834267
WHO Regions,sear,1998,pol3,37046746,24937499,67,12109247
WHO Regions,sear,1998,hib3,37046746,0,0,37046746
WHO Regions,sear,1998,mcv1,37046746,22284586,60,14762160
WHO Regions,sear,1998,dtp1,37046746,30114242,81,6932504
WHO Regions,sear,1998,hepb3,37046746,4173822,11,32872924
WHO Regions,sear,1998,dtp3,37046746,24447772,66,12598974
WHO Regions,sear,1999,bcg,39669391,31050581,78,8618810
WHO Regions,sear,1999,dtp1,37184067,29131861,78,8052206
WHO Regions,sear,1999,pol3,37184067,24373669,66,12810398
WHO Regions,sear,1999,rcv1,37184067,1199888,3,35984179
WHO Regions,sear,1999,hib3,37184067,0,0,37184067
WHO Regions,sear,1999,hepb3,37184067,4242484,11,32941583
WHO Regions,sear,1999,mcv1,37184067,23275700,63,13908367
WHO Regions,sear,1999,dtp3,37184067,24017265,65,13166802
WHO Regions,sear,2000,hepbb,39753939,0,0,39753939
WHO Regions,sear,2000,bcg,39714580,31006889,78,8707691
WHO Regions,sear,2000,dtp1,37316357,29133396,78,8182961
WHO Regions,sear,2000,dtp3,37316357,24071787,65,13244570
WHO Regions,sear,2000,hib3,37316357,0,0,37316357
WHO Regions,sear,2000,pol3,37316357,23922673,64,13393684
WHO Regions,sear,2000,rcv1,37316357,1181400,3,36134957
WHO Regions,sear,2000,mcv1,37316357,23379863,63,13936494
WHO Regions,sear,2000,hepb3,37316357,3747696,10,33568661
WHO Regions,sear,2000,mcv2,36570265,1000411,3,35569854
WHO Regions,sear,2001,hepbb,39782437,0,0,39782437
WHO Regions,sear,2001,bcg,39743503,31158643,78,8584860
WHO Regions,sear,2001,pol3,37432676,24436466,65,12996210
WHO Regions,sear,2001,dtp1,37432676,29406007,79,8026669
WHO Regions,sear,2001,mcv1,37432676,23753966,63,13678710
WHO Regions,sear,2001,hib3,37432676,0,0,37432676
WHO Regions,sear,2001,rcv1,37432676,1169630,3,36263046
WHO Regions,sear,2001,hepb3,37432676,3645853,10,33786823
WHO Regions,sear,2001,dtp3,37432676,24454059,65,12978617
WHO Regions,sear,2001,mcv2,36878276,1025804,3,35852472
WHO Regions,sear,2002,bcg,39782768,31423203,79,8359565
WHO Regions,sear,2002,hepbb,39782768,0,0,39782768
WHO Regions,sear,2002,dtp1,37556713,29583309,79,7973404
WHO Regions,sear,2002,mcv1,37556713,23382951,62,14173762
WHO Regions,sear,2002,hib3,37556713,0,0,37556713
WHO Regions,sear,2002,pol3,37556713,24646560,66,12910153
WHO Regions,sear,2002,dtp3,37556713,24258949,65,13297764
WHO Regions,sear,2002,hepb3,37556713,3725443,10,33831270
WHO Regions,sear,2002,rcv1,37556713,1159720,3,36396993
WHO Regions,sear,2002,mcv2,37182852,1169966,3,36012886
WHO Regions,sear,2003,bcg,39743526,31909637,80,7833889
WHO Regions,sear,2003,hepbb,39743526,109162,0,39634364
WHO Regions,sear,2003,dtp3,37604448,25056549,67,12547899
WHO Regions,sear,2003,mcv1,37604448,24649934,66,12954514
WHO Regions,sear,2003,dtp1,37604448,29860863,79,7743585
WHO Regions,sear,2003,pol3,37604448,24713735,66,12890713
WHO Regions,sear,2003,hib3,37604448,0,0,37604448
WHO Regions,sear,2003,rcv1,37604448,1168294,3,36436154
WHO Regions,sear,2003,hepb3,37604448,4298246,11,33306202
WHO Regions,sear,2003,mcv2,37107020,2110314,6,34996706
WHO Regions,sear,2004,bcg,39655892,32909614,83,6746278
WHO Regions,sear,2004,hepbb,39655892,378490,1,39277402
WHO Regions,sear,2004,dtp1,37603053,30437392,81,7165661
WHO Regions,sear,2004,mcv1,37603053,25992301,69,11610752
WHO Regions,sear,2004,dtp3,37603053,26033437,69,11569616
WHO Regions,sear,2004,rcv1,37603053,1149892,3,36453161
WHO Regions,sear,2004,pol3,37603053,24942443,66,12660610
WHO Regions,sear,2004,hib3,37603053,0,0,37603053
WHO Regions,sear,2004,hepb3,37603053,6965581,19,30637472
WHO Regions,sear,2004,mcv2,37209248,2509435,7,34699813
WHO Regions,sear,2005,hepbb,39504995,352642,1,39152353
WHO Regions,sear,2005,bcg,39504995,34432680,87,5072315
WHO Regions,sear,2005,dtp3,37537889,26254567,70,11283322
WHO Regions,sear,2005,rcv1,37537889,1153297,3,36384592
WHO Regions,sear,2005,pol3,37537889,26843428,72,10694461
WHO Regions,sear,2005,dtp1,37537889,31549945,84,5987944
WHO Regions,sear,2005,mcv1,37537889,27264433,73,10273456
WHO Regions,sear,2005,hepb3,37537889,9104742,24,28433147
WHO Regions,sear,2005,hib3,37537889,0,0,37537889
WHO Regions,sear,2005,mcv2,37268976,2247990,6,35020986
WHO Regions,sear,2006,bcg,39277511,34479459,88,4798052
WHO Regions,sear,2006,hepbb,39277511,346544,1,38930967
WHO Regions,sear,2006,hib3,37396086,0,0,37396086
WHO Regions,sear,2006,dtp3,37396086,26400785,71,10995301
WHO Regions,sear,2006,mcv1,37396086,27365644,73,10030442
WHO Regions,sear,2006,rotac,37396086,0,0,37396086
WHO Regions,sear,2006,pol3,37396086,27027689,72,10368397
WHO Regions,sear,2006,rcv1,37396086,1158757,3,36237329
WHO Regions,sear,2006,dtp1,37396086,31429619,84,5966467
WHO Regions,sear,2006,hepb3,37396086,10264276,27,27131810
WHO Regions,sear,2006,mcv2,37333087,3463618,9,33869469
WHO Regions,sear,2007,bcg,38978078,34286786,88,4691292
WHO Regions,sear,2007,hepbb,38978078,348476,1,38629602
WHO Regions,sear,2007,dtp3,37182228,26040357,70,11141871
WHO Regions,sear,2007,hepb3,37182228,11149829,30,26032399
WHO Regions,sear,2007,dtp1,37182228,31315821,84,5866407
WHO Regions,sear,2007,hib3,37182228,0,0,37182228
WHO Regions,sear,2007,mcv1,37182228,27527336,74,9654892
WHO Regions,sear,2007,rcv1,37182228,1150658,3,36031570
WHO Regions,sear,2007,pol3,37182228,27079351,73,10102877
WHO Regions,sear,2007,rotac,37182228,0,0,37182228
WHO Regions,sear,2007,mcv2,37352752,4531690,12,32821062
WHO Regions,sear,2008,bcg,38619740,33564253,87,5055487
WHO Regions,sear,2008,hepbb,38619740,2506598,6,36113142
WHO Regions,sear,2008,pcv3,36908826,0,0,36908826
WHO Regions,sear,2008,hepb3,36908826,17357473,47,19551353
WHO Regions,sear,2008,hib3,36908826,0,0,36908826
WHO Regions,sear,2008,dtp3,36908826,27645842,75,9262984
WHO Regions,sear,2008,pol3,36908826,27702834,75,9205992
WHO Regions,sear,2008,dtp1,36908826,31348320,85,5560506
WHO Regions,sear,2008,mcv1,36908826,27945935,76,8962891
WHO Regions,sear,2008,rcv1,36908826,1158271,3,35750555
WHO Regions,sear,2008,rotac,36908826,0,0,36908826
WHO Regions,sear,2008,mcv2,37193466,5161568,14,32031898
WHO Regions,sear,2009,hepbb,38218612,2480573,6,35738039
WHO Regions,sear,2009,bcg,38218612,33735821,88,4482791
WHO Regions,sear,2009,pcv3,36591065,0,0,36591065
WHO Regions,sear,2009,hib3,36591065,3047627,8,33543438
WHO Regions,sear,2009,dtp3,36591065,28592239,78,7998826
WHO Regions,sear,2009,rotac,36591065,0,0,36591065
WHO Regions,sear,2009,hepb3,36591065,19388976,53,17202089
WHO Regions,sear,2009,rcv1,36591065,1142939,3,35448126
WHO Regions,sear,2009,pol3,36591065,28725646,79,7865419
WHO Regions,sear,2009,dtp1,36591065,32046425,88,4544640
WHO Regions,sear,2009,mcv1,36591065,29272479,80,7318586
WHO Regions,sear,2009,mcv2,37082275,5301466,14,31780809
WHO Regions,sear,2010,bcg,37802017,34099021,90,3702996
WHO Regions,sear,2010,hepbb,37802017,2454255,6,35347762
WHO Regions,sear,2010,hib3,36254693,3273735,9,32980958
WHO Regions,sear,2010,rcv1,36254693,1135580,3,35119113
WHO Regions,sear,2010,pol3,36254693,28926353,80,7328340
WHO Regions,sear,2010,dtp3,36254693,29604221,82,6650472
WHO Regions,sear,2010,rotac,36254693,0,0,36254693
WHO Regions,sear,2010,pcv3,36254693,0,0,36254693
WHO Regions,sear,2010,dtp1,36254693,32327727,89,3926966
WHO Regions,sear,2010,hepb3,36254693,19410509,54,16844184
WHO Regions,sear,2010,mcv1,36254693,30039383,83,6215310
WHO Regions,sear,2010,mcv2,36888102,5744549,16,31143553
WHO Regions,sear,2011,bcg,37401530,34553189,92,2848341
WHO Regions,sear,2011,hepbb,37401530,2431000,6,34970530
WHO Regions,sear,2011,hib3,35929557,3565421,10,32364136
WHO Regions,sear,2011,dtp1,35929557,32888239,92,3041318
WHO Regions,sear,2011,pol3,35929557,29477199,82,6452358
WHO Regions,sear,2011,hepb3,35929557,20282697,56,15646860
WHO Regions,sear,2011,dtp3,35929557,30150279,84,5779278
WHO Regions,sear,2011,rcv1,35929557,1118835,3,34810722
WHO Regions,sear,2011,pcv3,35929557,0,0,35929557
WHO Regions,sear,2011,mcv1,35929557,30526964,85,5402593
WHO Regions,sear,2011,rotac,35929557,0,0,35929557
WHO Regions,sear,2011,mcv2,36676792,12781681,35,23895111
WHO Regions,sear,2012,bcg,37041986,33624807,91,3417179
WHO Regions,sear,2012,hepbb,37041986,6269667,17,30772319
WHO Regions,sear,2012,dtp3,35639347,29944764,84,5694583
WHO Regions,sear,2012,pol3,35639347,29293032,82,6346315
WHO Regions,sear,2012,hepb3,35639347,27479915,77,8159432
WHO Regions,sear,2012,rotac,35639347,0,0,35639347
WHO Regions,sear,2012,rcv1,35639347,1622716,5,34016631
WHO Regions,sear,2012,mcv1,35639347,29932867,84,5706480
WHO Regions,sear,2012,dtp1,35639347,32502210,91,3137137
WHO Regions,sear,2012,pcv3,35639347,0,0,35639347
WHO Regions,sear,2012,hib3,35639347,3858585,11,31780762
WHO Regions,sear,2012,mcv2,36384007,15413981,42,20970026
WHO Regions,sear,2013,hepbb,36740234,9788062,27,26952172
WHO Regions,sear,2013,bcg,36740234,33531585,91,3208649
WHO Regions,sear,2013,hepb3,35400309,26884854,76,8515455
WHO Regions,sear,2013,rcv1,35400309,4362185,12,31038124
WHO Regions,sear,2013,rotac,35400309,0,0,35400309
WHO Regions,sear,2013,dtp3,35400309,30064793,85,5335516
WHO Regions,sear,2013,hib3,35400309,9922991,28,25477318
WHO Regions,sear,2013,dtp1,35400309,32534099,92,2866210
WHO Regions,sear,2013,pol3,35400309,29899147,84,5501162
WHO Regions,sear,2013,mcv1,35400309,29808391,84,5591918
WHO Regions,sear,2013,pcv3,35400309,0,0,35400309
WHO Regions,sear,2013,mcv2,35814571,20688066,58,15126505
WHO Regions,sear,2014,bcg,36503029,32673716,90,3829313
WHO Regions,sear,2014,hepbb,36503029,10746072,29,25756957
WHO Regions,sear,2014,hib3,35219106,11293454,32,23925652
WHO Regions,sear,2014,dtp1,35219106,32364111,92,2854995
WHO Regions,sear,2014,dtp3,35219106,30198885,86,5020221
WHO Regions,sear,2014,hepb3,35219106,28738031,82,6481075
WHO Regions,sear,2014,rotac,35219106,0,0,35219106
WHO Regions,sear,2014,rcv1,35219106,4413700,13,30805406
WHO Regions,sear,2014,pcv3,35219106,0,0,35219106
WHO Regions,sear,2014,pol3,35219106,30073558,85,5145548
WHO Regions,sear,2014,mcv1,35219106,29957452,85,5261654
WHO Regions,sear,2014,mcv2,35431764,20835676,59,14596088
WHO Regions,sear,2015,hepbb,36326841,11458310,32,24868531
WHO Regions,sear,2015,bcg,36326841,31896547,88,4430294
WHO Regions,sear,2015,rcv1,35092689,5118533,15,29974156
WHO Regions,sear,2015,mcv1,35092689,30276245,86,4816444
WHO Regions,sear,2015,dtp3,35092689,30587551,87,4505138
WHO Regions,sear,2015,hib3,35092689,19674309,56,15418380
WHO Regions,sear,2015,pol3,35092689,30446381,87,4646308
WHO Regions,sear,2015,rotac,35092689,0,0,35092689
WHO Regions,sear,2015,dtp1,35092689,32273457,92,2819232
WHO Regions,sear,2015,hepb3,35092689,30587551,87,4505138
WHO Regions,sear,2015,pcv3,35092689,1476513,4,33616176
WHO Regions,sear,2015,mcv2,35134916,22952590,65,12182326
WHO Regions,sear,2016,hepbb,36197304,12212438,34,23984866
WHO Regions,sear,2016,bcg,36197304,32272984,89,3924320
WHO Regions,sear,2016,rotac,35007724,971083,3,34036641
WHO Regions,sear,2016,rcv1,35007724,5166524,15,29841200
WHO Regions,sear,2016,hib3,35007724,28155418,80,6852306
WHO Regions,sear,2016,dtp3,35007724,30794277,88,4213447
WHO Regions,sear,2016,dtp1,35007724,32429170,93,2578554
WHO Regions,sear,2016,mcv1,35007724,30552985,87,4454739
WHO Regions,sear,2016,pol3,35007724,30346406,87,4661318
WHO Regions,sear,2016,pcv3,35007724,3292869,9,31714855
WHO Regions,sear,2016,hepb3,35007724,30794277,88,4213447
WHO Regions,sear,2016,mcv2,34714746,26046985,75,8667761
WHO Regions,wpr,1980,bcg,28156883,1570632,6,26586251
WHO Regions,wpr,1981,bcg,28621475,3372436,12,25249039
WHO Regions,wpr,1982,bcg,29455389,3646641,12,25808748
WHO Regions,wpr,1983,bcg,30540144,11627680,38,18912464
WHO Regions,wpr,1984,bcg,31756304,19052021,60,12704283
WHO Regions,wpr,1985,bcg,32914963,21171548,64,11743415
WHO Regions,wpr,1986,bcg,33810553,23660943,70,10149610
WHO Regions,wpr,1987,bcg,34311231,28376727,83,5934504
WHO Regions,wpr,1988,bcg,34331284,32448726,95,1882558
WHO Regions,wpr,1989,bcg,33852415,32381507,96,1470908
WHO Regions,wpr,1990,bcg,32911330,31641982,96,1269348
WHO Regions,wpr,1991,bcg,31609667,30086227,95,1523440
WHO Regions,wpr,1992,bcg,30136753,27904130,93,2232623
WHO Regions,wpr,1993,bcg,28665653,26155448,91,2510205
WHO Regions,wpr,1994,bcg,26078009,23206480,89,2871529
WHO Regions,wpr,1995,bcg,24902090,20203639,81,4698451
WHO Regions,wpr,1996,bcg,23949408,20380903,85,3568505
WHO Regions,wpr,1997,bcg,23190899,19686360,85,3504539
WHO Regions,wpr,1998,bcg,22598880,19064368,84,3534512
WHO Regions,wpr,1999,bcg,22175381,18944940,85,3230441
WHO Regions,wpr,2000,bcg,21913635,18793078,86,3120557
WHO Regions,wpr,2001,bcg,21795538,18795068,86,3000470
WHO Regions,wpr,2002,bcg,21783638,18672513,86,3111125
WHO Regions,wpr,2003,bcg,21841051,18793031,86,3048020
WHO Regions,wpr,2004,bcg,21942928,19236000,88,2706928
WHO Regions,wpr,2005,bcg,22074695,19331997,88,2742698
WHO Regions,wpr,2006,bcg,22232137,20467488,92,1764649
WHO Regions,wpr,2007,bcg,23529852,21964593,93,1565259
WHO Regions,wpr,2008,bcg,23723866,22701233,96,1022633
WHO Regions,wpr,2009,bcg,23913913,23291073,97,622840
WHO Regions,wpr,2010,bcg,24075786,23293759,97,782027
WHO Regions,wpr,2011,bcg,24187361,23633672,98,553689
WHO Regions,wpr,2012,bcg,24237699,23657389,98,580310
WHO Regions,wpr,2013,bcg,24220041,23502225,97,717816
WHO Regions,wpr,2014,bcg,24129959,23242924,96,887035
WHO Regions,wpr,2015,bcg,23967110,22997004,96,970106
WHO Regions,wpr,2016,bcg,23737665,22646414,95,1091251
GVAP Indicator,gavi,1980,bcg,60819406,5984684,10,54834722
GVAP Indicator,gavi,1980,dtp1,53963378,9059938,17,44903440
GVAP Indicator,gavi,1980,mcv1,53963378,1302032,2,52661346
GVAP Indicator,gavi,1980,pol3,53963378,2105518,4,51857860
GVAP Indicator,gavi,1980,rcv1,53963378,0,0,53963378
GVAP Indicator,gavi,1980,dtp3,53963378,2905806,5,51057572
GVAP Indicator,gavi,1981,bcg,61932455,9963715,16,51968740
GVAP Indicator,gavi,1981,dtp1,55096834,12802867,23,42293967
GVAP Indicator,gavi,1981,dtp3,55096834,4116169,7,50980665
GVAP Indicator,gavi,1981,mcv1,55096834,2299278,4,52797556
GVAP Indicator,gavi,1981,pol3,55096834,2885605,5,52211229
GVAP Indicator,gavi,1981,rcv1,55096834,0,0,55096834
GVAP Indicator,gavi,1982,bcg,63007070,10880661,17,52126409
GVAP Indicator,gavi,1982,dtp3,56194883,5967977,11,50226906
GVAP Indicator,gavi,1982,mcv1,56194883,2847717,5,53347166
GVAP Indicator,gavi,1982,dtp1,56194883,15587728,28,40607155
GVAP Indicator,gavi,1982,pol3,56194883,4844324,9,51350559
GVAP Indicator,gavi,1982,rcv1,56194883,0,0,56194883
GVAP Indicator,gavi,1983,bcg,64018091,13158247,21,50859844
GVAP Indicator,gavi,1983,dtp3,57234982,7609906,13,49625076
GVAP Indicator,gavi,1983,dtp1,57234982,18364090,32,38870892
GVAP Indicator,gavi,1983,rcv1,57234982,0,0,57234982
GVAP Indicator,gavi,1983,pol3,57234982,6270779,11,50964203
GVAP Indicator,gavi,1983,mcv1,57234982,4286033,7,52948949
GVAP Indicator,gavi,1984,bcg,64951407,16087102,25,48864305
GVAP Indicator,gavi,1984,dtp3,58203625,10056871,17,48146754
GVAP Indicator,gavi,1984,pol3,58203625,8421167,14,49782458
GVAP Indicator,gavi,1984,mcv1,58203625,6379228,11,51824397
GVAP Indicator,gavi,1984,rcv1,58203625,0,0,58203625
GVAP Indicator,gavi,1984,dtp1,58203625,22488212,39,35715413
GVAP Indicator,gavi,1985,bcg,65798020,19000447,29,46797573
GVAP Indicator,gavi,1985,pol3,59091070,11930252,20,47160818
GVAP Indicator,gavi,1985,dtp3,59091070,13343190,23,45747880
GVAP Indicator,gavi,1985,dtp1,59091070,26587667,45,32503403
GVAP Indicator,gavi,1985,hepb3,59091070,0,0,59091070
GVAP Indicator,gavi,1985,mcv1,59091070,9173983,16,49917087
GVAP Indicator,gavi,1985,rcv1,59091070,0,0,59091070
GVAP Indicator,gavi,1986,bcg,66558466,21445900,32,45112566
GVAP Indicator,gavi,1986,dtp3,59896096,16312203,27,43583893
GVAP Indicator,gavi,1986,pol3,59896096,15224743,25,44671353
GVAP Indicator,gavi,1986,rcv1,59896096,140346,0,59755750
GVAP Indicator,gavi,1986,dtp1,59896096,30034480,50,29861616
GVAP Indicator,gavi,1986,hepb3,59896096,0,0,59896096
GVAP Indicator,gavi,1986,mcv1,59896096,14615260,24,45280836
GVAP Indicator,gavi,1987,bcg,67250897,28320691,42,38930206
GVAP Indicator,gavi,1987,dtp1,60634879,35076490,58,25558389
GVAP Indicator,gavi,1987,hepb3,60634879,0,0,60634879
GVAP Indicator,gavi,1987,dtp3,60634879,20933696,35,39701183
GVAP Indicator,gavi,1987,rcv1,60634879,175657,0,60459222
GVAP Indicator,gavi,1987,pol3,60634879,19920552,33,40714327
GVAP Indicator,gavi,1987,mcv1,60634879,19557944,32,41076935
GVAP Indicator,gavi,1988,bcg,67893755,30896402,46,36997353
GVAP Indicator,gavi,1988,dtp3,61324812,25579070,42,35745742
GVAP Indicator,gavi,1988,mcv1,61324812,24279539,40,37045273
GVAP Indicator,gavi,1988,dtp1,61324812,39822199,65,21502613
GVAP Indicator,gavi,1988,hepb3,61324812,0,0,61324812
GVAP Indicator,gavi,1988,pol3,61324812,24331994,40,36992818
GVAP Indicator,gavi,1988,rcv1,61324812,158448,0,61166364
GVAP Indicator,gavi,1989,bcg,68497416,35998361,53,32499055
GVAP Indicator,gavi,1989,dtp3,61976611,31624994,51,30351617
GVAP Indicator,gavi,1989,pol3,61976611,32333663,52,29642948
GVAP Indicator,gavi,1989,dtp1,61976611,45520261,73,16456350
GVAP Indicator,gavi,1989,mcv1,61976611,30497252,49,31479359
GVAP Indicator,gavi,1989,rcv1,61976611,173587,0,61803024
GVAP Indicator,gavi,1989,hepb3,61976611,0,0,61976611
GVAP Indicator,gavi,1990,bcg,69071284,50030245,72,19041039
GVAP Indicator,gavi,1990,pol3,62600835,39017848,62,23582987
GVAP Indicator,gavi,1990,rcv1,62600835,164380,0,62436455
GVAP Indicator,gavi,1990,hib3,62600835,0,0,62600835
GVAP Indicator,gavi,1990,dtp3,62600835,39924325,64,22676510
GVAP Indicator,gavi,1990,mcv1,62600835,35877188,57,26723647
GVAP Indicator,gavi,1990,dtp1,62600835,51657443,83,10943392
GVAP Indicator,gavi,1990,hepb3,62600835,29941,0,62570894
GVAP Indicator,gavi,1991,bcg,69622880,46525952,67,23096928
GVAP Indicator,gavi,1991,dtp3,63206753,35056411,55,28150342
GVAP Indicator,gavi,1991,hib3,63206753,0,0,63206753
GVAP Indicator,gavi,1991,rcv1,63206753,169921,0,63036832
GVAP Indicator,gavi,1991,dtp1,63206753,48371645,77,14835108
GVAP Indicator,gavi,1991,pol3,63206753,35579786,56,27626967
GVAP Indicator,gavi,1991,mcv1,63206753,32354452,51,30852301
GVAP Indicator,gavi,1991,hepb3,63206753,70558,0,63136195
GVAP Indicator,gavi,1992,bcg,72214522,49620171,69,22594351
GVAP Indicator,gavi,1992,hib3,65754684,0,0,65754684
GVAP Indicator,gavi,1992,rcv1,65754684,166336,0,65588348
GVAP Indicator,gavi,1992,dtp1,65754684,50106446,76,15648238
GVAP Indicator,gavi,1992,mcv1,65754684,35870537,55,29884147
GVAP Indicator,gavi,1992,hepb3,65754684,1263695,2,64490989
GVAP Indicator,gavi,1992,pol3,65754684,36408959,55,29345725
GVAP Indicator,gavi,1992,dtp3,65754684,36297743,55,29456941
GVAP Indicator,gavi,1993,bcg,72797731,51335616,71,21462115
GVAP Indicator,gavi,1993,hib3,66399480,0,0,66399480
GVAP Indicator,gavi,1993,mcv1,66399480,38818188,58,27581292
GVAP Indicator,gavi,1993,pol3,66399480,37817387,57,28582093
GVAP Indicator,gavi,1993,dtp1,66399480,50997597,77,15401883
GVAP Indicator,gavi,1993,rcv1,66399480,157907,0,66241573
GVAP Indicator,gavi,1993,hepb3,66399480,2077712,3,64321768
GVAP Indicator,gavi,1993,dtp3,66399480,37791896,57,28607584
GVAP Indicator,gavi,1994,bcg,73255184,52936132,72,20319052
GVAP Indicator,gavi,1994,hepb3,66939294,2063880,3,64875414
GVAP Indicator,gavi,1994,rcv1,66939294,159628,0,66779666
GVAP Indicator,gavi,1994,mcv1,66939294,42118592,63,24820702
GVAP Indicator,gavi,1994,hib3,66939294,0,0,66939294
GVAP Indicator,gavi,1994,dtp1,66939294,53880806,80,13058488
GVAP Indicator,gavi,1994,pol3,66939294,41575315,62,25363979
GVAP Indicator,gavi,1994,dtp3,66939294,41308081,62,25631213
GVAP Indicator,gavi,1995,bcg,73722619,55772941,76,17949678
GVAP Indicator,gavi,1995,hepb3,67498445,2440298,4,65058147
GVAP Indicator,gavi,1995,dtp3,67498445,43054514,64,24443931
GVAP Indicator,gavi,1995,dtp1,67498445,54819563,81,12678882
GVAP Indicator,gavi,1995,mcv1,67498445,43480246,64,24018199
GVAP Indicator,gavi,1995,hib3,67498445,0,0,67498445
GVAP Indicator,gavi,1995,rcv1,67498445,172231,0,67326214
GVAP Indicator,gavi,1995,pol3,67498445,43345860,64,24152585
GVAP Indicator,gavi,1996,bcg,74209895,54882683,74,19327212
GVAP Indicator,gavi,1996,pol3,68086709,42931967,63,25154742
GVAP Indicator,gavi,1996,dtp1,68086709,54215608,80,13871101
GVAP Indicator,gavi,1996,rcv1,68086709,472920,1,67613789
GVAP Indicator,gavi,1996,hib3,68086709,0,0,68086709
GVAP Indicator,gavi,1996,dtp3,68086709,41677042,61,26409667
GVAP Indicator,gavi,1996,hepb3,68086709,3052672,4,65034037
GVAP Indicator,gavi,1996,mcv1,68086709,42736720,63,25349989
GVAP Indicator,gavi,1997,bcg,74719497,52681906,71,22037591
GVAP Indicator,gavi,1997,dtp1,68705104,54536094,79,14169010
GVAP Indicator,gavi,1997,hepb3,68705104,3222364,5,65482740
GVAP Indicator,gavi,1997,dtp3,68705104,40928826,60,27776278
GVAP Indicator,gavi,1997,pol3,68705104,42437401,62,26267703
GVAP Indicator,gavi,1997,mcv1,68705104,40146489,58,28558615
GVAP Indicator,gavi,1997,rcv1,68705104,660136,1,68044968
GVAP Indicator,gavi,1997,hib3,68705104,0,0,68705104
GVAP Indicator,gavi,1998,bcg,75252862,54133645,72,21119217
GVAP Indicator,gavi,1998,dtp3,69353352,41352069,60,28001283
GVAP Indicator,gavi,1998,dtp1,69353352,52465891,76,16887461
GVAP Indicator,gavi,1998,hib3,69353352,48233,0,69305119
GVAP Indicator,gavi,1998,rcv1,69353352,805850,1,68547502
GVAP Indicator,gavi,1998,pol3,69353352,42367966,61,26985386
GVAP Indicator,gavi,1998,mcv1,69353352,39821829,57,29531523
GVAP Indicator,gavi,1998,hepb3,69353352,3751116,5,65602236
GVAP Indicator,gavi,1999,bcg,75812471,55531164,73,20281307
GVAP Indicator,gavi,1999,pol3,70032540,42570143,61,27462397
GVAP Indicator,gavi,1999,dtp3,70032540,41183867,59,28848673
GVAP Indicator,gavi,1999,dtp1,70032540,51197524,73,18835016
GVAP Indicator,gavi,1999,hib3,70032540,299275,0,69733265
GVAP Indicator,gavi,1999,rcv1,70032540,796939,1,69235601
GVAP Indicator,gavi,1999,hepb3,70032540,4048378,6,65984162
GVAP Indicator,gavi,1999,mcv1,70032540,40857153,58,29175387
GVAP Indicator,gavi,2000,bcg,76403441,56484697,74,19918744
GVAP Indicator,gavi,2000,hepbb,76442800,320085,0,76122715
GVAP Indicator,gavi,2000,pol3,70746374,43081160,61,27665214
GVAP Indicator,gavi,2000,rcv1,70746374,1007421,1,69738953
GVAP Indicator,gavi,2000,dtp1,70746374,52052920,74,18693454
GVAP Indicator,gavi,2000,dtp3,70746374,42424041,60,28322333
GVAP Indicator,gavi,2000,hib3,70746374,675210,1,70071164
GVAP Indicator,gavi,2000,mcv1,70746374,42012219,59,28734155
GVAP Indicator,gavi,2000,hepb3,70746374,4268616,6,66477758
GVAP Indicator,gavi,2000,mcv2,67772447,1396015,2,66376432
GVAP Indicator,gavi,2001,hepbb,77068234,552474,1,76515760
GVAP Indicator,gavi,2001,bcg,77029300,57269241,74,19760059
GVAP Indicator,gavi,2001,dtp3,71497127,43449638,61,28047489
GVAP Indicator,gavi,2001,pol3,71497127,44403725,62,27093402
GVAP Indicator,gavi,2001,mcv1,71497127,43056964,60,28440163
GVAP Indicator,gavi,2001,dtp1,71497127,53138218,74,18358909
GVAP Indicator,gavi,2001,hib3,71497127,696712,1,70800415
GVAP Indicator,gavi,2001,rcv1,71497127,1527167,2,69969960
GVAP Indicator,gavi,2001,hepb3,71497127,4521132,6,66975995
GVAP Indicator,gavi,2001,mcv2,68700343,1659299,2,67041044
GVAP Indicator,gavi,2002,bcg,77720635,58068537,75,19652098
GVAP Indicator,gavi,2002,hepbb,77720635,1513542,2,76207093
GVAP Indicator,gavi,2002,dtp3,72311931,43818494,61,28493437
GVAP Indicator,gavi,2002,hib3,72311931,3138285,4,69173646
GVAP Indicator,gavi,2002,mcv1,72311931,43402131,60,28909800
GVAP Indicator,gavi,2002,dtp1,72311931,53937485,75,18374446
GVAP Indicator,gavi,2002,pol3,72311931,46068777,64,26243154
GVAP Indicator,gavi,2002,hepb3,72311931,10179325,14,62132606
GVAP Indicator,gavi,2002,rcv1,72311931,1607618,2,70704313
GVAP Indicator,gavi,2002,mcv2,69628030,1817849,3,67810181
GVAP Indicator,gavi,2003,bcg,78387064,59586397,76,18800667
GVAP Indicator,gavi,2003,hepbb,78387064,1694112,2,76692952
GVAP Indicator,gavi,2003,hib3,73104660,3360026,5,69744634
GVAP Indicator,gavi,2003,hepb3,73104660,16055785,22,57048875
GVAP Indicator,gavi,2003,mcv1,73104660,45803304,63,27301356
GVAP Indicator,gavi,2003,pol3,73104660,47277291,65,25827369
GVAP Indicator,gavi,2003,dtp3,73104660,46203688,63,26900972
GVAP Indicator,gavi,2003,rcv1,73104660,1703552,2,71401108
GVAP Indicator,gavi,2003,dtp1,73104660,55740586,76,17364074
GVAP Indicator,gavi,2003,mcv2,69957580,2750595,4,67206985
GVAP Indicator,gavi,2004,bcg,79053825,61770297,78,17283528
GVAP Indicator,gavi,2004,hepbb,79053825,2069657,3,76984168
GVAP Indicator,gavi,2004,hib3,73896934,4275174,6,69621760
GVAP Indicator,gavi,2004,pol3,73896934,48397629,65,25499305
GVAP Indicator,gavi,2004,mcv1,73896934,48665281,66,25231653
GVAP Indicator,gavi,2004,rcv1,73896934,1720367,2,72176567
GVAP Indicator,gavi,2004,hepb3,73896934,20197884,27,53699050
GVAP Indicator,gavi,2004,dtp3,73896934,48603376,66,25293558
GVAP Indicator,gavi,2004,dtp1,73896934,57397181,78,16499753
GVAP Indicator,gavi,2004,mcv2,70763982,3190021,5,67573961
GVAP Indicator,gavi,2005,bcg,79697635,64745672,81,14951963
GVAP Indicator,gavi,2005,hepbb,79697635,2077127,3,77620508
GVAP Indicator,gavi,2005,mcv1,74665309,51234245,69,23431064
GVAP Indicator,gavi,2005,dtp1,74665309,59828977,80,14836332
GVAP Indicator,gavi,2005,rcv1,74665309,1760524,2,72904785
GVAP Indicator,gavi,2005,pol3,74665309,52227877,70,22437432
GVAP Indicator,gavi,2005,hepb3,74665309,25750247,34,48915062
GVAP Indicator,gavi,2005,hib3,74665309,5018064,7,69647245
GVAP Indicator,gavi,2005,dtp3,74665309,50812749,68,23852560
GVAP Indicator,gavi,2005,mcv2,71526068,3084010,4,68442058
GVAP Indicator,gavi,2006,hepbb,80293190,2157158,3,78136032
GVAP Indicator,gavi,2006,bcg,80293190,66238133,82,14055057
GVAP Indicator,gavi,2006,rcv1,75384977,2358741,3,73026236
GVAP Indicator,gavi,2006,hib3,75384977,6438353,9,68946624
GVAP Indicator,gavi,2006,pol3,75384977,53308577,71,22076400
GVAP Indicator,gavi,2006,mcv1,75384977,52526181,70,22858796
GVAP Indicator,gavi,2006,dtp3,75384977,52080911,69,23304066
GVAP Indicator,gavi,2006,rotac,75384977,0,0,75384977
GVAP Indicator,gavi,2006,hepb3,75384977,29632032,39,45752945
GVAP Indicator,gavi,2006,dtp1,75384977,61102329,81,14282648
GVAP Indicator,gavi,2006,mcv2,72394238,4404958,6,67989280
GVAP Indicator,gavi,2007,hepbb,80827141,2875903,4,77951238
GVAP Indicator,gavi,2007,bcg,80827141,67332877,83,13494264
GVAP Indicator,gavi,2007,hib3,76043087,9328335,12,66714752
GVAP Indicator,gavi,2007,rotac,76043087,83512,0,75959575
GVAP Indicator,gavi,2007,hepb3,76043087,36470311,48,39572776
GVAP Indicator,gavi,2007,dtp3,76043087,53233260,70,22809827
GVAP Indicator,gavi,2007,mcv1,76043087,53708444,71,22334643
GVAP Indicator,gavi,2007,pol3,76043087,55255332,73,20787755
GVAP Indicator,gavi,2007,dtp1,76043087,62457565,82,13585522
GVAP Indicator,gavi,2007,rcv1,76043087,2394525,3,73648562
GVAP Indicator,gavi,2007,mcv2,73077595,5501029,8,67576566
GVAP Indicator,gavi,2008,bcg,81294778,68154555,84,13140223
GVAP Indicator,gavi,2008,hepbb,81294778,5711101,7,75583677
GVAP Indicator,gavi,2008,rcv1,76634785,2590357,3,74044428
GVAP Indicator,gavi,2008,hepb3,76634785,43355398,57,33279387
GVAP Indicator,gavi,2008,dtp1,76634785,63662926,83,12971859
GVAP Indicator,gavi,2008,pcv3,76634785,0,0,76634785
GVAP Indicator,gavi,2008,hib3,76634785,12422936,16,64211849
GVAP Indicator,gavi,2008,rotac,76634785,235452,0,76399333
GVAP Indicator,gavi,2008,mcv1,76634785,55490109,72,21144676
GVAP Indicator,gavi,2008,pol3,76634785,56644876,74,19989909
GVAP Indicator,gavi,2008,dtp3,76634785,55612504,73,21022281
GVAP Indicator,gavi,2008,mcv2,73659835,7304531,10,66355304
GVAP Indicator,gavi,2009,hepbb,81698999,6584657,8,75114342
GVAP Indicator,gavi,2009,bcg,81698999,69975057,86,11723942
GVAP Indicator,gavi,2009,rcv1,77162051,2765915,4,74396136
GVAP Indicator,gavi,2009,dtp1,77162051,66210646,86,10951405
GVAP Indicator,gavi,2009,hepb3,77162051,48996408,63,28165643
GVAP Indicator,gavi,2009,rotac,77162051,461674,1,76700377
GVAP Indicator,gavi,2009,mcv1,77162051,58330355,76,18831696
GVAP Indicator,gavi,2009,pol3,77162051,59299958,77,17862093
GVAP Indicator,gavi,2009,hib3,77162051,27474658,36,49687393
GVAP Indicator,gavi,2009,pcv3,77162051,0,0,77162051
GVAP Indicator,gavi,2009,dtp3,77162051,58557541,76,18604510
GVAP Indicator,gavi,2009,mcv2,74382180,8615122,12,65767058
GVAP Indicator,gavi,2010,bcg,82054790,71068714,87,10986076
GVAP Indicator,gavi,2010,hepbb,82054790,6597263,8,75457527
GVAP Indicator,gavi,2010,pol3,77638415,60413361,78,17225054
GVAP Indicator,gavi,2010,pcv3,77638415,400883,1,77237532
GVAP Indicator,gavi,2010,hib3,77638415,30336605,39,47301810
GVAP Indicator,gavi,2010,rotac,77638415,527903,1,77110512
GVAP Indicator,gavi,2010,hepb3,77638415,49173898,63,28464517
GVAP Indicator,gavi,2010,dtp1,77638415,66469312,86,11169103
GVAP Indicator,gavi,2010,mcv1,77638415,60479311,78,17159104
GVAP Indicator,gavi,2010,rcv1,77638415,2745507,4,74892908
GVAP Indicator,gavi,2010,dtp3,77638415,60398090,78,17240325
GVAP Indicator,gavi,2010,mcv2,75044200,10330521,14,64713679
GVAP Indicator,gavi,2011,bcg,82385952,70769993,86,11615959
GVAP Indicator,gavi,2011,hepbb,82385952,7588969,9,74796983
GVAP Indicator,gavi,2011,dtp3,78086066,61140203,78,16945863
GVAP Indicator,gavi,2011,pcv3,78086066,3683871,5,74402195
GVAP Indicator,gavi,2011,dtp1,78086066,67570942,87,10515124
GVAP Indicator,gavi,2011,pol3,78086066,60510909,77,17575157
GVAP Indicator,gavi,2011,hib3,78086066,31550000,40,46536066
GVAP Indicator,gavi,2011,rcv1,78086066,2852499,4,75233567
GVAP Indicator,gavi,2011,rotac,78086066,857833,1,77228233
GVAP Indicator,gavi,2011,mcv1,78086066,60644228,78,17441838
GVAP Indicator,gavi,2011,hepb3,78086066,50388157,65,27697909
GVAP Indicator,gavi,2011,mcv2,75987277,18006191,24,57981086
GVAP Indicator,gavi,2012,bcg,82719609,70942271,86,11777338
GVAP Indicator,gavi,2012,hepbb,82719609,11925528,14,70794081
GVAP Indicator,gavi,2012,pol3,78530916,60833794,77,17697122
GVAP Indicator,gavi,2012,dtp3,78530916,61408493,78,17122423
GVAP Indicator,gavi,2012,dtp1,78530916,67455833,86,11075083
GVAP Indicator,gavi,2012,pcv3,78530916,6936360,9,71594556
GVAP Indicator,gavi,2012,mcv1,78530916,60465791,77,18065125
GVAP Indicator,gavi,2012,rcv1,78530916,3554509,5,74976407
GVAP Indicator,gavi,2012,rotac,78530916,2234880,3,76296036
GVAP Indicator,gavi,2012,hepb3,78530916,58152329,74,20378587
GVAP Indicator,gavi,2012,hib3,78530916,33467234,43,45063682
GVAP Indicator,gavi,2012,mcv2,76721811,21523030,28,55198781
GVAP Indicator,gavi,2013,bcg,83075961,71025478,85,12050483
GVAP Indicator,gavi,2013,hepbb,83075961,15155673,18,67920288
GVAP Indicator,gavi,2013,hepb3,78992372,58176608,74,20815764
GVAP Indicator,gavi,2013,pol3,78992372,61684033,78,17308339
GVAP Indicator,gavi,2013,dtp3,78992372,61602456,78,17389916
GVAP Indicator,gavi,2013,pcv3,78992372,15436057,20,63556315
GVAP Indicator,gavi,2013,dtp1,78992372,68112683,86,10879689
GVAP Indicator,gavi,2013,hib3,78992372,41122336,52,37870036
GVAP Indicator,gavi,2013,rcv1,78992372,7749086,10,71243286
GVAP Indicator,gavi,2013,mcv1,78992372,60728943,77,18263429
GVAP Indicator,gavi,2013,rotac,78992372,5256700,7,73735672
GVAP Indicator,gavi,2013,mcv2,76664496,27539272,36,49125224
GVAP Indicator,gavi,2014,hepbb,83462528,16317797,20,67144731
GVAP Indicator,gavi,2014,bcg,83462528,71088864,85,12373664
GVAP Indicator,gavi,2014,hib3,79477574,44794287,56,34683287
GVAP Indicator,gavi,2014,dtp1,79477574,69196624,87,10280950
GVAP Indicator,gavi,2014,rcv1,79477574,9687692,12,69789882
GVAP Indicator,gavi,2014,dtp3,79477574,63057547,79,16420027
GVAP Indicator,gavi,2014,pcv3,79477574,22524757,28,56952817
GVAP Indicator,gavi,2014,pol3,79477574,62879846,79,16597728
GVAP Indicator,gavi,2014,rotac,79477574,11505767,14,67971807
GVAP Indicator,gavi,2014,hepb3,79477574,61425263,77,18052311
GVAP Indicator,gavi,2014,mcv1,79477574,61662638,78,17814936
GVAP Indicator,gavi,2014,mcv2,77140836,29166964,38,47973872
GVAP Indicator,gavi,2015,bcg,83878573,70011308,83,13867265
GVAP Indicator,gavi,2015,hepbb,83878573,17506762,21,66371811
GVAP Indicator,gavi,2015,hepb3,79985890,63809870,80,16176020
GVAP Indicator,gavi,2015,hib3,79985890,53691744,67,26294146
GVAP Indicator,gavi,2015,rcv1,79985890,13463365,17,66522525
GVAP Indicator,gavi,2015,dtp1,79985890,69398854,87,10587036
GVAP Indicator,gavi,2015,dtp3,79985890,63826740,80,16159150
GVAP Indicator,gavi,2015,rotac,79985890,15229483,19,64756407
GVAP Indicator,gavi,2015,pol3,79985890,63575628,79,16410262
GVAP Indicator,gavi,2015,pcv3,79985890,27639333,35,52346557
GVAP Indicator,gavi,2015,mcv1,79985890,62445693,78,17540197
GVAP Indicator,gavi,2015,mcv2,77653986,33838657,44,43815329
GVAP Indicator,gavi,2016,bcg,84314625,71450873,85,12863752
GVAP Indicator,gavi,2016,hepbb,84314625,18486985,22,65827640
GVAP Indicator,gavi,2016,pol3,80508460,63814427,79,16694033
GVAP Indicator,gavi,2016,rotac,80508460,18125248,23,62383212
GVAP Indicator,gavi,2016,rcv1,80508460,14032764,17,66475696
GVAP Indicator,gavi,2016,dtp3,80508460,64585078,80,15923382
GVAP Indicator,gavi,2016,dtp1,80508460,69977909,87,10530551
GVAP Indicator,gavi,2016,pcv3,80508460,32486039,40,48022421
GVAP Indicator,gavi,2016,hepb3,80508460,64608002,80,15900458
GVAP Indicator,gavi,2016,hib3,80508460,62776806,78,17731654
GVAP Indicator,gavi,2016,mcv1,80508460,63061944,78,17446516
GVAP Indicator,gavi,2016,mcv2,78019035,39088383,50,38930652
GVAP Indicator,mic_nongavi,1980,bcg,44477172,9711907,22,34765265
GVAP Indicator,mic_nongavi,1980,rcv1,41978108,0,0,41978108
GVAP Indicator,mic_nongavi,1980,mcv1,41978108,6121679,15,35856429
GVAP Indicator,mic_nongavi,1980,dtp1,41978108,12089119,29,29888989
GVAP Indicator,mic_nongavi,1980,pol3,41978108,10205199,24,31772909
GVAP Indicator,mic_nongavi,1980,dtp3,41978108,7600022,18,34378086
GVAP Indicator,mic_nongavi,1981,bcg,45154098,10856472,24,34297626
GVAP Indicator,mic_nongavi,1981,mcv1,42727118,7450118,17,35277000
GVAP Indicator,mic_nongavi,1981,dtp1,42727118,13112086,31,29615032
GVAP Indicator,mic_nongavi,1981,pol3,42727118,10114162,24,32612956
GVAP Indicator,mic_nongavi,1981,dtp3,42727118,8650180,20,34076938
GVAP Indicator,mic_nongavi,1981,rcv1,42727118,0,0,42727118
GVAP Indicator,mic_nongavi,1982,bcg,46168055,12335439,27,33832616
GVAP Indicator,mic_nongavi,1982,mcv1,43792533,8150399,19,35642134
GVAP Indicator,mic_nongavi,1982,pol3,43792533,28651061,65,15141472
GVAP Indicator,mic_nongavi,1982,rcv1,43792533,0,0,43792533
GVAP Indicator,mic_nongavi,1982,dtp1,43792533,14206103,32,29586430
GVAP Indicator,mic_nongavi,1982,dtp3,43792533,9559736,22,34232797
GVAP Indicator,mic_nongavi,1983,bcg,47402612,21857574,46,25545038
GVAP Indicator,mic_nongavi,1983,dtp1,45064370,33458149,74,11606221
GVAP Indicator,mic_nongavi,1983,pol3,45064370,30392504,67,14671866
GVAP Indicator,mic_nongavi,1983,rcv1,45064370,0,0,45064370
GVAP Indicator,mic_nongavi,1983,dtp3,45064370,23699347,53,21365023
GVAP Indicator,mic_nongavi,1983,mcv1,45064370,26742887,59,18321483
GVAP Indicator,mic_nongavi,1984,bcg,48735239,29004227,60,19731012
GVAP Indicator,mic_nongavi,1984,dtp3,46426167,29349381,63,17076786
GVAP Indicator,mic_nongavi,1984,rcv1,46426167,0,0,46426167
GVAP Indicator,mic_nongavi,1984,dtp1,46426167,37932547,82,8493620
GVAP Indicator,mic_nongavi,1984,mcv1,46426167,30244186,65,16181981
GVAP Indicator,mic_nongavi,1984,pol3,46426167,33330938,72,13095229
GVAP Indicator,mic_nongavi,1985,bcg,49968239,32968762,66,16999477
GVAP Indicator,mic_nongavi,1985,dtp1,47688662,41163320,86,6525342
GVAP Indicator,mic_nongavi,1985,rcv1,47688662,0,0,47688662
GVAP Indicator,mic_nongavi,1985,dtp3,47688662,33131450,69,14557212
GVAP Indicator,mic_nongavi,1985,hepb3,47688662,0,0,47688662
GVAP Indicator,mic_nongavi,1985,mcv1,47688662,35247291,74,12441371
GVAP Indicator,mic_nongavi,1985,pol3,47688662,35852566,75,11836096
GVAP Indicator,mic_nongavi,1986,bcg,50886004,36379488,71,14506516
GVAP Indicator,mic_nongavi,1986,hepb3,48645208,0,0,48645208
GVAP Indicator,mic_nongavi,1986,dtp1,48645208,42467778,87,6177430
GVAP Indicator,mic_nongavi,1986,mcv1,48645208,30271152,62,18374056
GVAP Indicator,mic_nongavi,1986,dtp3,48645208,34356250,71,14288958
GVAP Indicator,mic_nongavi,1986,rcv1,48645208,3584,0,48641624
GVAP Indicator,mic_nongavi,1986,pol3,48645208,32953715,68,15691493
GVAP Indicator,mic_nongavi,1987,bcg,51355375,41549085,81,9806290
GVAP Indicator,mic_nongavi,1987,dtp3,49166611,35235702,72,13930909
GVAP Indicator,mic_nongavi,1987,pol3,49166611,36983707,75,12182904
GVAP Indicator,mic_nongavi,1987,hepb3,49166611,0,0,49166611
GVAP Indicator,mic_nongavi,1987,mcv1,49166611,34948360,71,14218251
GVAP Indicator,mic_nongavi,1987,dtp1,49166611,43420690,88,5745921
GVAP Indicator,mic_nongavi,1987,rcv1,49166611,79494,0,49087117
GVAP Indicator,mic_nongavi,1988,bcg,51295370,46599908,91,4695462
GVAP Indicator,mic_nongavi,1988,dtp3,49175663,41696409,85,7479254
GVAP Indicator,mic_nongavi,1988,dtp1,49175663,45948200,93,3227463
GVAP Indicator,mic_nongavi,1988,mcv1,49175663,41348447,84,7827216
GVAP Indicator,mic_nongavi,1988,pol3,49175663,43159511,88,6016152
GVAP Indicator,mic_nongavi,1988,hepb3,49175663,0,0,49175663
GVAP Indicator,mic_nongavi,1988,rcv1,49175663,83924,0,49091739
GVAP Indicator,mic_nongavi,1989,bcg,50696683,46441419,92,4255264
GVAP Indicator,mic_nongavi,1989,dtp3,48664140,41580199,85,7083941
GVAP Indicator,mic_nongavi,1989,rcv1,48664140,70420,0,48593720
GVAP Indicator,mic_nongavi,1989,mcv1,48664140,41609678,86,7054462
GVAP Indicator,mic_nongavi,1989,pol3,48664140,42770664,88,5893476
GVAP Indicator,mic_nongavi,1989,dtp1,48664140,45700137,94,2964003
GVAP Indicator,mic_nongavi,1989,hepb3,48664140,340837,1,48323303
GVAP Indicator,mic_nongavi,1990,bcg,49610981,46030851,93,3580130
GVAP Indicator,mic_nongavi,1990,pol3,47682603,42414046,89,5268557
GVAP Indicator,mic_nongavi,1990,mcv1,47682603,42484169,89,5198434
GVAP Indicator,mic_nongavi,1990,rcv1,47682603,80432,0,47602171
GVAP Indicator,mic_nongavi,1990,dtp3,47682603,41956727,88,5725876
GVAP Indicator,mic_nongavi,1990,hepb3,47682603,434272,1,47248331
GVAP Indicator,mic_nongavi,1990,dtp1,47682603,45112496,95,2570107
GVAP Indicator,mic_nongavi,1990,hib3,47682603,0,0,47682603
GVAP Indicator,mic_nongavi,1991,bcg,48212637,44970401,93,3242236
GVAP Indicator,mic_nongavi,1991,hib3,46398163,0,0,46398163
GVAP Indicator,mic_nongavi,1991,pol3,46398163,40962258,88,5435905
GVAP Indicator,mic_nongavi,1991,hepb3,46398163,459485,1,45938678
GVAP Indicator,mic_nongavi,1991,rcv1,46398163,88516,0,46309647
GVAP Indicator,mic_nongavi,1991,mcv1,46398163,40366070,87,6032093
GVAP Indicator,mic_nongavi,1991,dtp1,46398163,44049513,95,2348650
GVAP Indicator,mic_nongavi,1991,dtp3,46398163,40771360,88,5626803
GVAP Indicator,mic_nongavi,1992,bcg,49116703,45295025,92,3821678
GVAP Indicator,mic_nongavi,1992,dtp1,47354246,44701187,94,2653059
GVAP Indicator,mic_nongavi,1992,hib3,47354246,0,0,47354246
GVAP Indicator,mic_nongavi,1992,hepb3,47354246,803294,2,46550952
GVAP Indicator,mic_nongavi,1992,dtp3,47354246,40551190,86,6803056
GVAP Indicator,mic_nongavi,1992,rcv1,47354246,163314,0,47190932
GVAP Indicator,mic_nongavi,1992,mcv1,47354246,40348314,85,7005932
GVAP Indicator,mic_nongavi,1992,pol3,47354246,40992118,87,6362128
GVAP Indicator,mic_nongavi,1993,bcg,47504610,43903398,92,3601212
GVAP Indicator,mic_nongavi,1993,mcv1,45864522,37727727,82,8136795
GVAP Indicator,mic_nongavi,1993,hib3,45864522,0,0,45864522
GVAP Indicator,mic_nongavi,1993,rcv1,45864522,1140284,2,44724238
GVAP Indicator,mic_nongavi,1993,dtp1,45864522,43099060,94,2765462
GVAP Indicator,mic_nongavi,1993,pol3,45864522,39035299,85,6829223
GVAP Indicator,mic_nongavi,1993,hepb3,45864522,1364694,3,44499828
GVAP Indicator,mic_nongavi,1993,dtp3,45864522,38751377,84,7113145
GVAP Indicator,mic_nongavi,1994,bcg,45907761,42121487,92,3786274
GVAP Indicator,mic_nongavi,1994,hepb3,44388860,4032389,9,40356471
GVAP Indicator,mic_nongavi,1994,hib3,44388860,0,0,44388860
GVAP Indicator,mic_nongavi,1994,mcv1,44388860,35436445,80,8952415
GVAP Indicator,mic_nongavi,1994,rcv1,44388860,1301268,3,43087592
GVAP Indicator,mic_nongavi,1994,pol3,44388860,37496243,84,6892617
GVAP Indicator,mic_nongavi,1994,dtp1,44388860,40161653,90,4227207
GVAP Indicator,mic_nongavi,1994,dtp3,44388860,37262712,84,7126148
GVAP Indicator,mic_nongavi,1995,bcg,44555429,39097993,88,5457436
GVAP Indicator,mic_nongavi,1995,pol3,43148562,35802179,83,7346383
GVAP Indicator,mic_nongavi,1995,dtp3,43148562,35408258,82,7740304
GVAP Indicator,mic_nongavi,1995,rcv1,43148562,2916660,7,40231902
GVAP Indicator,mic_nongavi,1995,hepb3,43148562,6495535,15,36653027
GVAP Indicator,mic_nongavi,1995,dtp1,43148562,39702370,92,3446192
GVAP Indicator,mic_nongavi,1995,hib3,43148562,0,0,43148562
GVAP Indicator,mic_nongavi,1995,mcv1,43148562,35757280,83,7391282
GVAP Indicator,mic_nongavi,1996,bcg,43486037,39257576,90,4228461
GVAP Indicator,mic_nongavi,1996,pol3,42180154,35843813,85,6336341
GVAP Indicator,mic_nongavi,1996,hepb3,42180154,7354339,17,34825815
GVAP Indicator,mic_nongavi,1996,rcv1,42180154,3009780,7,39170374
GVAP Indicator,mic_nongavi,1996,dtp1,42180154,38786093,92,3394061
GVAP Indicator,mic_nongavi,1996,mcv1,42180154,35847405,85,6332749
GVAP Indicator,mic_nongavi,1996,hib3,42180154,0,0,42180154
GVAP Indicator,mic_nongavi,1996,dtp3,42180154,35333949,84,6846205
GVAP Indicator,mic_nongavi,1997,bcg,42652165,38517340,90,4134825
GVAP Indicator,mic_nongavi,1997,hepb3,41437388,8194547,20,33242841
GVAP Indicator,mic_nongavi,1997,dtp1,41437388,39281062,95,2156326
GVAP Indicator,mic_nongavi,1997,mcv1,41437388,35848226,87,5589162
GVAP Indicator,mic_nongavi,1997,pol3,41437388,36096584,87,5340804
GVAP Indicator,mic_nongavi,1997,hib3,41437388,19605,0,41417783
GVAP Indicator,mic_nongavi,1997,dtp3,41437388,35300678,85,6136710
GVAP Indicator,mic_nongavi,1997,rcv1,41437388,3346394,8,38090994
GVAP Indicator,mic_nongavi,1998,bcg,42010625,37924598,90,4086027
GVAP Indicator,mic_nongavi,1998,pol3,40878334,35742467,87,5135867
GVAP Indicator,mic_nongavi,1998,hepb3,40878334,8218210,20,32660124
GVAP Indicator,mic_nongavi,1998,dtp1,40878334,38743305,95,2135029
GVAP Indicator,mic_nongavi,1998,dtp3,40878334,35241990,86,5636344
GVAP Indicator,mic_nongavi,1998,hib3,40878334,974324,2,39904010
GVAP Indicator,mic_nongavi,1998,rcv1,40878334,6689688,16,34188646
GVAP Indicator,mic_nongavi,1998,mcv1,40878334,35755409,87,5122925
GVAP Indicator,mic_nongavi,1999,bcg,41558681,37806384,91,3752297
GVAP Indicator,mic_nongavi,1999,dtp1,40500439,38498803,95,2001636
GVAP Indicator,mic_nongavi,1999,hepb3,40500439,11494841,28,29005598
GVAP Indicator,mic_nongavi,1999,dtp3,40500439,35402015,87,5098424
GVAP Indicator,mic_nongavi,1999,pol3,40500439,35843991,89,4656448
GVAP Indicator,mic_nongavi,1999,rcv1,40500439,8624605,21,31875834
GVAP Indicator,mic_nongavi,1999,mcv1,40500439,35653418,88,4847021
GVAP Indicator,mic_nongavi,1999,hib3,40500439,1379800,3,39120639
GVAP Indicator,mic_nongavi,2000,hepbb,41519373,6490875,16,35028498
GVAP Indicator,mic_nongavi,2000,bcg,41284850,37668994,91,3615856
GVAP Indicator,mic_nongavi,2000,pol3,40292974,35727621,89,4565353
GVAP Indicator,mic_nongavi,2000,rcv1,40292974,13723605,34,26569369
GVAP Indicator,mic_nongavi,2000,hib3,40292974,7659479,19,32633495
GVAP Indicator,mic_nongavi,2000,mcv1,40292974,35604164,88,4688810
GVAP Indicator,mic_nongavi,2000,dtp1,40292974,38256810,95,2036164
GVAP Indicator,mic_nongavi,2000,hepb3,40292974,24722691,61,15570283
GVAP Indicator,mic_nongavi,2000,dtp3,40292974,35542541,88,4750433
GVAP Indicator,mic_nongavi,2000,mcv2,40750659,14899369,37,25851290
GVAP Indicator,mic_nongavi,2001,hepbb,41402177,6571025,16,34831152
GVAP Indicator,mic_nongavi,2001,bcg,41167873,37413452,91,3754421
GVAP Indicator,mic_nongavi,2001,dtp3,40235955,35550212,88,4685743
GVAP Indicator,mic_nongavi,2001,hib3,40235955,8393571,21,31842384
GVAP Indicator,mic_nongavi,2001,pol3,40235955,35667389,89,4568566
GVAP Indicator,mic_nongavi,2001,mcv1,40235955,35819569,89,4416386
GVAP Indicator,mic_nongavi,2001,dtp1,40235955,38134221,95,2101734
GVAP Indicator,mic_nongavi,2001,hepb3,40235955,27453514,68,12782441
GVAP Indicator,mic_nongavi,2001,rcv1,40235955,14621887,36,25614068
GVAP Indicator,mic_nongavi,2001,mcv2,40854654,16295676,40,24558978
GVAP Indicator,mic_nongavi,2002,bcg,41333349,37339563,90,3993786
GVAP Indicator,mic_nongavi,2002,hepbb,41405333,6606637,16,34798696
GVAP Indicator,mic_nongavi,2002,pol3,40294589,35645813,88,4648776
GVAP Indicator,mic_nongavi,2002,dtp1,40294589,37947240,94,2347349
GVAP Indicator,mic_nongavi,2002,mcv1,40294589,35591886,88,4702703
GVAP Indicator,mic_nongavi,2002,dtp3,40294589,35550436,88,4744153
GVAP Indicator,mic_nongavi,2002,hib3,40294589,8886436,22,31408153
GVAP Indicator,mic_nongavi,2002,rcv1,40294589,14644999,36,25649590
GVAP Indicator,mic_nongavi,2002,hepb3,40294589,29354049,73,10940540
GVAP Indicator,mic_nongavi,2002,mcv2,41220148,15752134,38,25468014
GVAP Indicator,mic_nongavi,2003,bcg,41423748,37637931,91,3785817
GVAP Indicator,mic_nongavi,2003,hepbb,41493754,7986849,19,33506905
GVAP Indicator,mic_nongavi,2003,mcv1,40435091,35729268,88,4705823
GVAP Indicator,mic_nongavi,2003,rcv1,40435091,15248501,38,25186590
GVAP Indicator,mic_nongavi,2003,hib3,40435091,9646363,24,30788728
GVAP Indicator,mic_nongavi,2003,pol3,40435091,36047642,89,4387449
GVAP Indicator,mic_nongavi,2003,dtp3,40435091,35743234,88,4691857
GVAP Indicator,mic_nongavi,2003,dtp1,40435091,38011469,94,2423622
GVAP Indicator,mic_nongavi,2003,hepb3,40435091,31576720,78,8858371
GVAP Indicator,mic_nongavi,2003,mcv2,39744027,15763504,40,23980523
GVAP Indicator,mic_nongavi,2004,bcg,41575530,37896591,91,3678939
GVAP Indicator,mic_nongavi,2004,hepbb,41643651,22788354,55,18855297
GVAP Indicator,mic_nongavi,2004,hib3,40634330,10514728,26,30119602
GVAP Indicator,mic_nongavi,2004,mcv1,40634330,36153299,89,4481031
GVAP Indicator,mic_nongavi,2004,pol3,40634330,36351513,89,4282817
GVAP Indicator,mic_nongavi,2004,rcv1,40634330,17343740,43,23290590
GVAP Indicator,mic_nongavi,2004,dtp1,40634330,38494021,95,2140309
GVAP Indicator,mic_nongavi,2004,dtp3,40634330,36517225,90,4117105
GVAP Indicator,mic_nongavi,2004,hepb3,40634330,33383378,82,7250952
GVAP Indicator,mic_nongavi,2004,mcv2,39981412,16235809,41,23745603
GVAP Indicator,mic_nongavi,2005,hepbb,41850901,24829864,59,17021037
GVAP Indicator,mic_nongavi,2005,bcg,41784189,38121880,91,3662309
GVAP Indicator,mic_nongavi,2005,hib3,40888306,11159376,27,29728930
GVAP Indicator,mic_nongavi,2005,rcv1,40888306,17520032,43,23368274
GVAP Indicator,mic_nongavi,2005,mcv1,40888306,36495900,89,4392406
GVAP Indicator,mic_nongavi,2005,dtp1,40888306,38970892,95,1917414
GVAP Indicator,mic_nongavi,2005,dtp3,40888306,36886693,90,4001613
GVAP Indicator,mic_nongavi,2005,pol3,40888306,36785415,90,4102891
GVAP Indicator,mic_nongavi,2005,hepb3,40888306,35220003,86,5668303
GVAP Indicator,mic_nongavi,2005,mcv2,40104978,29640131,74,10464847
GVAP Indicator,mic_nongavi,2006,hepbb,42125154,25386903,60,16738251
GVAP Indicator,mic_nongavi,2006,bcg,42058947,39450270,94,2608677
GVAP Indicator,mic_nongavi,2006,pol3,41206314,38380031,93,2826283
GVAP Indicator,mic_nongavi,2006,rcv1,41206314,19013328,46,22192986
GVAP Indicator,mic_nongavi,2006,hib3,41206314,10998173,27,30208141
GVAP Indicator,mic_nongavi,2006,rotac,41206314,1627442,4,39578872
GVAP Indicator,mic_nongavi,2006,hepb3,41206314,37244638,90,3961676
GVAP Indicator,mic_nongavi,2006,dtp3,41206314,38156204,93,3050110
GVAP Indicator,mic_nongavi,2006,dtp1,41206314,39702357,96,1503957
GVAP Indicator,mic_nongavi,2006,mcv1,41206314,38232601,93,2973713
GVAP Indicator,mic_nongavi,2006,mcv2,40557995,31345248,77,9212747
GVAP Indicator,mic_nongavi,2007,bcg,42402018,40118112,95,2283906
GVAP Indicator,mic_nongavi,2007,hepbb,42468864,25668543,60,16800321
GVAP Indicator,mic_nongavi,2007,hib3,41590217,12703673,31,28886544
GVAP Indicator,mic_nongavi,2007,rcv1,41590217,19304129,46,22286088
GVAP Indicator,mic_nongavi,2007,hepb3,41590217,38108149,92,3482068
GVAP Indicator,mic_nongavi,2007,mcv1,41590217,38654309,93,2935908
GVAP Indicator,mic_nongavi,2007,dtp1,41590217,39999596,96,1590621
GVAP Indicator,mic_nongavi,2007,pol3,41590217,38797459,93,2792758
GVAP Indicator,mic_nongavi,2007,rotac,41590217,2769452,7,38820765
GVAP Indicator,mic_nongavi,2007,dtp3,41590217,38467843,92,3122374
GVAP Indicator,mic_nongavi,2007,mcv2,41020026,31456111,77,9563915
GVAP Indicator,mic_nongavi,2008,bcg,42798044,41179126,96,1618918
GVAP Indicator,mic_nongavi,2008,hepbb,42866763,27208357,63,15658406
GVAP Indicator,mic_nongavi,2008,hib3,42024550,13937965,33,28086585
GVAP Indicator,mic_nongavi,2008,rcv1,42024550,19043218,45,22981332
GVAP Indicator,mic_nongavi,2008,dtp1,42024550,40759388,97,1265162
GVAP Indicator,mic_nongavi,2008,pcv3,42024550,322034,1,41702516
GVAP Indicator,mic_nongavi,2008,rotac,42024550,4269633,10,37754917
GVAP Indicator,mic_nongavi,2008,mcv1,42024550,39735514,95,2289036
GVAP Indicator,mic_nongavi,2008,dtp3,42024550,39633277,94,2391273
GVAP Indicator,mic_nongavi,2008,pol3,42024550,40144242,96,1880308
GVAP Indicator,mic_nongavi,2008,hepb3,42024550,38951434,93,3073116
GVAP Indicator,mic_nongavi,2008,mcv2,40675788,31628044,78,9047744
GVAP Indicator,mic_nongavi,2009,hepbb,43285094,27646968,64,15638126
GVAP Indicator,mic_nongavi,2009,bcg,43213319,41821000,97,1392319
GVAP Indicator,mic_nongavi,2009,rcv1,42475913,19298490,45,23177423
GVAP Indicator,mic_nongavi,2009,hepb3,42475913,40327082,95,2148831
GVAP Indicator,mic_nongavi,2009,hib3,42475913,14385808,34,28090105
GVAP Indicator,mic_nongavi,2009,mcv1,42475913,40490892,95,1985021
GVAP Indicator,mic_nongavi,2009,dtp1,42475913,41085203,97,1390710
GVAP Indicator,mic_nongavi,2009,pcv3,42475913,2505400,6,39970513
GVAP Indicator,mic_nongavi,2009,dtp3,42475913,40530158,95,1945755
GVAP Indicator,mic_nongavi,2009,pol3,42475913,40463373,95,2012540
GVAP Indicator,mic_nongavi,2009,rotac,42475913,6354045,15,36121868
GVAP Indicator,mic_nongavi,2009,mcv2,40931055,33461652,82,7469403
GVAP Indicator,mic_nongavi,2010,hepbb,43674482,29645867,68,14028615
GVAP Indicator,mic_nongavi,2010,bcg,43598635,41946720,96,1651915
GVAP Indicator,mic_nongavi,2010,pol3,42895489,40580155,95,2315334
GVAP Indicator,mic_nongavi,2010,pcv3,42895489,5644409,13,37251080
GVAP Indicator,mic_nongavi,2010,rcv1,42895489,31713504,74,11181985
GVAP Indicator,mic_nongavi,2010,rotac,42895489,7255005,17,35640484
GVAP Indicator,mic_nongavi,2010,dtp1,42895489,41252662,96,1642827
GVAP Indicator,mic_nongavi,2010,hib3,42895489,14580234,34,28315255
GVAP Indicator,mic_nongavi,2010,mcv1,42895489,40571752,95,2323737
GVAP Indicator,mic_nongavi,2010,hepb3,42895489,40362389,94,2533100
GVAP Indicator,mic_nongavi,2010,dtp3,42895489,40609902,95,2285587
GVAP Indicator,mic_nongavi,2010,mcv2,41276548,33782535,82,7494013
GVAP Indicator,mic_nongavi,2011,bcg,43902110,42384213,97,1517897
GVAP Indicator,mic_nongavi,2011,hepbb,43982756,30874199,70,13108557
GVAP Indicator,mic_nongavi,2011,hepb3,43231751,40986725,95,2245026
GVAP Indicator,mic_nongavi,2011,rcv1,43231751,36323122,84,6908629
GVAP Indicator,mic_nongavi,2011,pol3,43231751,40914280,95,2317471
GVAP Indicator,mic_nongavi,2011,dtp3,43231751,41002823,95,2228928
GVAP Indicator,mic_nongavi,2011,dtp1,43231751,41857008,97,1374743
GVAP Indicator,mic_nongavi,2011,pcv3,43231751,8172809,19,35058942
GVAP Indicator,mic_nongavi,2011,rotac,43231751,8510220,20,34721531
GVAP Indicator,mic_nongavi,2011,hib3,43231751,15143082,35,28088669
GVAP Indicator,mic_nongavi,2011,mcv1,43231751,41221824,95,2009927
GVAP Indicator,mic_nongavi,2011,mcv2,41576452,35243313,85,6333139
GVAP Indicator,mic_nongavi,2012,bcg,44088900,42539192,96,1549708
GVAP Indicator,mic_nongavi,2012,hepbb,44174607,30739334,70,13435273
GVAP Indicator,mic_nongavi,2012,pol3,43450058,40916633,94,2533425
GVAP Indicator,mic_nongavi,2012,pcv3,43450058,9845449,23,33604609
GVAP Indicator,mic_nongavi,2012,hib3,43450058,15826462,36,27623596
GVAP Indicator,mic_nongavi,2012,dtp3,43450058,40929246,94,2520812
GVAP Indicator,mic_nongavi,2012,rotac,43450058,9318572,21,34131486
GVAP Indicator,mic_nongavi,2012,rcv1,43450058,37991928,87,5458130
GVAP Indicator,mic_nongavi,2012,dtp1,43450058,41772474,96,1677584
GVAP Indicator,mic_nongavi,2012,mcv1,43450058,41202252,95,2247806
GVAP Indicator,mic_nongavi,2012,hepb3,43450058,40856375,94,2593683
GVAP Indicator,mic_nongavi,2012,mcv2,41883273,35188943,84,6694330
GVAP Indicator,mic_nongavi,2013,bcg,44136310,42375269,96,1761041
GVAP Indicator,mic_nongavi,2013,hepbb,44226889,31569119,71,12657770
GVAP Indicator,mic_nongavi,2013,rotac,43527866,9996860,23,33531006
GVAP Indicator,mic_nongavi,2013,dtp3,43527866,40808394,94,2719472
GVAP Indicator,mic_nongavi,2013,mcv1,43527866,40909857,94,2618009
GVAP Indicator,mic_nongavi,2013,dtp1,43527866,41763063,96,1764803
GVAP Indicator,mic_nongavi,2013,pol3,43527866,40593777,93,2934089
GVAP Indicator,mic_nongavi,2013,hepb3,43527866,40832567,94,2695299
GVAP Indicator,mic_nongavi,2013,pcv3,43527866,10328749,24,33199117
GVAP Indicator,mic_nongavi,2013,hib3,43527866,17521497,40,26006369
GVAP Indicator,mic_nongavi,2013,rcv1,43527866,37814465,87,5713401
GVAP Indicator,mic_nongavi,2013,mcv2,42599834,35716893,84,6882941
GVAP Indicator,mic_nongavi,2014,hepbb,44129270,30759601,70,13369669
GVAP Indicator,mic_nongavi,2014,bcg,44034316,42186757,96,1847559
GVAP Indicator,mic_nongavi,2014,rcv1,43455246,38722028,89,4733218
GVAP Indicator,mic_nongavi,2014,pcv3,43455246,11707202,27,31748044
GVAP Indicator,mic_nongavi,2014,hepb3,43455246,40068252,92,3386994
GVAP Indicator,mic_nongavi,2014,hib3,43455246,19264998,44,24190248
GVAP Indicator,mic_nongavi,2014,dtp3,43455246,40027215,92,3428031
GVAP Indicator,mic_nongavi,2014,dtp1,43455246,41380242,95,2075004
GVAP Indicator,mic_nongavi,2014,mcv1,43455246,40579987,93,2875259
GVAP Indicator,mic_nongavi,2014,pol3,43455246,40310836,93,3144410
GVAP Indicator,mic_nongavi,2014,rotac,43455246,9273160,21,34182086
GVAP Indicator,mic_nongavi,2014,mcv2,42965898,37698028,88,5267870
GVAP Indicator,mic_nongavi,2015,bcg,43785272,41710370,95,2074902
GVAP Indicator,mic_nongavi,2015,hepbb,43883842,31350426,71,12533416
GVAP Indicator,mic_nongavi,2015,rcv1,43234522,38618426,89,4616096
GVAP Indicator,mic_nongavi,2015,dtp3,43234522,39680789,92,3553733
GVAP Indicator,mic_nongavi,2015,pcv3,43234522,11790646,27,31443876
GVAP Indicator,mic_nongavi,2015,pol3,43234522,40334564,93,2899958
GVAP Indicator,mic_nongavi,2015,hib3,43234522,20373674,47,22860848
GVAP Indicator,mic_nongavi,2015,rotac,43234522,10221045,24,33013477
GVAP Indicator,mic_nongavi,2015,mcv1,43234522,40491055,94,2743467
GVAP Indicator,mic_nongavi,2015,dtp1,43234522,40979962,95,2254560
GVAP Indicator,mic_nongavi,2015,hepb3,43234522,39535927,91,3698595
GVAP Indicator,mic_nongavi,2015,mcv2,43225220,38255079,89,4970141
GVAP Indicator,mic_nongavi,2016,bcg,43407787,41366921,95,2040866
GVAP Indicator,mic_nongavi,2016,hepbb,43509059,31153854,72,12355205
GVAP Indicator,mic_nongavi,2016,dtp3,42884131,39823851,93,3060280
GVAP Indicator,mic_nongavi,2016,rcv1,42884131,38481346,90,4402785
GVAP Indicator,mic_nongavi,2016,pol3,42884131,39825874,93,3058257
GVAP Indicator,mic_nongavi,2016,dtp1,42884131,40823024,95,2061107
GVAP Indicator,mic_nongavi,2016,rotac,42884131,9882419,23,33001712
GVAP Indicator,mic_nongavi,2016,mcv1,42884131,40291481,94,2592650
GVAP Indicator,mic_nongavi,2016,hepb3,42884131,39722628,93,3161503
GVAP Indicator,mic_nongavi,2016,pcv3,42884131,13301257,31,29582874
GVAP Indicator,mic_nongavi,2016,hib3,42884131,20772047,48,22112084
GVAP Indicator,mic_nongavi,2016,mcv2,43607459,38883239,89,4724220
GVAP Indicator,hic,1997,rcv1,12657421,11358583,90,1298838
GVAP Indicator,hic,1997,dtp3,12657421,11475824,91,1181597
GVAP Indicator,hic,1997,dtp1,12657421,12160553,96,496868
GVAP Indicator,hic,1997,hepb3,12657421,6645777,53,6011644
GVAP Indicator,hic,1997,pol3,12657421,11722728,93,934693
GVAP Indicator,hic,1997,hib3,12657421,6541363,52,6116058
GVAP Indicator,hic,1997,mcv1,12657421,11358865,90,1298556
GVAP Indicator,hic,1998,mcv1,12562963,11272826,90,1290137
GVAP Indicator,hic,1998,rcv1,12562963,11272575,90,1290388
GVAP Indicator,hic,1998,pol3,12562963,11554265,92,1008698
GVAP Indicator,hic,1998,hib3,12562963,7694564,61,4868399
GVAP Indicator,hic,1998,hepb3,12562963,7075092,56,5487871
GVAP Indicator,hic,1998,dtp3,12562963,11445553,91,1117410
GVAP Indicator,hic,1998,dtp1,12562963,12070237,96,492726
GVAP Indicator,hic,1999,hib3,12489875,8117890,65,4371985
GVAP Indicator,hic,1999,dtp3,12489875,11620441,93,869434
GVAP Indicator,hic,1999,rcv1,12489875,11322259,91,1167616
GVAP Indicator,hic,1999,dtp1,12489875,12107406,97,382469
GVAP Indicator,hic,1999,hepb3,12489875,7196265,58,5293610
GVAP Indicator,hic,1999,mcv1,12489875,11322393,91,1167482
GVAP Indicator,hic,1999,pol3,12489875,11587031,93,902844
GVAP Indicator,hic,2000,hepbb,12529524,773965,6,11755559
GVAP Indicator,hic,2000,mcv1,12447203,11341799,91,1105404
GVAP Indicator,hic,2000,rcv1,12447203,11341778,91,1105425
GVAP Indicator,hic,2000,pol3,12447203,11623991,93,823212
GVAP Indicator,hic,2000,hib3,12447203,8468124,68,3979079
GVAP Indicator,hic,2000,hepb3,12447203,7402362,59,5044841
GVAP Indicator,hic,2000,dtp1,12447203,12039403,97,407800
GVAP Indicator,hic,2000,dtp3,12447203,11543461,93,903742
GVAP Indicator,hic,2000,mcv2,12849345,2032653,16,10816692
GVAP Indicator,hic,2001,hepbb,12522155,1309154,10,11213001
GVAP Indicator,hic,2001,hib3,12442371,8665353,70,3777018
GVAP Indicator,hic,2001,dtp1,12442371,12152464,98,289907
GVAP Indicator,hic,2001,mcv1,12442371,11393165,92,1049206
GVAP Indicator,hic,2001,hepb3,12442371,7663108,62,4779263
GVAP Indicator,hic,2001,rcv1,12442371,11392916,92,1049455
GVAP Indicator,hic,2001,dtp3,12442371,11751593,94,690778
GVAP Indicator,hic,2001,pol3,12442371,11430534,92,1011837
GVAP Indicator,hic,2001,mcv2,12840378,3065504,24,9774874
GVAP Indicator,hic,2002,hepbb,12550515,2204363,18,10346152
GVAP Indicator,hic,2002,hepb3,12472661,7834567,63,4638094
GVAP Indicator,hic,2002,mcv1,12472661,11483337,92,989324
GVAP Indicator,hic,2002,rcv1,12472661,11483234,92,989427
GVAP Indicator,hic,2002,pol3,12472661,11595058,93,877603
GVAP Indicator,hic,2002,dtp1,12472661,12093410,97,379251
GVAP Indicator,hic,2002,dtp3,12472661,11790120,95,682541
GVAP Indicator,hic,2002,hib3,12472661,9524430,76,2948231
GVAP Indicator,hic,2002,mcv2,12629592,3970485,31,8659107
GVAP Indicator,hic,2003,hepbb,12607725,2949868,23,9657857
GVAP Indicator,hic,2003,rcv1,12531376,11630950,93,900426
GVAP Indicator,hic,2003,pol3,12531376,11754548,94,776828
GVAP Indicator,hic,2003,dtp3,12531376,11998136,96,533240
GVAP Indicator,hic,2003,hepb3,12531376,8119198,65,4412178
GVAP Indicator,hic,2003,hib3,12531376,9715151,78,2816225
GVAP Indicator,hic,2003,dtp1,12531376,12269270,98,262106
GVAP Indicator,hic,2003,mcv1,12531376,11631084,93,900292
GVAP Indicator,hic,2003,mcv2,12722657,3980643,31,8742014
GVAP Indicator,hic,2004,hepbb,12686111,3360699,26,9325412
GVAP Indicator,hic,2004,hepb3,12610977,8330368,66,4280609
GVAP Indicator,hic,2004,pol3,12610977,11891922,94,719055
GVAP Indicator,hic,2004,dtp3,12610977,12043471,95,567506
GVAP Indicator,hic,2004,mcv1,12610977,11734698,93,876279
GVAP Indicator,hic,2004,rcv1,12610977,11734533,93,876444
GVAP Indicator,hic,2004,dtp1,12610977,12320653,98,290324
GVAP Indicator,hic,2004,hib3,12610977,9934914,79,2676063
GVAP Indicator,hic,2004,mcv2,12665391,4819920,38,7845471
GVAP Indicator,hic,2005,hepbb,12771158,3484204,27,9286954
GVAP Indicator,hic,2005,pol3,12697109,11955383,94,741726
GVAP Indicator,hic,2005,mcv1,12697109,11773921,93,923188
GVAP Indicator,hic,2005,hib3,12697109,10114852,80,2582257
GVAP Indicator,hic,2005,rcv1,12697109,11773728,93,923381
GVAP Indicator,hic,2005,dtp3,12697109,12144716,96,552393
GVAP Indicator,hic,2005,hepb3,12697109,8500400,67,4196709
GVAP Indicator,hic,2005,dtp1,12697109,12409480,98,287629
GVAP Indicator,hic,2005,mcv2,12664630,4865457,38,7799173
GVAP Indicator,hic,2006,hepbb,12845674,3513313,27,9332361
GVAP Indicator,hic,2006,rcv1,12772726,11883839,93,888887
GVAP Indicator,hic,2006,pol3,12772726,12112754,95,659972
GVAP Indicator,hic,2006,mcv1,12772726,11883844,93,888882
GVAP Indicator,hic,2006,dtp3,12772726,12277347,96,495379
GVAP Indicator,hic,2006,hepb3,12772726,8812819,69,3959907
GVAP Indicator,hic,2006,hib3,12772726,10244732,80,2527994
GVAP Indicator,hic,2006,dtp1,12772726,12506600,98,266126
GVAP Indicator,hic,2006,rotac,12772726,0,0,12772726
GVAP Indicator,hic,2006,mcv2,12772328,4990455,39,7781873
GVAP Indicator,hic,2007,hepbb,12896943,3671175,28,9225768
GVAP Indicator,hic,2007,mcv1,12825179,11928863,93,896316
GVAP Indicator,hic,2007,dtp1,12825179,12549450,98,275729
GVAP Indicator,hic,2007,pol3,12825179,12136275,95,688904
GVAP Indicator,hic,2007,rcv1,12825179,11928863,93,896316
GVAP Indicator,hic,2007,rotac,12825179,0,0,12825179
GVAP Indicator,hic,2007,hib3,12825179,10515831,82,2309348
GVAP Indicator,hic,2007,dtp3,12825179,12286499,96,538680
GVAP Indicator,hic,2007,hepb3,12825179,8859565,69,3965614
GVAP Indicator,hic,2007,mcv2,12891790,5082575,39,7809215
GVAP Indicator,hic,2008,hepbb,12917419,3773680,29,9143739
GVAP Indicator,hic,2008,mcv1,12846997,11964173,93,882824
GVAP Indicator,hic,2008,pol3,12846997,12203334,95,643663
GVAP Indicator,hic,2008,rcv1,12846997,11964173,93,882824
GVAP Indicator,hic,2008,rotac,12846997,280562,2,12566435
GVAP Indicator,hic,2008,hib3,12846997,10518219,82,2328778
GVAP Indicator,hic,2008,dtp3,12846997,12323616,96,523381
GVAP Indicator,hic,2008,hepb3,12846997,9041864,70,3805133
GVAP Indicator,hic,2008,dtp1,12846997,12566999,98,279998
GVAP Indicator,hic,2008,pcv3,12846997,5197537,40,7649460
GVAP Indicator,hic,2008,mcv2,12779525,5911828,46,6867697
GVAP Indicator,hic,2009,hepbb,12905651,4017156,31,8888495
GVAP Indicator,hic,2009,pol3,12836775,12183777,95,652998
GVAP Indicator,hic,2009,mcv1,12836775,11855135,92,981640
GVAP Indicator,hic,2009,rcv1,12836775,11855120,92,981655
GVAP Indicator,hic,2009,hepb3,12836775,9024989,70,3811786
GVAP Indicator,hic,2009,dtp3,12836775,12264689,96,572086
GVAP Indicator,hic,2009,pcv3,12836775,6435937,50,6400838
GVAP Indicator,hic,2009,dtp1,12836775,12514699,97,322076
GVAP Indicator,hic,2009,rotac,12836775,2106376,16,10730399
GVAP Indicator,hic,2009,hib3,12836775,10244220,80,2592555
GVAP Indicator,hic,2009,mcv2,12817544,6081523,47,6736021
GVAP Indicator,hic,2010,hepbb,12867453,4106239,32,8761214
GVAP Indicator,hic,2010,dtp3,12800341,12232916,96,567425
GVAP Indicator,hic,2010,rotac,12800341,2751357,21,10048984
GVAP Indicator,hic,2010,dtp1,12800341,12474008,97,326333
GVAP Indicator,hic,2010,hepb3,12800341,9178630,72,3621711
GVAP Indicator,hic,2010,mcv1,12800341,11940325,93,860016
GVAP Indicator,hic,2010,pol3,12800341,12145863,95,654478
GVAP Indicator,hic,2010,rcv1,12800341,11940325,93,860016
GVAP Indicator,hic,2010,pcv3,12800341,8105616,63,4694725
GVAP Indicator,hic,2010,hib3,12800341,10446438,82,2353903
GVAP Indicator,hic,2010,mcv2,12858989,6733226,52,6125763
GVAP Indicator,hic,2011,hepbb,12814790,4332530,34,8482260
GVAP Indicator,hic,2011,pol3,12749621,12139069,95,610552
GVAP Indicator,hic,2011,dtp1,12749621,12440009,98,309612
GVAP Indicator,hic,2011,rcv1,12749621,11907573,93,842048
GVAP Indicator,hic,2011,pcv3,12749621,8621667,68,4127954
GVAP Indicator,hic,2011,dtp3,12749621,12255162,96,494459
GVAP Indicator,hic,2011,hib3,12749621,10591730,83,2157891
GVAP Indicator,hic,2011,hepb3,12749621,9371174,74,3378447
GVAP Indicator,hic,2011,rotac,12749621,3071678,24,9677943
GVAP Indicator,hic,2011,mcv1,12749621,11907573,93,842048
GVAP Indicator,hic,2011,mcv2,12896889,6739884,52,6157005
GVAP Indicator,hic,2012,hepbb,12763664,4438712,35,8324952
GVAP Indicator,hic,2012,rcv1,12700528,11908906,94,791622
GVAP Indicator,hic,2012,pcv3,12700528,8855976,70,3844552
GVAP Indicator,hic,2012,dtp1,12700528,12347916,97,352612
GVAP Indicator,hic,2012,mcv1,12700528,11908906,94,791622
GVAP Indicator,hic,2012,pol3,12700528,12130753,96,569775
GVAP Indicator,hic,2012,hepb3,12700528,9319951,73,3380577
GVAP Indicator,hic,2012,dtp3,12700528,12160120,96,540408
GVAP Indicator,hic,2012,hib3,12700528,10551237,83,2149291
GVAP Indicator,hic,2012,rotac,12700528,3377480,27,9323048
GVAP Indicator,hic,2012,mcv2,13002629,7259248,56,5743381
GVAP Indicator,hic,2013,hepbb,12726178,4514386,35,8211792
GVAP Indicator,hic,2013,pol3,12665073,12066880,95,598193
GVAP Indicator,hic,2013,pcv3,12665073,8940932,71,3724141
GVAP Indicator,hic,2013,mcv1,12665073,11875006,94,790067
GVAP Indicator,hic,2013,hepb3,12665073,9311764,74,3353309
GVAP Indicator,hic,2013,dtp3,12665073,12096024,96,569049
GVAP Indicator,hic,2013,hib3,12665073,10544923,83,2120150
GVAP Indicator,hic,2013,rcv1,12665073,11875006,94,790067
GVAP Indicator,hic,2013,dtp1,12665073,12331046,97,334027
GVAP Indicator,hic,2013,rotac,12665073,4045408,32,8619665
GVAP Indicator,hic,2013,mcv2,12944276,7811105,60,5133171
GVAP Indicator,hic,2014,hepbb,12706496,4837103,38,7869393
GVAP Indicator,hic,2014,hepb3,12647367,9490464,75,3156903
GVAP Indicator,hic,2014,pol3,12647367,12047104,95,600263
GVAP Indicator,hic,2014,mcv1,12647367,11907873,94,739494
GVAP Indicator,hic,2014,pcv3,12647367,9095654,72,3551713
GVAP Indicator,hic,2014,hib3,12647367,10974094,87,1673273
GVAP Indicator,hic,2014,dtp3,12647367,12111937,96,535430
GVAP Indicator,hic,2014,rcv1,12647367,11907873,94,739494
GVAP Indicator,hic,2014,dtp1,12647367,12335109,98,312258
GVAP Indicator,hic,2014,rotac,12647367,4647217,37,8000150
GVAP Indicator,hic,2014,mcv2,12908389,7945640,62,4962749
GVAP Indicator,hic,2015,hepbb,12704953,4836644,38,7868309
GVAP Indicator,hic,2015,pcv3,12647729,10610673,84,2037056
GVAP Indicator,hic,2015,dtp3,12647729,12109573,96,538156
GVAP Indicator,hic,2015,mcv1,12647729,11884194,94,763535
GVAP Indicator,hic,2015,dtp1,12647729,12338243,98,309486
GVAP Indicator,hic,2015,hepb3,12647729,9517998,75,3129731
GVAP Indicator,hic,2015,hib3,12647729,12009722,95,638007
GVAP Indicator,hic,2015,rcv1,12647729,11884194,94,763535
GVAP Indicator,hic,2015,rotac,12647729,5475419,43,7172310
GVAP Indicator,hic,2015,pol3,12647729,12024689,95,623040
GVAP Indicator,hic,2015,mcv2,12891753,7963187,62,4928566
GVAP Indicator,hic,2016,hepbb,12717542,4543179,36,8174363
GVAP Indicator,hic,2016,dtp3,12662123,12121055,96,541068
GVAP Indicator,hic,2016,rcv1,12662123,11854300,94,807823
GVAP Indicator,hic,2016,hib3,12662123,12016852,95,645271
GVAP Indicator,hic,2016,mcv1,12662123,11854300,94,807823
GVAP Indicator,hic,2016,rotac,12662123,5587699,44,7074424
GVAP Indicator,hic,2016,hepb3,12662123,9581535,76,3080588
GVAP Indicator,hic,2016,dtp1,12662123,12361622,98,300501
GVAP Indicator,hic,2016,pol3,12662123,12043098,95,619025
GVAP Indicator,hic,2016,pcv3,12662123,10711078,85,1951045
GVAP Indicator,hic,2016,mcv2,12765890,7962261,62,4803629
GVAP Indicator,hic,1980,bcg,6397645,2251709,35,4145936
GVAP Indicator,hic,1980,mcv1,12891259,6216047,48,6675212
GVAP Indicator,hic,1980,dtp1,12891259,8476052,66,4415207
GVAP Indicator,hic,1980,pol3,12891259,7261157,56,5630102
GVAP Indicator,hic,1980,dtp3,12891259,7434305,58,5456954
GVAP Indicator,hic,1980,rcv1,12891259,3484718,27,9406541
GVAP Indicator,hic,1981,bcg,6341811,4148362,65,2193449
GVAP Indicator,hic,1981,mcv1,12906399,7047781,55,5858618
GVAP Indicator,hic,1981,rcv1,12906399,4049680,31,8856719
GVAP Indicator,hic,1981,dtp1,12906399,10257295,79,2649104
GVAP Indicator,hic,1981,pol3,12906399,8155931,63,4750468
GVAP Indicator,hic,1981,dtp3,12906399,9163343,71,3743056
GVAP Indicator,hic,1982,bcg,6284251,4333144,69,1951107
GVAP Indicator,hic,1982,rcv1,12928354,4398397,34,8529957
GVAP Indicator,hic,1982,mcv1,12928354,7413600,57,5514754
GVAP Indicator,hic,1982,dtp3,12928354,9471526,73,3456828
GVAP Indicator,hic,1982,dtp1,12928354,10455256,81,2473098
GVAP Indicator,hic,1982,pol3,12928354,9966515,77,2961839
GVAP Indicator,hic,1983,bcg,6126096,4294312,70,1831784
GVAP Indicator,hic,1983,dtp3,12945937,9711323,75,3234614
GVAP Indicator,hic,1983,mcv1,12945937,8254389,64,4691548
GVAP Indicator,hic,1983,pol3,12945937,10813406,84,2132531
GVAP Indicator,hic,1983,rcv1,12945937,5124800,40,7821137
GVAP Indicator,hic,1983,dtp1,12945937,10649081,82,2296856
GVAP Indicator,hic,1984,bcg,6053600,4398482,73,1655118
GVAP Indicator,hic,1984,pol3,12953915,11396527,88,1557388
GVAP Indicator,hic,1984,dtp3,12953915,10455458,81,2498457
GVAP Indicator,hic,1984,dtp1,12953915,11288652,87,1665263
GVAP Indicator,hic,1984,rcv1,12953915,5706801,44,7247114
GVAP Indicator,hic,1984,mcv1,12953915,8953784,69,4000131
GVAP Indicator,hic,1985,bcg,5922580,4280048,72,1642532
GVAP Indicator,hic,1985,dtp1,12951330,11261697,87,1689633
GVAP Indicator,hic,1985,dtp3,12951330,10295768,79,2655562
GVAP Indicator,hic,1985,pol3,12951330,11385449,88,1565881
GVAP Indicator,hic,1985,mcv1,12951330,9428255,73,3523075
GVAP Indicator,hic,1985,hepb3,12951330,0,0,12951330
GVAP Indicator,hic,1985,rcv1,12951330,6264660,48,6686670
GVAP Indicator,hic,1986,bcg,5845429,4250285,73,1595144
GVAP Indicator,hic,1986,dtp3,12941307,10669461,82,2271846
GVAP Indicator,hic,1986,mcv1,12941307,9753541,75,3187766
GVAP Indicator,hic,1986,dtp1,12941307,11441684,88,1499623
GVAP Indicator,hic,1986,pol3,12941307,11589179,90,1352128
GVAP Indicator,hic,1986,hepb3,12941307,0,0,12941307
GVAP Indicator,hic,1986,rcv1,12941307,6473050,50,6468257
GVAP Indicator,hic,1987,bcg,5774605,4224869,73,1549736
GVAP Indicator,hic,1987,pol3,12929550,11854292,92,1075258
GVAP Indicator,hic,1987,dtp1,12929550,11723230,91,1206320
GVAP Indicator,hic,1987,rcv1,12929550,6276109,49,6653441
GVAP Indicator,hic,1987,hepb3,12929550,0,0,12929550
GVAP Indicator,hic,1987,mcv1,12929550,9656021,75,3273529
GVAP Indicator,hic,1987,dtp3,12929550,10796623,84,2132927
GVAP Indicator,hic,1988,bcg,5713758,4225714,74,1488044
GVAP Indicator,hic,1988,dtp3,12919074,10845995,84,2073079
GVAP Indicator,hic,1988,rcv1,12919074,7590205,59,5328869
GVAP Indicator,hic,1988,pol3,12919074,11843664,92,1075410
GVAP Indicator,hic,1988,dtp1,12919074,11727526,91,1191548
GVAP Indicator,hic,1988,mcv1,12919074,10419900,81,2499174
GVAP Indicator,hic,1988,hepb3,12919074,0,0,12919074
GVAP Indicator,hic,1989,bcg,5663073,4286174,76,1376899
GVAP Indicator,hic,1989,mcv1,12908207,10694083,83,2214124
GVAP Indicator,hic,1989,pol3,12908207,11609738,90,1298469
GVAP Indicator,hic,1989,dtp3,12908207,11149819,86,1758388
GVAP Indicator,hic,1989,dtp1,12908207,11854747,92,1053460
GVAP Indicator,hic,1989,rcv1,12908207,8964614,69,3943593
GVAP Indicator,hic,1989,hepb3,12908207,0,0,12908207
GVAP Indicator,hic,1990,bcg,5530899,4152046,75,1378853
GVAP Indicator,hic,1990,pol3,12891285,11385688,88,1505597
GVAP Indicator,hic,1990,rcv1,12891285,9464646,73,3426639
GVAP Indicator,hic,1990,dtp1,12891285,12300446,95,590839
GVAP Indicator,hic,1990,hib3,12891285,0,0,12891285
GVAP Indicator,hic,1990,hepb3,12891285,417386,3,12473899
GVAP Indicator,hic,1990,mcv1,12891285,10862252,84,2029033
GVAP Indicator,hic,1990,dtp3,12891285,11386005,88,1505280
GVAP Indicator,hic,1991,bcg,5489658,4271921,78,1217737
GVAP Indicator,hic,1991,rcv1,12860924,10496532,82,2364392
GVAP Indicator,hic,1991,dtp3,12860924,11389696,89,1471228
GVAP Indicator,hic,1991,dtp1,12860924,12315210,96,545714
GVAP Indicator,hic,1991,pol3,12860924,11116730,86,1744194
GVAP Indicator,hic,1991,mcv1,12860924,10778446,84,2082478
GVAP Indicator,hic,1991,hepb3,12860924,1149038,9,11711886
GVAP Indicator,hic,1991,hib3,12860924,556332,4,12304592
GVAP Indicator,hic,1992,bcg,5617014,4430645,79,1186369
GVAP Indicator,hic,1992,dtp1,12981309,12380638,95,600671
GVAP Indicator,hic,1992,hepb3,12981309,1330423,10,11650886
GVAP Indicator,hic,1992,dtp3,12981309,11393444,88,1587865
GVAP Indicator,hic,1992,mcv1,12981309,10694266,82,2287043
GVAP Indicator,hic,1992,pol3,12981309,11035151,85,1946158
GVAP Indicator,hic,1992,hib3,12981309,764169,6,12217140
GVAP Indicator,hic,1992,rcv1,12981309,10388495,80,2592814
GVAP Indicator,hic,1993,bcg,5746374,4534274,79,1212100
GVAP Indicator,hic,1993,mcv1,13091245,10932449,84,2158796
GVAP Indicator,hic,1993,dtp3,13091245,11510184,88,1581061
GVAP Indicator,hic,1993,pol3,13091245,11511231,88,1580014
GVAP Indicator,hic,1993,dtp1,13091245,12438432,95,652813
GVAP Indicator,hic,1993,hib3,13091245,1564998,12,11526247
GVAP Indicator,hic,1993,hepb3,13091245,2165543,17,10925702
GVAP Indicator,hic,1993,rcv1,13091245,10653641,81,2437604
GVAP Indicator,hic,1994,bcg,4455820,3468255,78,987565
GVAP Indicator,hic,1994,dtp1,12991792,12514108,96,477684
GVAP Indicator,hic,1994,hib3,12991792,1697519,13,11294273
GVAP Indicator,hic,1994,mcv1,12991792,11333241,87,1658551
GVAP Indicator,hic,1994,hepb3,12991792,3345711,26,9646081
GVAP Indicator,hic,1994,rcv1,12991792,11114016,86,1877776
GVAP Indicator,hic,1994,dtp3,12991792,11847138,91,1144654
GVAP Indicator,hic,1994,pol3,12991792,11819873,91,1171919
GVAP Indicator,hic,1995,bcg,3739819,3391453,91,348366
GVAP Indicator,hic,1995,mcv1,12881012,11409491,89,1471521
GVAP Indicator,hic,1995,dtp3,12881012,11793662,92,1087350
GVAP Indicator,hic,1995,dtp1,12881012,12441820,97,439192
GVAP Indicator,hic,1995,pol3,12881012,11981346,93,899666
GVAP Indicator,hic,1995,hib3,12881012,5310217,41,7570795
GVAP Indicator,hic,1995,hepb3,12881012,5238896,41,7642116
GVAP Indicator,hic,1995,rcv1,12881012,11409491,89,1471521
GVAP Indicator,hic,1996,bcg,3670427,3295193,90,375234
GVAP Indicator,hic,1996,hib3,12766104,5942410,47,6823694
GVAP Indicator,hic,1996,rcv1,12766104,11472567,90,1293537
GVAP Indicator,hic,1996,dtp3,12766104,11969043,94,797061
GVAP Indicator,hic,1996,hepb3,12766104,6292397,49,6473707
GVAP Indicator,hic,1996,dtp1,12766104,12429293,97,336811
GVAP Indicator,hic,1996,mcv1,12766104,11472567,90,1293537
GVAP Indicator,hic,1996,pol3,12766104,11957368,94,808736
GVAP Indicator,hic,1997,bcg,3596070,3198772,89,397298
GVAP Indicator,hic,1998,bcg,3531890,3040129,86,491761
GVAP Indicator,hic,1999,bcg,3476284,3008846,87,467438
GVAP Indicator,hic,2000,bcg,3433394,2969743,86,463651
GVAP Indicator,hic,2001,bcg,3406453,3006593,88,399860
GVAP Indicator,hic,2002,bcg,3394773,3064592,90,330181
GVAP Indicator,hic,2003,bcg,3396403,3015791,89,380612
GVAP Indicator,hic,2004,bcg,3409367,3038815,89,370552
GVAP Indicator,hic,2005,bcg,3411166,3038613,89,372553
GVAP Indicator,hic,2006,bcg,3486231,3135797,90,350434
GVAP Indicator,hic,2007,bcg,4566285,4107112,90,459173
GVAP Indicator,hic,2008,bcg,3794517,3479415,92,315102
GVAP Indicator,hic,2009,bcg,3801356,3519894,93,281462
GVAP Indicator,hic,2010,bcg,3687542,3458604,94,228938
GVAP Indicator,hic,2011,bcg,3680217,3410474,93,269743
GVAP Indicator,hic,2012,bcg,3668926,3412277,93,256649
GVAP Indicator,hic,2013,bcg,3655514,3364510,92,291004
GVAP Indicator,hic,2014,bcg,3640264,3332468,92,307796
GVAP Indicator,hic,2015,bcg,3623042,3165485,87,457557
GVAP Indicator,hic,2016,bcg,3603454,3118350,87,485104
GVAP Indicator,NA,1980,bcg,7174851,247186,3,6927665
GVAP Indicator,NA,1980,mcv1,7158014,6472373,90,685641
GVAP Indicator,NA,1980,dtp1,7158014,6677091,93,480923
GVAP Indicator,NA,1980,rcv1,7158014,89,0,7157925
GVAP Indicator,NA,1980,pol3,7158014,6472606,90,685408
GVAP Indicator,NA,1980,dtp3,7158014,6472532,90,685482
GVAP Indicator,NA,1981,bcg,7264630,583160,8,6681470
GVAP Indicator,NA,1981,dtp1,7248649,6766857,93,481792
GVAP Indicator,NA,1981,dtp3,7248649,6868660,95,379989
GVAP Indicator,NA,1981,rcv1,7248649,78,0,7248571
GVAP Indicator,NA,1981,pol3,7248649,6885922,95,362727
GVAP Indicator,NA,1981,mcv1,7248649,6885630,95,363019
GVAP Indicator,NA,1982,bcg,7349948,582606,8,6767342
GVAP Indicator,NA,1982,mcv1,7334877,6977068,95,357809
GVAP Indicator,NA,1982,rcv1,7334877,68,0,7334809
GVAP Indicator,NA,1982,dtp1,7334877,6785199,93,549678
GVAP Indicator,NA,1982,pol3,7334877,6755295,92,579582
GVAP Indicator,NA,1982,dtp3,7334877,6750750,92,584127
GVAP Indicator,NA,1983,bcg,7422662,6794264,92,628398
GVAP Indicator,NA,1983,mcv1,7408541,7044835,95,363706
GVAP Indicator,NA,1983,rcv1,7408541,225996,3,7182545
GVAP Indicator,NA,1983,dtp1,7408541,6790132,92,618409
GVAP Indicator,NA,1983,pol3,7408541,6668836,90,739705
GVAP Indicator,NA,1983,dtp3,7408541,6600500,89,808041
GVAP Indicator,NA,1984,bcg,7474399,6840539,92,633860
GVAP Indicator,NA,1984,rcv1,7461256,222275,3,7238981
GVAP Indicator,NA,1984,pol3,7461256,6729704,90,731552
GVAP Indicator,NA,1984,mcv1,7461256,7080080,95,381176
GVAP Indicator,NA,1984,dtp1,7461256,6843111,92,618145
GVAP Indicator,NA,1984,dtp3,7461256,6662682,89,798574
GVAP Indicator,NA,1985,bcg,7491564,6994246,93,497318
GVAP Indicator,NA,1985,hepb3,7479400,0,0,7479400
GVAP Indicator,NA,1985,dtp3,7479400,6401576,86,1077824
GVAP Indicator,NA,1985,mcv1,7479400,7098521,95,380879
GVAP Indicator,NA,1985,dtp1,7479400,6794741,91,684659
GVAP Indicator,NA,1985,pol3,7479400,7374470,99,104930
GVAP Indicator,NA,1985,rcv1,7479400,215573,3,7263827
GVAP Indicator,NA,1986,bcg,7460343,6895719,92,564624
GVAP Indicator,NA,1986,mcv1,7449131,5968730,80,1480401
GVAP Indicator,NA,1986,pol3,7449131,6027954,81,1421177
GVAP Indicator,NA,1986,dtp1,7449131,6563326,88,885805
GVAP Indicator,NA,1986,dtp3,7449131,5964419,80,1484712
GVAP Indicator,NA,1986,hepb3,7449131,0,0,7449131
GVAP Indicator,NA,1986,rcv1,7449131,212430,3,7236701
GVAP Indicator,NA,1987,bcg,7376350,6817955,92,558395
GVAP Indicator,NA,1987,hepb3,7366033,0,0,7366033
GVAP Indicator,NA,1987,dtp3,7366033,5624474,76,1741559
GVAP Indicator,NA,1987,rcv1,7366033,209886,3,7156147
GVAP Indicator,NA,1987,pol3,7366033,5827165,79,1538868
GVAP Indicator,NA,1987,dtp1,7366033,6423854,87,942179
GVAP Indicator,NA,1987,mcv1,7366033,6038478,82,1327555
GVAP Indicator,NA,1988,bcg,7240663,6625527,92,615136
GVAP Indicator,NA,1988,mcv1,7231165,6065286,84,1165879
GVAP Indicator,NA,1988,rcv1,7231165,207280,3,7023885
GVAP Indicator,NA,1988,pol3,7231165,5595068,77,1636097
GVAP Indicator,NA,1988,dtp1,7231165,6173197,85,1057968
GVAP Indicator,NA,1988,dtp3,7231165,5323797,74,1907368
GVAP Indicator,NA,1988,hepb3,7231165,0,0,7231165
GVAP Indicator,NA,1989,bcg,7058013,6393268,91,664745
GVAP Indicator,NA,1989,dtp3,7049247,4926150,70,2123097
GVAP Indicator,NA,1989,mcv1,7049247,6019890,85,1029357
GVAP Indicator,NA,1989,dtp1,7049247,5887267,84,1161980
GVAP Indicator,NA,1989,pol3,7049247,5318040,75,1731207
GVAP Indicator,NA,1989,rcv1,7049247,189722,3,6859525
GVAP Indicator,NA,1989,hepb3,7049247,0,0,7049247
GVAP Indicator,NA,1990,bcg,6836914,6191269,91,645645
GVAP Indicator,NA,1990,dtp3,6828796,4755228,70,2073568
GVAP Indicator,NA,1990,dtp1,6828796,5702155,84,1126641
GVAP Indicator,NA,1990,pol3,6828796,5125542,75,1703254
GVAP Indicator,NA,1990,hib3,6828796,0,0,6828796
GVAP Indicator,NA,1990,rcv1,6828796,202532,3,6626264
GVAP Indicator,NA,1990,hepb3,6828796,405,0,6828391
GVAP Indicator,NA,1990,mcv1,6828796,5827004,85,1001792
GVAP Indicator,NA,1991,bcg,6589409,5967469,91,621940
GVAP Indicator,NA,1991,dtp3,6581870,5239592,80,1342278
GVAP Indicator,NA,1991,hepb3,6581870,550,0,6581320
GVAP Indicator,NA,1991,pol3,6581870,4940964,75,1640906
GVAP Indicator,NA,1991,rcv1,6581870,195365,3,6386505
GVAP Indicator,NA,1991,mcv1,6581870,5594238,85,987632
GVAP Indicator,NA,1991,hib3,6581870,0,0,6581870
GVAP Indicator,NA,1991,dtp1,6581870,5798271,88,783599
GVAP Indicator,NA,1992,bcg,195331,191402,98,3929
GVAP Indicator,NA,1992,dtp3,193362,191361,99,2001
GVAP Indicator,NA,1992,mcv1,193362,187506,97,5856
GVAP Indicator,NA,1992,rcv1,193362,187018,97,6344
GVAP Indicator,NA,1992,dtp1,193362,189478,98,3884
GVAP Indicator,NA,1992,hib3,193362,0,0,193362
GVAP Indicator,NA,1992,hepb3,193362,617,0,192745
GVAP Indicator,NA,1992,pol3,193362,191361,99,2001
GVAP Indicator,NA,1993,bcg,620,586,95,34
GVAP Indicator,NA,1993,rcv1,620,65,10,555
GVAP Indicator,NA,1993,pol3,620,614,99,6
GVAP Indicator,NA,1993,hib3,620,0,0,620
GVAP Indicator,NA,1993,dtp3,620,614,99,6
GVAP Indicator,NA,1993,hepb3,620,486,78,134
GVAP Indicator,NA,1993,mcv1,620,614,99,6
GVAP Indicator,NA,1993,dtp1,620,614,99,6
GVAP Indicator,NA,1994,bcg,609,603,99,6
GVAP Indicator,NA,1994,rcv1,609,63,10,546
GVAP Indicator,NA,1994,dtp3,609,532,87,77
GVAP Indicator,NA,1994,hib3,609,0,0,609
GVAP Indicator,NA,1994,hepb3,609,494,81,115
GVAP Indicator,NA,1994,dtp1,609,581,95,28
GVAP Indicator,NA,1994,mcv1,609,456,75,153
GVAP Indicator,NA,1994,pol3,609,532,87,77
GVAP Indicator,NA,1995,bcg,595,568,95,27
GVAP Indicator,NA,1995,mcv1,595,533,90,62
GVAP Indicator,NA,1995,rcv1,595,21,4,574
GVAP Indicator,NA,1995,pol3,595,556,93,39
GVAP Indicator,NA,1995,hib3,595,0,0,595
GVAP Indicator,NA,1995,hepb3,595,509,86,86
GVAP Indicator,NA,1995,dtp3,595,556,93,39
GVAP Indicator,NA,1995,dtp1,595,578,97,17
GVAP Indicator,NA,1996,bcg,577,525,91,52
GVAP Indicator,NA,1996,mcv1,577,431,75,146
GVAP Indicator,NA,1996,hepb3,577,395,68,182
GVAP Indicator,NA,1996,hib3,577,0,0,577
GVAP Indicator,NA,1996,dtp3,577,447,77,130
GVAP Indicator,NA,1996,dtp1,577,530,92,47
GVAP Indicator,NA,1996,pol3,577,447,77,130
GVAP Indicator,NA,1996,rcv1,577,58,10,519
GVAP Indicator,NA,1997,bcg,557,481,86,76
GVAP Indicator,NA,1997,mcv1,557,496,89,61
GVAP Indicator,NA,1997,hepb3,557,551,99,6
GVAP Indicator,NA,1997,rcv1,557,55,10,502
GVAP Indicator,NA,1997,hib3,557,0,0,557
GVAP Indicator,NA,1997,dtp1,557,541,97,16
GVAP Indicator,NA,1997,pol3,557,521,94,36
GVAP Indicator,NA,1997,dtp3,557,521,94,36
GVAP Indicator,NA,1998,bcg,537,527,98,10
GVAP Indicator,NA,1998,hib3,537,0,0,537
GVAP Indicator,NA,1998,dtp3,537,503,94,34
GVAP Indicator,NA,1998,hepb3,537,479,89,58
GVAP Indicator,NA,1998,rcv1,537,53,10,484
GVAP Indicator,NA,1998,mcv1,537,522,97,15
GVAP Indicator,NA,1998,dtp1,537,527,98,10
GVAP Indicator,NA,1998,pol3,537,503,94,34
GVAP Indicator,NA,1999,bcg,521,506,97,15
GVAP Indicator,NA,1999,mcv1,521,445,85,76
GVAP Indicator,NA,1999,rcv1,521,50,10,471
GVAP Indicator,NA,1999,hepb3,521,473,91,48
GVAP Indicator,NA,1999,dtp1,521,511,98,10
GVAP Indicator,NA,1999,hib3,521,0,0,521
GVAP Indicator,NA,1999,pol3,521,482,93,39
GVAP Indicator,NA,1999,dtp3,521,482,93,39
GVAP Indicator,NA,2000,bcg,510,505,99,5
GVAP Indicator,NA,2000,hepbb,510,399,78,111
GVAP Indicator,NA,2000,dtp1,510,505,99,5
GVAP Indicator,NA,2000,hib3,510,48,9,462
GVAP Indicator,NA,2000,mcv1,510,399,78,111
GVAP Indicator,NA,2000,hepb3,510,500,98,10
GVAP Indicator,NA,2000,pol3,510,473,93,37
GVAP Indicator,NA,2000,rcv1,510,48,9,462
GVAP Indicator,NA,2000,dtp3,510,473,93,37
GVAP Indicator,NA,2000,mcv2,510,371,73,139
GVAP Indicator,NA,2001,bcg,506,496,98,10
GVAP Indicator,NA,2001,hepbb,506,501,99,5
GVAP Indicator,NA,2001,dtp1,506,491,97,15
GVAP Indicator,NA,2001,rcv1,506,46,9,460
GVAP Indicator,NA,2001,pol3,506,459,91,47
GVAP Indicator,NA,2001,hepb3,506,473,93,33
GVAP Indicator,NA,2001,mcv1,506,427,84,79
GVAP Indicator,NA,2001,hib3,506,46,9,460
GVAP Indicator,NA,2001,dtp3,506,459,91,47
GVAP Indicator,NA,2001,mcv2,506,276,55,230
GVAP Indicator,NA,2002,bcg,506,496,98,10
GVAP Indicator,NA,2002,hepbb,506,501,99,5
GVAP Indicator,NA,2002,dtp1,506,501,99,5
GVAP Indicator,NA,2002,rcv1,506,44,9,462
GVAP Indicator,NA,2002,pol3,506,492,97,14
GVAP Indicator,NA,2002,dtp3,506,492,97,14
GVAP Indicator,NA,2002,hepb3,506,472,93,34
GVAP Indicator,NA,2002,hib3,506,44,9,462
GVAP Indicator,NA,2002,mcv1,506,482,95,24
GVAP Indicator,NA,2002,mcv2,506,322,64,184
GVAP Indicator,NA,2003,hepbb,509,503,99,6
GVAP Indicator,NA,2003,bcg,509,503,99,6
GVAP Indicator,NA,2003,pol3,509,483,95,26
GVAP Indicator,NA,2003,mcv1,509,497,98,12
GVAP Indicator,NA,2003,dtp1,509,489,96,20
GVAP Indicator,NA,2003,hepb3,509,473,93,36
GVAP Indicator,NA,2003,dtp3,509,487,96,22
GVAP Indicator,NA,2003,rcv1,509,36,7,473
GVAP Indicator,NA,2003,hib3,509,42,8,467
GVAP Indicator,NA,2003,mcv2,509,447,88,62
GVAP Indicator,NA,2004,hepbb,510,473,93,37
GVAP Indicator,NA,2004,bcg,510,503,99,7
GVAP Indicator,NA,2004,hib3,510,41,8,469
GVAP Indicator,NA,2004,dtp1,510,505,99,5
GVAP Indicator,NA,2004,rcv1,510,41,8,469
GVAP Indicator,NA,2004,dtp3,510,505,99,5
GVAP Indicator,NA,2004,mcv1,510,505,99,5
GVAP Indicator,NA,2004,pol3,510,505,99,5
GVAP Indicator,NA,2004,hepb3,510,505,99,5
GVAP Indicator,NA,2004,mcv2,510,444,87,66
GVAP Indicator,NA,2005,bcg,507,501,99,6
GVAP Indicator,NA,2005,hepbb,507,467,92,40
GVAP Indicator,NA,2005,dtp3,507,497,98,10
GVAP Indicator,NA,2005,hib3,507,39,8,468
GVAP Indicator,NA,2005,hepb3,507,497,98,10
GVAP Indicator,NA,2005,rcv1,507,39,8,468
GVAP Indicator,NA,2005,pol3,507,497,98,10
GVAP Indicator,NA,2005,mcv1,507,502,99,5
GVAP Indicator,NA,2005,dtp1,507,500,99,7
GVAP Indicator,NA,2005,mcv2,507,481,95,26
GVAP Indicator,NA,2006,hepbb,500,483,97,17
GVAP Indicator,NA,2006,bcg,500,494,99,6
GVAP Indicator,NA,2006,hib3,500,38,8,462
GVAP Indicator,NA,2006,dtp1,500,494,99,6
GVAP Indicator,NA,2006,hepb3,500,494,99,6
GVAP Indicator,NA,2006,dtp3,500,494,99,6
GVAP Indicator,NA,2006,rcv1,500,494,99,6
GVAP Indicator,NA,2006,pol3,500,494,99,6
GVAP Indicator,NA,2006,mcv1,500,494,99,6
GVAP Indicator,NA,2006,rotac,500,0,0,500
GVAP Indicator,NA,2006,mcv2,500,494,99,6
GVAP Indicator,NA,2007,hepbb,489,484,99,5
GVAP Indicator,NA,2007,bcg,489,483,99,6
GVAP Indicator,NA,2007,dtp3,489,483,99,6
GVAP Indicator,NA,2007,rotac,489,0,0,489
GVAP Indicator,NA,2007,rcv1,489,479,98,10
GVAP Indicator,NA,2007,hepb3,489,483,99,6
GVAP Indicator,NA,2007,dtp1,489,483,99,6
GVAP Indicator,NA,2007,hib3,489,38,8,451
GVAP Indicator,NA,2007,mcv1,489,479,98,10
GVAP Indicator,NA,2007,pol3,489,483,99,6
GVAP Indicator,NA,2007,mcv2,489,480,98,9
GVAP Indicator,NA,2008,hepbb,475,470,99,5
GVAP Indicator,NA,2008,bcg,475,470,99,5
GVAP Indicator,NA,2008,dtp3,475,470,99,5
GVAP Indicator,NA,2008,hepb3,475,470,99,5
GVAP Indicator,NA,2008,pol3,475,470,99,5
GVAP Indicator,NA,2008,hib3,475,37,8,438
GVAP Indicator,NA,2008,mcv1,475,453,95,22
GVAP Indicator,NA,2008,dtp1,475,470,99,5
GVAP Indicator,NA,2008,rotac,475,0,0,475
GVAP Indicator,NA,2008,rcv1,475,453,95,22
GVAP Indicator,NA,2008,pcv3,475,0,0,475
GVAP Indicator,NA,2008,mcv2,475,453,95,22
GVAP Indicator,NA,2009,hepbb,460,455,99,5
GVAP Indicator,NA,2009,bcg,460,455,99,5
GVAP Indicator,NA,2009,rotac,460,0,0,460
GVAP Indicator,NA,2009,hepb3,460,383,83,77
GVAP Indicator,NA,2009,hib3,460,383,83,77
GVAP Indicator,NA,2009,dtp1,460,455,99,5
GVAP Indicator,NA,2009,dtp3,460,383,83,77
GVAP Indicator,NA,2009,rcv1,460,367,80,93
GVAP Indicator,NA,2009,pol3,460,383,83,77
GVAP Indicator,NA,2009,mcv1,460,367,80,93
GVAP Indicator,NA,2009,pcv3,460,36,8,424
GVAP Indicator,NA,2009,mcv2,460,294,64,166
GVAP Indicator,NA,2010,bcg,446,442,99,4
GVAP Indicator,NA,2010,hepbb,446,426,96,20
GVAP Indicator,NA,2010,hepb3,446,442,99,4
GVAP Indicator,NA,2010,rotac,446,0,0,446
GVAP Indicator,NA,2010,hib3,446,442,99,4
GVAP Indicator,NA,2010,dtp3,446,442,99,4
GVAP Indicator,NA,2010,pcv3,446,36,8,410
GVAP Indicator,NA,2010,mcv1,446,442,99,4
GVAP Indicator,NA,2010,pol3,446,442,99,4
GVAP Indicator,NA,2010,rcv1,446,442,99,4
GVAP Indicator,NA,2010,dtp1,446,442,99,4
GVAP Indicator,NA,2010,mcv2,446,438,98,8
GVAP Indicator,NA,2011,hepbb,432,420,97,12
GVAP Indicator,NA,2011,bcg,432,424,98,8
GVAP Indicator,NA,2011,hepb3,432,404,94,28
GVAP Indicator,NA,2011,hib3,432,404,94,28
GVAP Indicator,NA,2011,mcv1,432,388,90,44
GVAP Indicator,NA,2011,pcv3,432,35,8,397
GVAP Indicator,NA,2011,dtp3,432,404,94,28
GVAP Indicator,NA,2011,pol3,432,404,94,28
GVAP Indicator,NA,2011,rotac,432,0,0,432
GVAP Indicator,NA,2011,rcv1,432,388,90,44
GVAP Indicator,NA,2011,dtp1,432,424,98,8
GVAP Indicator,NA,2011,mcv2,432,416,96,16
GVAP Indicator,NA,2012,bcg,419,411,98,8
GVAP Indicator,NA,2012,hepbb,419,407,97,12
GVAP Indicator,NA,2012,hepb3,419,411,98,8
GVAP Indicator,NA,2012,hib3,419,411,98,8
GVAP Indicator,NA,2012,mcv1,419,407,97,12
GVAP Indicator,NA,2012,pcv3,419,34,8,385
GVAP Indicator,NA,2012,dtp3,419,411,98,8
GVAP Indicator,NA,2012,rotac,419,0,0,419
GVAP Indicator,NA,2012,rcv1,419,407,97,12
GVAP Indicator,NA,2012,pol3,419,411,98,8
GVAP Indicator,NA,2012,dtp1,419,411,98,8
GVAP Indicator,NA,2012,mcv2,419,411,98,8
GVAP Indicator,NA,2013,hepbb,408,400,98,8
GVAP Indicator,NA,2013,bcg,408,400,98,8
GVAP Indicator,NA,2013,hepb3,408,400,98,8
GVAP Indicator,NA,2013,pol3,408,400,98,8
GVAP Indicator,NA,2013,pcv3,408,34,8,374
GVAP Indicator,NA,2013,hib3,408,400,98,8
GVAP Indicator,NA,2013,rotac,408,0,0,408
GVAP Indicator,NA,2013,mcv1,408,396,97,12
GVAP Indicator,NA,2013,dtp1,408,400,98,8
GVAP Indicator,NA,2013,rcv1,408,396,97,12
GVAP Indicator,NA,2013,dtp3,408,400,98,8
GVAP Indicator,NA,2013,mcv2,408,389,95,19
GVAP Indicator,NA,2014,bcg,397,393,99,4
GVAP Indicator,NA,2014,hepbb,397,393,99,4
GVAP Indicator,NA,2014,hepb3,397,393,99,4
GVAP Indicator,NA,2014,hib3,397,393,99,4
GVAP Indicator,NA,2014,mcv1,397,390,98,7
GVAP Indicator,NA,2014,rcv1,397,390,98,7
GVAP Indicator,NA,2014,pcv3,397,33,8,364
GVAP Indicator,NA,2014,dtp1,397,393,99,4
GVAP Indicator,NA,2014,dtp3,397,393,99,4
GVAP Indicator,NA,2014,pol3,397,393,99,4
GVAP Indicator,NA,2014,rotac,397,0,0,397
GVAP Indicator,NA,2014,mcv2,397,390,98,7
GVAP Indicator,NA,2015,bcg,389,385,99,4
GVAP Indicator,NA,2015,hepbb,389,385,99,4
GVAP Indicator,NA,2015,mcv1,389,385,99,4
GVAP Indicator,NA,2015,rcv1,389,385,99,4
GVAP Indicator,NA,2015,rotac,389,0,0,389
GVAP Indicator,NA,2015,dtp1,389,385,99,4
GVAP Indicator,NA,2015,dtp3,389,385,99,4
GVAP Indicator,NA,2015,pol3,389,385,99,4
GVAP Indicator,NA,2015,hepb3,389,385,99,4
GVAP Indicator,NA,2015,pcv3,389,33,8,356
GVAP Indicator,NA,2015,hib3,389,385,99,4
GVAP Indicator,NA,2015,mcv2,389,371,95,18
GVAP Indicator,NA,2016,hepbb,382,378,99,4
GVAP Indicator,NA,2016,bcg,382,378,99,4
GVAP Indicator,NA,2016,rcv1,382,346,91,36
GVAP Indicator,NA,2016,pol3,382,378,99,4
GVAP Indicator,NA,2016,dtp1,382,378,99,4
GVAP Indicator,NA,2016,pcv3,382,32,8,350
GVAP Indicator,NA,2016,dtp3,382,378,99,4
GVAP Indicator,NA,2016,rotac,382,0,0,382
GVAP Indicator,NA,2016,hepb3,382,378,99,4
GVAP Indicator,NA,2016,mcv1,382,346,91,36
GVAP Indicator,NA,2016,hib3,382,378,99,4
GVAP Indicator,NA,2016,mcv2,0,0,NA,0
